PokerStars Home Game Hand #235284185950: {Club #4837790} Tournament #3391835049, €0.13+€0.05+€0.02 EUR Omaha Pot Limit - Level IX (200/400) - 2022/04/05 18:18:54 CET [2022/04/05 12:18:54 ET]
Table '3391835049 2' 6-max Seat #4 is the button
Seat 1: phoud02 (6777 in chips, €0.05 bounty)
Seat 2: jeje_sat (17004 in chips, €0.08 bounty) is sitting out
Seat 4: Tuche37300 (2277 in chips, €0.05 bounty)
Seat 5: stephoumOPC (11461 in chips, €0.09 bounty)
stephoumOPC: posts small blind 200
phoud02: posts big blind 400
*** HOLE CARDS ***
Dealt to jeje_sat [Qs Qd Ac 4c]
jeje_sat: folds
Tuche37300: folds
stephoumOPC: calls 200
jeje_sat has returned
phoud02: checks
*** FLOP *** [Qc Ts Qh]
stephoumOPC: checks
phoud02: checks
*** TURN *** [Qc Ts Qh] [2c]
stephoumOPC: checks
phoud02: checks
*** RIVER *** [Qc Ts Qh 2c] [Ah]
stephoumOPC: checks
phoud02: bets 800
stephoumOPC: folds
Uncalled bet (800) returned to phoud02
phoud02 collected 800 from pot
phoud02: doesn't show hand
*** SUMMARY ***
Total pot 800 | Rake 0
Board [Qc Ts Qh 2c Ah]
Seat 1: phoud02 (big blind) collected (800)
Seat 2: jeje_sat folded before Flop (didn't bet)
Seat 4: Tuche37300 (button) folded before Flop (didn't bet)
Seat 5: stephoumOPC (small blind) folded on the River


PokerStars Home Game Hand #235284199049: {Club #4837790} Tournament #3391835049, €0.13+€0.05+€0.02 EUR Omaha Pot Limit - Level IX (200/400) - 2022/04/05 18:19:35 CET [2022/04/05 12:19:35 ET]
Table '3391835049 2' 6-max Seat #5 is the button
Seat 1: phoud02 (7177 in chips, €0.05 bounty)
Seat 2: jeje_sat (17004 in chips, €0.08 bounty)
Seat 4: Tuche37300 (2277 in chips, €0.05 bounty)
Seat 5: stephoumOPC (11061 in chips, €0.09 bounty)
phoud02: posts small blind 200
jeje_sat: posts big blind 400
*** HOLE CARDS ***
Dealt to jeje_sat [Tc Qc Qh 2s]
Tuche37300: raises 1000 to 1400
stephoumOPC: calls 1400
phoud02: folds
jeje_sat: calls 1000
*** FLOP *** [6h 7d 3h]
jeje_sat: checks
Tuche37300: bets 877 and is all-in
stephoumOPC: calls 877
jeje_sat: folds
*** TURN *** [6h 7d 3h] [Qd]
*** RIVER *** [6h 7d 3h Qd] [Jc]
*** SHOW DOWN ***
Tuche37300: shows [7h Ac 5s Ah] (a pair of Aces)
stephoumOPC: shows [3s 9d Kd Qs] (two pair, Queens and Threes)
stephoumOPC collected 6154 from pot
stephoumOPC wins €0.03 for eliminating Tuche37300 and their own bounty increases by €0.02 to €0.11
Tuche37300 finished the tournament in 8th place
*** SUMMARY ***
Total pot 6154 | Rake 0
Board [6h 7d 3h Qd Jc]
Seat 1: phoud02 (small blind) folded before Flop
Seat 2: jeje_sat (big blind) folded on the Flop
Seat 4: Tuche37300 showed [7h Ac 5s Ah] and lost with a pair of Aces
Seat 5: stephoumOPC (button) showed [3s 9d Kd Qs] and won (6154) with two pair, Queens and Threes


PokerStars Home Game Hand #235284210222: {Club #4837790} Tournament #3391835049, €0.13+€0.05+€0.02 EUR Omaha Pot Limit - Level IX (200/400) - 2022/04/05 18:20:08 CET [2022/04/05 12:20:08 ET]
Table '3391835049 2' 6-max Seat #1 is the button
Seat 1: phoud02 (6977 in chips, €0.05 bounty)
Seat 2: jeje_sat (15604 in chips, €0.08 bounty)
Seat 5: stephoumOPC (14938 in chips, €0.11 bounty)
jeje_sat: posts small blind 200
stephoumOPC: posts big blind 400
*** HOLE CARDS ***
Dealt to jeje_sat [3c 9c Ts 2d]
phoud02: folds
jeje_sat: folds
Uncalled bet (200) returned to stephoumOPC
stephoumOPC collected 400 from pot
stephoumOPC: doesn't show hand
*** SUMMARY ***
Total pot 400 | Rake 0
Seat 1: phoud02 (button) folded before Flop (didn't bet)
Seat 2: jeje_sat (small blind) folded before Flop
Seat 5: stephoumOPC (big blind) collected (400)


PokerStars Home Game Hand #235284215623: {Club #4837790} Tournament #3391835049, €0.13+€0.05+€0.02 EUR Omaha Pot Limit - Level X (250/500) - 2022/04/05 18:20:25 CET [2022/04/05 12:20:25 ET]
Table '3391835049 2' 6-max Seat #2 is the button
Seat 1: phoud02 (6977 in chips, €0.05 bounty)
Seat 2: jeje_sat (15404 in chips, €0.08 bounty)
Seat 5: stephoumOPC (15138 in chips, €0.11 bounty)
stephoumOPC: posts small blind 250
phoud02: posts big blind 500
*** HOLE CARDS ***
Dealt to jeje_sat [Ad 6s Jc 2s]
jeje_sat: folds
stephoumOPC: calls 250
phoud02: checks
*** FLOP *** [3d 9s 4s]
stephoumOPC: bets 500
phoud02: folds
Uncalled bet (500) returned to stephoumOPC
stephoumOPC collected 1000 from pot
stephoumOPC: doesn't show hand
*** SUMMARY ***
Total pot 1000 | Rake 0
Board [3d 9s 4s]
Seat 1: phoud02 (big blind) folded on the Flop
Seat 2: jeje_sat (button) folded before Flop (didn't bet)
Seat 5: stephoumOPC (small blind) collected (1000)


PokerStars Home Game Hand #235284230513: {Club #4837790} Tournament #3391835049, €0.13+€0.05+€0.02 EUR Omaha Pot Limit - Level X (250/500) - 2022/04/05 18:20:49 CET [2022/04/05 12:20:49 ET]
Table '3391835049 2' 6-max Seat #5 is the button
Seat 1: phoud02 (6477 in chips, €0.05 bounty)
Seat 2: jeje_sat (15404 in chips, €0.08 bounty)
Seat 5: stephoumOPC (15638 in chips, €0.11 bounty)
phoud02: posts small blind 250
jeje_sat: posts big blind 500
*** HOLE CARDS ***
Dealt to jeje_sat [Kc Ts 5s Jc]
stephoumOPC: raises 500 to 1000
phoud02: calls 750
jeje_sat: calls 500
*** FLOP *** [7c Kh Qd]
phoud02: checks
jeje_sat: checks
stephoumOPC: checks
*** TURN *** [7c Kh Qd] [4c]
phoud02: checks
jeje_sat: bets 2000
stephoumOPC: folds
phoud02: folds
Uncalled bet (2000) returned to jeje_sat
jeje_sat collected 3000 from pot
jeje_sat: doesn't show hand
*** SUMMARY ***
Total pot 3000 | Rake 0
Board [7c Kh Qd 4c]
Seat 1: phoud02 (small blind) folded on the Turn
Seat 2: jeje_sat (big blind) collected (3000)
Seat 5: stephoumOPC (button) folded on the Turn


PokerStars Home Game Hand #235284245605: {Club #4837790} Tournament #3391835049, €0.13+€0.05+€0.02 EUR Omaha Pot Limit - Level X (250/500) - 2022/04/05 18:21:35 CET [2022/04/05 12:21:35 ET]
Table '3391835049 2' 6-max Seat #1 is the button
Seat 1: phoud02 (5477 in chips, €0.05 bounty)
Seat 2: jeje_sat (17404 in chips, €0.08 bounty)
Seat 5: stephoumOPC (14638 in chips, €0.11 bounty)
jeje_sat: posts small blind 250
stephoumOPC: posts big blind 500
*** HOLE CARDS ***
Dealt to jeje_sat [6c 9h 9s Jh]
phoud02: folds
jeje_sat: folds
Uncalled bet (250) returned to stephoumOPC
stephoumOPC collected 500 from pot
stephoumOPC: doesn't show hand
*** SUMMARY ***
Total pot 500 | Rake 0
Seat 1: phoud02 (button) folded before Flop (didn't bet)
Seat 2: jeje_sat (small blind) folded before Flop
Seat 5: stephoumOPC (big blind) collected (500)


PokerStars Home Game Hand #235284248324: {Club #4837790} Tournament #3391835049, €0.13+€0.05+€0.02 EUR Omaha Pot Limit - Level X (250/500) - 2022/04/05 18:21:44 CET [2022/04/05 12:21:44 ET]
Table '3391835049 2' 6-max Seat #2 is the button
Seat 1: phoud02 (5477 in chips, €0.05 bounty)
Seat 2: jeje_sat (17154 in chips, €0.08 bounty)
Seat 5: stephoumOPC (14888 in chips, €0.11 bounty)
stephoumOPC: posts small blind 250
phoud02: posts big blind 500
*** HOLE CARDS ***
Dealt to jeje_sat [7h 4s 8h 9d]
jeje_sat: folds
stephoumOPC: raises 1000 to 1500
phoud02: folds
Uncalled bet (1000) returned to stephoumOPC
stephoumOPC collected 1000 from pot
stephoumOPC: doesn't show hand
*** SUMMARY ***
Total pot 1000 | Rake 0
Seat 1: phoud02 (big blind) folded before Flop
Seat 2: jeje_sat (button) folded before Flop (didn't bet)
Seat 5: stephoumOPC (small blind) collected (1000)


PokerStars Home Game Hand #235284253605: {Club #4837790} Tournament #3391835049, €0.13+€0.05+€0.02 EUR Omaha Pot Limit - Level X (250/500) - 2022/04/05 18:22:00 CET [2022/04/05 12:22:00 ET]
Table '3391835049 2' 6-max Seat #5 is the button
Seat 1: phoud02 (4977 in chips, €0.05 bounty)
Seat 2: jeje_sat (17154 in chips, €0.08 bounty)
Seat 5: stephoumOPC (15388 in chips, €0.11 bounty)
phoud02: posts small blind 250
jeje_sat: posts big blind 500
*** HOLE CARDS ***
Dealt to jeje_sat [7d 3c 8s 9s]
stephoumOPC: raises 500 to 1000
phoud02: folds
jeje_sat: folds
Uncalled bet (500) returned to stephoumOPC
stephoumOPC collected 1250 from pot
stephoumOPC: doesn't show hand
*** SUMMARY ***
Total pot 1250 | Rake 0
Seat 1: phoud02 (small blind) folded before Flop
Seat 2: jeje_sat (big blind) folded before Flop
Seat 5: stephoumOPC (button) collected (1250)


PokerStars Home Game Hand #235284256833: {Club #4837790} Tournament #3391835049, €0.13+€0.05+€0.02 EUR Omaha Pot Limit - Level X (250/500) - 2022/04/05 18:22:10 CET [2022/04/05 12:22:10 ET]
Table '3391835049 2' 6-max Seat #1 is the button
Seat 1: phoud02 (4727 in chips, €0.05 bounty)
Seat 2: jeje_sat (16654 in chips, €0.08 bounty)
Seat 5: stephoumOPC (16138 in chips, €0.11 bounty)
jeje_sat: posts small blind 250
stephoumOPC: posts big blind 500
*** HOLE CARDS ***
Dealt to jeje_sat [As 8c 7s Kh]
phoud02: folds
jeje_sat: calls 250
stephoumOPC: checks
*** FLOP *** [4h 9c 8d]
jeje_sat: checks
stephoumOPC: bets 500
jeje_sat: calls 500
*** TURN *** [4h 9c 8d] [4c]
jeje_sat: checks
stephoumOPC: checks
*** RIVER *** [4h 9c 8d 4c] [Kd]
jeje_sat: checks
stephoumOPC: bets 750
jeje_sat: calls 750
*** SHOW DOWN ***
stephoumOPC: shows [3h 4d Js Qd] (three of a kind, Fours)
jeje_sat: mucks hand
stephoumOPC collected 3500 from pot
*** SUMMARY ***
Total pot 3500 | Rake 0
Board [4h 9c 8d 4c Kd]
Seat 1: phoud02 (button) folded before Flop (didn't bet)
Seat 2: jeje_sat (small blind) mucked [As 8c 7s Kh]
Seat 5: stephoumOPC (big blind) showed [3h 4d Js Qd] and won (3500) with three of a kind, Fours


PokerStars Home Game Hand #235284267032: {Club #4837790} Tournament #3391835049, €0.13+€0.05+€0.02 EUR Omaha Pot Limit - Level X (250/500) - 2022/04/05 18:22:41 CET [2022/04/05 12:22:41 ET]
Table '3391835049 2' 6-max Seat #2 is the button
Seat 1: phoud02 (4727 in chips, €0.05 bounty)
Seat 2: jeje_sat (14904 in chips, €0.08 bounty)
Seat 5: stephoumOPC (17888 in chips, €0.11 bounty)
stephoumOPC: posts small blind 250
phoud02: posts big blind 500
*** HOLE CARDS ***
Dealt to jeje_sat [Ks Jc 5d 2c]
jeje_sat: folds
stephoumOPC: calls 250
phoud02: checks
*** FLOP *** [2h 7d 7s]
stephoumOPC: checks
phoud02: checks
*** TURN *** [2h 7d 7s] [6d]
stephoumOPC: checks
phoud02: checks
*** RIVER *** [2h 7d 7s 6d] [Js]
stephoumOPC: checks
phoud02: bets 1000
stephoumOPC: folds
Uncalled bet (1000) returned to phoud02
phoud02 collected 1000 from pot
phoud02: doesn't show hand
*** SUMMARY ***
Total pot 1000 | Rake 0
Board [2h 7d 7s 6d Js]
Seat 1: phoud02 (big blind) collected (1000)
Seat 2: jeje_sat (button) folded before Flop (didn't bet)
Seat 5: stephoumOPC (small blind) folded on the River


PokerStars Home Game Hand #235284276532: {Club #4837790} Tournament #3391835049, €0.13+€0.05+€0.02 EUR Omaha Pot Limit - Level X (250/500) - 2022/04/05 18:23:10 CET [2022/04/05 12:23:10 ET]
Table '3391835049 2' 6-max Seat #5 is the button
Seat 1: phoud02 (5227 in chips, €0.05 bounty)
Seat 2: jeje_sat (14904 in chips, €0.08 bounty)
Seat 5: stephoumOPC (17388 in chips, €0.11 bounty)
phoud02: posts small blind 250
jeje_sat: posts big blind 500
*** HOLE CARDS ***
Dealt to jeje_sat [8s 3d 7c 2s]
stephoumOPC: raises 500 to 1000
phoud02: folds
jeje_sat: folds
Uncalled bet (500) returned to stephoumOPC
stephoumOPC collected 1250 from pot
stephoumOPC: doesn't show hand
*** SUMMARY ***
Total pot 1250 | Rake 0
Seat 1: phoud02 (small blind) folded before Flop
Seat 2: jeje_sat (big blind) folded before Flop
Seat 5: stephoumOPC (button) collected (1250)


PokerStars Home Game Hand #235284281303: {Club #4837790} Tournament #3391835049, €0.13+€0.05+€0.02 EUR Omaha Pot Limit - Level X (250/500) - 2022/04/05 18:23:25 CET [2022/04/05 12:23:25 ET]
Table '3391835049 2' 6-max Seat #1 is the button
Seat 1: phoud02 (4977 in chips, €0.05 bounty)
Seat 2: jeje_sat (14404 in chips, €0.08 bounty)
Seat 5: stephoumOPC (18138 in chips, €0.11 bounty)
jeje_sat: posts small blind 250
stephoumOPC: posts big blind 500
*** HOLE CARDS ***
Dealt to jeje_sat [8d 6h 5s 2s]
phoud02: folds
jeje_sat: raises 1000 to 1500
stephoumOPC: folds
Uncalled bet (1000) returned to jeje_sat
jeje_sat collected 1000 from pot
jeje_sat: doesn't show hand
*** SUMMARY ***
Total pot 1000 | Rake 0
Seat 1: phoud02 (button) folded before Flop (didn't bet)
Seat 2: jeje_sat (small blind) collected (1000)
Seat 5: stephoumOPC (big blind) folded before Flop


PokerStars Home Game Hand #235284286633: {Club #4837790} Tournament #3391835049, €0.13+€0.05+€0.02 EUR Omaha Pot Limit - Level X (250/500) - 2022/04/05 18:23:41 CET [2022/04/05 12:23:41 ET]
Table '3391835049 2' 6-max Seat #2 is the button
Seat 1: phoud02 (4977 in chips, €0.05 bounty)
Seat 2: jeje_sat (14904 in chips, €0.08 bounty)
Seat 5: stephoumOPC (17638 in chips, €0.11 bounty)
stephoumOPC: posts small blind 250
phoud02: posts big blind 500
*** HOLE CARDS ***
Dealt to jeje_sat [Jh Kc 7c 8d]
jeje_sat: folds
stephoumOPC: calls 250
phoud02: checks
*** FLOP *** [8h 9s Ac]
stephoumOPC: checks
phoud02: checks
*** TURN *** [8h 9s Ac] [2d]
stephoumOPC: bets 500
phoud02: folds
Uncalled bet (500) returned to stephoumOPC
stephoumOPC collected 1000 from pot
stephoumOPC: doesn't show hand
*** SUMMARY ***
Total pot 1000 | Rake 0
Board [8h 9s Ac 2d]
Seat 1: phoud02 (big blind) folded on the Turn
Seat 2: jeje_sat (button) folded before Flop (didn't bet)
Seat 5: stephoumOPC (small blind) collected (1000)


PokerStars Home Game Hand #235284295033: {Club #4837790} Tournament #3391835049, €0.13+€0.05+€0.02 EUR Omaha Pot Limit - Level X (250/500) - 2022/04/05 18:24:07 CET [2022/04/05 12:24:07 ET]
Table '3391835049 2' 6-max Seat #5 is the button
Seat 1: phoud02 (4477 in chips, €0.05 bounty)
Seat 2: jeje_sat (14904 in chips, €0.08 bounty)
Seat 5: stephoumOPC (18138 in chips, €0.11 bounty)
phoud02: posts small blind 250
jeje_sat: posts big blind 500
*** HOLE CARDS ***
Dealt to jeje_sat [8s Qd Th As]
stephoumOPC: calls 500
phoud02: calls 250
jeje_sat: raises 1500 to 2000
stephoumOPC: folds
phoud02: folds
Uncalled bet (1500) returned to jeje_sat
jeje_sat collected 1500 from pot
jeje_sat: doesn't show hand
*** SUMMARY ***
Total pot 1500 | Rake 0
Seat 1: phoud02 (small blind) folded before Flop
Seat 2: jeje_sat (big blind) collected (1500)
Seat 5: stephoumOPC (button) folded before Flop


PokerStars Home Game Hand #235284300850: {Club #4837790} Tournament #3391835049, €0.13+€0.05+€0.02 EUR Omaha Pot Limit - Level X (250/500) - 2022/04/05 18:24:24 CET [2022/04/05 12:24:24 ET]
Table '3391835049 2' 6-max Seat #1 is the button
Seat 1: phoud02 (3977 in chips, €0.05 bounty)
Seat 2: jeje_sat (15904 in chips, €0.08 bounty)
Seat 5: stephoumOPC (17638 in chips, €0.11 bounty)
jeje_sat: posts small blind 250
stephoumOPC: posts big blind 500
*** HOLE CARDS ***
Dealt to jeje_sat [Tc 6h Kd 2s]
phoud02: folds
jeje_sat: folds
Uncalled bet (250) returned to stephoumOPC
stephoumOPC collected 500 from pot
stephoumOPC: doesn't show hand
*** SUMMARY ***
Total pot 500 | Rake 0
Seat 1: phoud02 (button) folded before Flop (didn't bet)
Seat 2: jeje_sat (small blind) folded before Flop
Seat 5: stephoumOPC (big blind) collected (500)


PokerStars Home Game Hand #235284303081: {Club #4837790} Tournament #3391835049, €0.13+€0.05+€0.02 EUR Omaha Pot Limit - Level X (250/500) - 2022/04/05 18:24:31 CET [2022/04/05 12:24:31 ET]
Table '3391835049 2' 6-max Seat #2 is the button
Seat 1: phoud02 (3977 in chips, €0.05 bounty)
Seat 2: jeje_sat (15654 in chips, €0.08 bounty)
Seat 5: stephoumOPC (17888 in chips, €0.11 bounty)
stephoumOPC: posts small blind 250
phoud02: posts big blind 500
*** HOLE CARDS ***
Dealt to jeje_sat [Ts 6c Kd 4d]
jeje_sat: folds
stephoumOPC: calls 250
phoud02: checks
*** FLOP *** [2d Kc 9s]
stephoumOPC: checks
phoud02: checks
*** TURN *** [2d Kc 9s] [7d]
stephoumOPC: checks
phoud02: bets 500
stephoumOPC: calls 500
*** RIVER *** [2d Kc 9s 7d] [7h]
stephoumOPC: checks
phoud02: bets 2000
stephoumOPC: folds
Uncalled bet (2000) returned to phoud02
phoud02 collected 2000 from pot
phoud02: doesn't show hand
*** SUMMARY ***
Total pot 2000 | Rake 0
Board [2d Kc 9s 7d 7h]
Seat 1: phoud02 (big blind) collected (2000)
Seat 2: jeje_sat (button) folded before Flop (didn't bet)
Seat 5: stephoumOPC (small blind) folded on the River


PokerStars Home Game Hand #235284312346: {Club #4837790} Tournament #3391835049, €0.13+€0.05+€0.02 EUR Omaha Pot Limit - Level X (250/500) - 2022/04/05 18:24:59 CET [2022/04/05 12:24:59 ET]
Table '3391835049 2' 6-max Seat #5 is the button
Seat 1: phoud02 (4977 in chips, €0.05 bounty)
Seat 2: jeje_sat (15654 in chips, €0.08 bounty)
Seat 5: stephoumOPC (16888 in chips, €0.11 bounty)
phoud02: posts small blind 250
jeje_sat: posts big blind 500
*** HOLE CARDS ***
Dealt to jeje_sat [8s Ac 2h 5c]
stephoumOPC: raises 500 to 1000
phoud02: folds
jeje_sat: calls 500
*** FLOP *** [Kh Qh 5d]
jeje_sat: checks
stephoumOPC: checks
*** TURN *** [Kh Qh 5d] [2d]
jeje_sat: bets 1125
stephoumOPC: folds
Uncalled bet (1125) returned to jeje_sat
jeje_sat collected 2250 from pot
jeje_sat: doesn't show hand
*** SUMMARY ***
Total pot 2250 | Rake 0
Board [Kh Qh 5d 2d]
Seat 1: phoud02 (small blind) folded before Flop
Seat 2: jeje_sat (big blind) collected (2250)
Seat 5: stephoumOPC (button) folded on the Turn


PokerStars Home Game Hand #235284328223: {Club #4837790} Tournament #3391835049, €0.13+€0.05+€0.02 EUR Omaha Pot Limit - Level XI (300/600) - 2022/04/05 18:25:45 CET [2022/04/05 12:25:45 ET]
Table '3391835049 2' 6-max Seat #1 is the button
Seat 1: phoud02 (4727 in chips, €0.05 bounty)
Seat 2: jeje_sat (16904 in chips, €0.08 bounty)
Seat 5: stephoumOPC (15888 in chips, €0.11 bounty)
jeje_sat: posts small blind 300
stephoumOPC: posts big blind 600
*** HOLE CARDS ***
Dealt to jeje_sat [Th Jd 8d Qd]
phoud02: folds
jeje_sat: raises 1200 to 1800
stephoumOPC: calls 1200
*** FLOP *** [7h Kh Qc]
jeje_sat: bets 1800
stephoumOPC: calls 1800
*** TURN *** [7h Kh Qc] [Kc]
jeje_sat: checks
stephoumOPC: checks
*** RIVER *** [7h Kh Qc Kc] [9s]
jeje_sat: bets 4200
stephoumOPC: folds
Uncalled bet (4200) returned to jeje_sat
jeje_sat collected 7200 from pot
jeje_sat: doesn't show hand
*** SUMMARY ***
Total pot 7200 | Rake 0
Board [7h Kh Qc Kc 9s]
Seat 1: phoud02 (button) folded before Flop (didn't bet)
Seat 2: jeje_sat (small blind) collected (7200)
Seat 5: stephoumOPC (big blind) folded on the River


PokerStars Home Game Hand #235284347050: {Club #4837790} Tournament #3391835049, €0.13+€0.05+€0.02 EUR Omaha Pot Limit - Level XI (300/600) - 2022/04/05 18:26:41 CET [2022/04/05 12:26:41 ET]
Table '3391835049 2' 6-max Seat #2 is the button
Seat 1: phoud02 (4727 in chips, €0.05 bounty)
Seat 2: jeje_sat (20504 in chips, €0.08 bounty)
Seat 5: stephoumOPC (12288 in chips, €0.11 bounty)
stephoumOPC: posts small blind 300
phoud02: posts big blind 600
*** HOLE CARDS ***
Dealt to jeje_sat [Qc 8d 7s 5s]
RIZCHOU is sitting out
Crakdeck is sitting out
Crakdeck has returned
RIZCHOU has returned
jeje_sat: folds
stephoumOPC: calls 300
phoud02: checks
*** FLOP *** [Jd 8c 9c]
stephoumOPC: bets 600
phoud02: folds
Uncalled bet (600) returned to stephoumOPC
stephoumOPC collected 1200 from pot
*** SUMMARY ***
Total pot 1200 | Rake 0
Board [Jd 8c 9c]
Seat 1: phoud02 (big blind) folded on the Flop
Seat 2: jeje_sat (button) folded before Flop (didn't bet)
Seat 5: stephoumOPC (small blind) collected (1200)


PokerStars Home Game Hand #235284365385: {Club #4837790} Tournament #3391835049, €0.13+€0.05+€0.02 EUR Omaha Pot Limit - Level XI (300/600) - 2022/04/05 18:27:13 CET [2022/04/05 12:27:13 ET]
Table '3391835049 2' 6-max Seat #5 is the button
Seat 1: phoud02 (4127 in chips, €0.05 bounty)
Seat 2: jeje_sat (20504 in chips, €0.08 bounty)
Seat 3: NHBROOO (48648 in chips, €0.11 bounty)
Seat 4: RIZCHOU (11514 in chips, €0.05 bounty)
Seat 5: stephoumOPC (12888 in chips, €0.11 bounty)
Seat 6: Crakdeck (2319 in chips) out of hand (moved from another table into small blind)
Crakdeck will be allowed to play after the button
phoud02: posts small blind 300
jeje_sat: posts big blind 600
*** HOLE CARDS ***
Dealt to jeje_sat [8s 9c 3h 4c]
NHBROOO: calls 600
RIZCHOU: raises 2100 to 2700
stephoumOPC: folds
phoud02: folds
jeje_sat: folds
NHBROOO: calls 2100
*** FLOP *** [5s Jh Ks]
NHBROOO: checks
RIZCHOU: bets 6300
NHBROOO: folds
Uncalled bet (6300) returned to RIZCHOU
RIZCHOU collected 6300 from pot
RIZCHOU: doesn't show hand
*** SUMMARY ***
Total pot 6300 | Rake 0
Board [5s Jh Ks]
Seat 1: phoud02 (small blind) folded before Flop
Seat 2: jeje_sat (big blind) folded before Flop
Seat 3: NHBROOO folded on the Flop
Seat 4: RIZCHOU collected (6300)
Seat 5: stephoumOPC (button) folded before Flop (didn't bet)


PokerStars Home Game Hand #235284381150: {Club #4837790} Tournament #3391835049, €0.13+€0.05+€0.02 EUR Omaha Pot Limit - Level XI (300/600) - 2022/04/05 18:27:59 CET [2022/04/05 12:27:59 ET]
Table '3391835049 2' 6-max Seat #1 is the button
Seat 1: phoud02 (3827 in chips, €0.05 bounty)
Seat 2: jeje_sat (19904 in chips, €0.08 bounty)
Seat 3: NHBROOO (45948 in chips, €0.11 bounty)
Seat 4: RIZCHOU (15114 in chips, €0.05 bounty)
Seat 5: stephoumOPC (12888 in chips, €0.11 bounty)
Seat 6: Crakdeck (2319 in chips, €0.15 bounty)
jeje_sat: posts small blind 300
NHBROOO: posts big blind 600
*** HOLE CARDS ***
Dealt to jeje_sat [5h Ts Ad 3s]
RIZCHOU: folds
stephoumOPC: folds
Crakdeck: raises 1500 to 2100
phoud02: folds
jeje_sat: calls 1800
NHBROOO: calls 1500
*** FLOP *** [Th Kh Tc]
jeje_sat: checks
NHBROOO: checks
Crakdeck: bets 219 and is all-in
jeje_sat: calls 219
NHBROOO: folds
*** TURN *** [Th Kh Tc] [2c]
*** RIVER *** [Th Kh Tc 2c] [Ac]
*** SHOW DOWN ***
jeje_sat: shows [5h Ts Ad 3s] (a full house, Tens full of Aces)
Crakdeck: shows [7c 2d Ks Kd] (a full house, Kings full of Tens)
Crakdeck collected 6738 from pot
*** SUMMARY ***
Total pot 6738 | Rake 0
Board [Th Kh Tc 2c Ac]
Seat 1: phoud02 (button) folded before Flop (didn't bet)
Seat 2: jeje_sat (small blind) showed [5h Ts Ad 3s] and lost with a full house, Tens full of Aces
Seat 3: NHBROOO (big blind) folded on the Flop
Seat 4: RIZCHOU folded before Flop (didn't bet)
Seat 5: stephoumOPC folded before Flop (didn't bet)
Seat 6: Crakdeck showed [7c 2d Ks Kd] and won (6738) with a full house, Kings full of Tens


PokerStars Home Game Hand #235284402230: {Club #4837790} Tournament #3391835049, €0.13+€0.05+€0.02 EUR Omaha Pot Limit - Level XI (300/600) - 2022/04/05 18:29:00 CET [2022/04/05 12:29:00 ET]
Table '3391835049 2' 6-max Seat #2 is the button
Seat 1: phoud02 (3827 in chips, €0.05 bounty)
Seat 2: jeje_sat (17585 in chips, €0.08 bounty)
Seat 3: NHBROOO (43848 in chips, €0.11 bounty)
Seat 4: RIZCHOU (15114 in chips, €0.05 bounty)
Seat 5: stephoumOPC (12888 in chips, €0.11 bounty)
Seat 6: Crakdeck (6738 in chips, €0.15 bounty)
NHBROOO: posts small blind 300
RIZCHOU: posts big blind 600
*** HOLE CARDS ***
Dealt to jeje_sat [5d 5s Tc Td]
stephoumOPC: folds
Crakdeck: folds
phoud02: folds
jeje_sat: raises 1500 to 2100
NHBROOO: folds
RIZCHOU: calls 1500
*** FLOP *** [6s 5h Ad]
RIZCHOU: checks
jeje_sat: bets 2400
RIZCHOU: calls 2400
*** TURN *** [6s 5h Ad] [Qc]
RIZCHOU: checks
jeje_sat: bets 9300
RIZCHOU: folds
Uncalled bet (9300) returned to jeje_sat
jeje_sat collected 9300 from pot
jeje_sat: doesn't show hand
*** SUMMARY ***
Total pot 9300 | Rake 0
Board [6s 5h Ad Qc]
Seat 1: phoud02 folded before Flop (didn't bet)
Seat 2: jeje_sat (button) collected (9300)
Seat 3: NHBROOO (small blind) folded before Flop
Seat 4: RIZCHOU (big blind) folded on the Turn
Seat 5: stephoumOPC folded before Flop (didn't bet)
Seat 6: Crakdeck folded before Flop (didn't bet)


PokerStars Home Game Hand #235284424015: {Club #4837790} Tournament #3391835049, €0.13+€0.05+€0.02 EUR Omaha Pot Limit - Level XI (300/600) - 2022/04/05 18:30:04 CET [2022/04/05 12:30:04 ET]
Table '3391835049 2' 6-max Seat #3 is the button
Seat 1: phoud02 (3827 in chips, €0.05 bounty)
Seat 2: jeje_sat (22385 in chips, €0.08 bounty)
Seat 3: NHBROOO (43548 in chips, €0.11 bounty)
Seat 4: RIZCHOU (10614 in chips, €0.05 bounty)
Seat 5: stephoumOPC (12888 in chips, €0.11 bounty)
Seat 6: Crakdeck (6738 in chips, €0.15 bounty)
RIZCHOU: posts small blind 300
stephoumOPC: posts big blind 600
*** HOLE CARDS ***
Dealt to jeje_sat [4s Kh 7d 9c]
Crakdeck: folds
phoud02: folds
jeje_sat: folds
NHBROOO: raises 1500 to 2100
RIZCHOU: folds
stephoumOPC: folds
Uncalled bet (1500) returned to NHBROOO
NHBROOO collected 1500 from pot
NHBROOO: doesn't show hand
*** SUMMARY ***
Total pot 1500 | Rake 0
Seat 1: phoud02 folded before Flop (didn't bet)
Seat 2: jeje_sat folded before Flop (didn't bet)
Seat 3: NHBROOO (button) collected (1500)
Seat 4: RIZCHOU (small blind) folded before Flop
Seat 5: stephoumOPC (big blind) folded before Flop
Seat 6: Crakdeck folded before Flop (didn't bet)


PokerStars Home Game Hand #235284432242: {Club #4837790} Tournament #3391835049, €0.13+€0.05+€0.02 EUR Omaha Pot Limit - Level XII (350/700) - 2022/04/05 18:30:27 CET [2022/04/05 12:30:27 ET]
Table '3391835049 2' 6-max Seat #4 is the button
Seat 1: phoud02 (3827 in chips, €0.05 bounty)
Seat 2: jeje_sat (22385 in chips, €0.08 bounty)
Seat 3: NHBROOO (44448 in chips, €0.11 bounty)
Seat 4: RIZCHOU (10314 in chips, €0.05 bounty)
Seat 5: stephoumOPC (12288 in chips, €0.11 bounty)
Seat 6: Crakdeck (6738 in chips, €0.15 bounty)
stephoumOPC: posts small blind 350
Crakdeck: posts big blind 700
*** HOLE CARDS ***
Dealt to jeje_sat [6d 3s 8c 5c]
phoud02: folds
jeje_sat: folds
NHBROOO: raises 1750 to 2450
RIZCHOU: folds
stephoumOPC: folds
Crakdeck: folds
Uncalled bet (1750) returned to NHBROOO
NHBROOO collected 1750 from pot
NHBROOO: doesn't show hand
*** SUMMARY ***
Total pot 1750 | Rake 0
Seat 1: phoud02 folded before Flop (didn't bet)
Seat 2: jeje_sat folded before Flop (didn't bet)
Seat 3: NHBROOO collected (1750)
Seat 4: RIZCHOU (button) folded before Flop (didn't bet)
Seat 5: stephoumOPC (small blind) folded before Flop
Seat 6: Crakdeck (big blind) folded before Flop


PokerStars Home Game Hand #235284439806: {Club #4837790} Tournament #3391835049, €0.13+€0.05+€0.02 EUR Omaha Pot Limit - Level XII (350/700) - 2022/04/05 18:30:48 CET [2022/04/05 12:30:48 ET]
Table '3391835049 2' 6-max Seat #5 is the button
Seat 1: phoud02 (3827 in chips, €0.05 bounty)
Seat 2: jeje_sat (22385 in chips, €0.08 bounty)
Seat 3: NHBROOO (45498 in chips, €0.11 bounty)
Seat 4: RIZCHOU (10314 in chips, €0.05 bounty)
Seat 5: stephoumOPC (11938 in chips, €0.11 bounty)
Seat 6: Crakdeck (6038 in chips, €0.15 bounty)
Crakdeck: posts small blind 350
phoud02: posts big blind 700
*** HOLE CARDS ***
Dealt to jeje_sat [8h 9s 2h 3d]
jeje_sat: folds
NHBROOO: calls 700
RIZCHOU: raises 2450 to 3150
stephoumOPC: folds
Crakdeck: folds
phoud02: folds
NHBROOO: calls 2450
*** FLOP *** [4h 6d 7s]
NHBROOO: checks
RIZCHOU: bets 5513
NHBROOO: folds
Uncalled bet (5513) returned to RIZCHOU
RIZCHOU collected 7350 from pot
RIZCHOU: doesn't show hand
*** SUMMARY ***
Total pot 7350 | Rake 0
Board [4h 6d 7s]
Seat 1: phoud02 (big blind) folded before Flop
Seat 2: jeje_sat folded before Flop (didn't bet)
Seat 3: NHBROOO folded on the Flop
Seat 4: RIZCHOU collected (7350)
Seat 5: stephoumOPC (button) folded before Flop (didn't bet)
Seat 6: Crakdeck (small blind) folded before Flop


PokerStars Home Game Hand #235284458144: {Club #4837790} Tournament #3391835049, €0.13+€0.05+€0.02 EUR Omaha Pot Limit - Level XII (350/700) - 2022/04/05 18:31:41 CET [2022/04/05 12:31:41 ET]
Table '3391835049 2' 6-max Seat #6 is the button
Seat 1: phoud02 (3127 in chips, €0.05 bounty)
Seat 2: jeje_sat (22385 in chips, €0.08 bounty)
Seat 3: NHBROOO (42348 in chips, €0.11 bounty)
Seat 4: RIZCHOU (14514 in chips, €0.05 bounty)
Seat 5: stephoumOPC (11938 in chips, €0.11 bounty)
Seat 6: Crakdeck (5688 in chips, €0.15 bounty)
phoud02: posts small blind 350
jeje_sat: posts big blind 700
*** HOLE CARDS ***
Dealt to jeje_sat [Td 7h Ah Th]
NHBROOO: folds
RIZCHOU: folds
stephoumOPC: raises 700 to 1400
Crakdeck: folds
phoud02: raises 1727 to 3127 and is all-in
jeje_sat: calls 2427
stephoumOPC: calls 1727
*** FLOP *** [8c 2h 8s]
jeje_sat: bets 9381
stephoumOPC: folds
Uncalled bet (9381) returned to jeje_sat
*** TURN *** [8c 2h 8s] [Kc]
*** RIVER *** [8c 2h 8s Kc] [Qc]
*** SHOW DOWN ***
phoud02: shows [Ts As Qd 2s] (two pair, Queens and Eights)
jeje_sat: shows [Td 7h Ah Th] (two pair, Tens and Eights)
phoud02 collected 9381 from pot
*** SUMMARY ***
Total pot 9381 | Rake 0
Board [8c 2h 8s Kc Qc]
Seat 1: phoud02 (small blind) showed [Ts As Qd 2s] and won (9381) with two pair, Queens and Eights
Seat 2: jeje_sat (big blind) showed [Td 7h Ah Th] and lost with two pair, Tens and Eights
Seat 3: NHBROOO folded before Flop (didn't bet)
Seat 4: RIZCHOU folded before Flop (didn't bet)
Seat 5: stephoumOPC folded on the Flop
Seat 6: Crakdeck (button) folded before Flop (didn't bet)


PokerStars Home Game Hand #235284473199: {Club #4837790} Tournament #3391835049, €0.13+€0.05+€0.02 EUR Omaha Pot Limit - Level XII (350/700) - 2022/04/05 18:32:24 CET [2022/04/05 12:32:24 ET]
Table '3391835049 2' 6-max Seat #1 is the button
Seat 1: phoud02 (9381 in chips, €0.05 bounty)
Seat 2: jeje_sat (19258 in chips, €0.08 bounty)
Seat 3: NHBROOO (42348 in chips, €0.11 bounty)
Seat 4: RIZCHOU (14514 in chips, €0.05 bounty)
Seat 5: stephoumOPC (8811 in chips, €0.11 bounty)
Seat 6: Crakdeck (5688 in chips, €0.15 bounty)
jeje_sat: posts small blind 350
NHBROOO: posts big blind 700
*** HOLE CARDS ***
Dealt to jeje_sat [4s 9d 3c 7c]
RIZCHOU: raises 1750 to 2450
stephoumOPC: folds
Crakdeck: folds
phoud02: folds
jeje_sat: folds
NHBROOO: folds
Uncalled bet (1750) returned to RIZCHOU
RIZCHOU collected 1750 from pot
RIZCHOU: doesn't show hand
*** SUMMARY ***
Total pot 1750 | Rake 0
Seat 1: phoud02 (button) folded before Flop (didn't bet)
Seat 2: jeje_sat (small blind) folded before Flop
Seat 3: NHBROOO (big blind) folded before Flop
Seat 4: RIZCHOU collected (1750)
Seat 5: stephoumOPC folded before Flop (didn't bet)
Seat 6: Crakdeck folded before Flop (didn't bet)


PokerStars Home Game Hand #235284485371: {Club #4837790} Tournament #3391835049, €0.13+€0.05+€0.02 EUR Omaha Pot Limit - Level XII (350/700) - 2022/04/05 18:32:58 CET [2022/04/05 12:32:58 ET]
Table '3391835049 2' 6-max Seat #2 is the button
Seat 1: phoud02 (9381 in chips, €0.05 bounty)
Seat 2: jeje_sat (18908 in chips, €0.08 bounty)
Seat 3: NHBROOO (41648 in chips, €0.11 bounty)
Seat 4: RIZCHOU (15564 in chips, €0.05 bounty)
Seat 5: stephoumOPC (8811 in chips, €0.11 bounty)
Seat 6: Crakdeck (5688 in chips, €0.15 bounty)
NHBROOO: posts small blind 350
RIZCHOU: posts big blind 700
*** HOLE CARDS ***
Dealt to jeje_sat [6s 5s As 4d]
stephoumOPC: folds
Crakdeck: folds
phoud02: folds
jeje_sat: raises 1750 to 2450
NHBROOO: calls 2100
RIZCHOU: folds
*** FLOP *** [Qh Ks 8h]
NHBROOO: checks
jeje_sat: checks
*** TURN *** [Qh Ks 8h] [2d]
NHBROOO: checks
jeje_sat: bets 3500
NHBROOO: calls 3500
*** RIVER *** [Qh Ks 8h 2d] [9h]
NHBROOO: checks
jeje_sat: bets 12600
NHBROOO: folds
Uncalled bet (12600) returned to jeje_sat
jeje_sat collected 12600 from pot
jeje_sat: doesn't show hand
*** SUMMARY ***
Total pot 12600 | Rake 0
Board [Qh Ks 8h 2d 9h]
Seat 1: phoud02 folded before Flop (didn't bet)
Seat 2: jeje_sat (button) collected (12600)
Seat 3: NHBROOO (small blind) folded on the River
Seat 4: RIZCHOU (big blind) folded before Flop
Seat 5: stephoumOPC folded before Flop (didn't bet)
Seat 6: Crakdeck folded before Flop (didn't bet)


PokerStars Home Game Hand #235284504096: {Club #4837790} Tournament #3391835049, €0.13+€0.05+€0.02 EUR Omaha Pot Limit - Level XII (350/700) - 2022/04/05 18:33:52 CET [2022/04/05 12:33:52 ET]
Table '3391835049 2' 6-max Seat #3 is the button
Seat 1: phoud02 (9381 in chips, €0.05 bounty)
Seat 2: jeje_sat (25558 in chips, €0.08 bounty)
Seat 3: NHBROOO (35698 in chips, €0.11 bounty)
Seat 4: RIZCHOU (14864 in chips, €0.05 bounty)
Seat 5: stephoumOPC (8811 in chips, €0.11 bounty)
Seat 6: Crakdeck (5688 in chips, €0.15 bounty)
RIZCHOU: posts small blind 350
stephoumOPC: posts big blind 700
*** HOLE CARDS ***
Dealt to jeje_sat [3s Ts Kd Th]
Crakdeck: folds
phoud02: folds
jeje_sat: folds
NHBROOO: folds
RIZCHOU: raises 1400 to 2100
stephoumOPC: folds
Uncalled bet (1400) returned to RIZCHOU
RIZCHOU collected 1400 from pot
RIZCHOU: doesn't show hand
*** SUMMARY ***
Total pot 1400 | Rake 0
Seat 1: phoud02 folded before Flop (didn't bet)
Seat 2: jeje_sat folded before Flop (didn't bet)
Seat 3: NHBROOO (button) folded before Flop (didn't bet)
Seat 4: RIZCHOU (small blind) collected (1400)
Seat 5: stephoumOPC (big blind) folded before Flop
Seat 6: Crakdeck folded before Flop (didn't bet)


PokerStars Home Game Hand #235284515988: {Club #4837790} Tournament #3391835049, €0.13+€0.05+€0.02 EUR Omaha Pot Limit - Level XII (350/700) - 2022/04/05 18:34:26 CET [2022/04/05 12:34:26 ET]
Table '3391835049 2' 6-max Seat #4 is the button
Seat 1: phoud02 (9381 in chips, €0.05 bounty)
Seat 2: jeje_sat (25558 in chips, €0.08 bounty)
Seat 3: NHBROOO (35698 in chips, €0.11 bounty)
Seat 4: RIZCHOU (15564 in chips, €0.05 bounty)
Seat 5: stephoumOPC (8111 in chips, €0.11 bounty)
Seat 6: Crakdeck (5688 in chips, €0.15 bounty)
stephoumOPC: posts small blind 350
Crakdeck: posts big blind 700
*** HOLE CARDS ***
Dealt to jeje_sat [2s 2h Qd 3s]
phoud02: folds
jeje_sat: folds
NHBROOO: calls 700
RIZCHOU: calls 700
stephoumOPC: raises 2800 to 3500
Crakdeck: folds
NHBROOO: folds
RIZCHOU: raises 8400 to 11900
stephoumOPC: calls 4611 and is all-in
Uncalled bet (3789) returned to RIZCHOU
*** FLOP *** [8d Jh 8h]
*** TURN *** [8d Jh 8h] [4c]
*** RIVER *** [8d Jh 8h 4c] [8c]
*** SHOW DOWN ***
stephoumOPC: shows [Ac 6d Kc Kd] (a full house, Eights full of Kings)
RIZCHOU: shows [2c Td 9d Th] (a full house, Eights full of Tens)
stephoumOPC collected 17622 from pot
*** SUMMARY ***
Total pot 17622 | Rake 0
Board [8d Jh 8h 4c 8c]
Seat 1: phoud02 folded before Flop (didn't bet)
Seat 2: jeje_sat folded before Flop (didn't bet)
Seat 3: NHBROOO folded before Flop
Seat 4: RIZCHOU (button) showed [2c Td 9d Th] and lost with a full house, Eights full of Tens
Seat 5: stephoumOPC (small blind) showed [Ac 6d Kc Kd] and won (17622) with a full house, Eights full of Kings
Seat 6: Crakdeck (big blind) folded before Flop


PokerStars Home Game Hand #235284538991: {Club #4837790} Tournament #3391835049, €0.13+€0.05+€0.02 EUR Omaha Pot Limit - Level XIII (400/800) - 2022/04/05 18:35:31 CET [2022/04/05 12:35:31 ET]
Table '3391835049 2' 6-max Seat #5 is the button
Seat 1: phoud02 (9381 in chips, €0.05 bounty)
Seat 2: jeje_sat (25558 in chips, €0.08 bounty)
Seat 3: NHBROOO (34998 in chips, €0.11 bounty)
Seat 4: RIZCHOU (7453 in chips, €0.05 bounty)
Seat 5: stephoumOPC (17622 in chips, €0.11 bounty)
Seat 6: Crakdeck (4988 in chips, €0.15 bounty)
Crakdeck: posts small blind 400
phoud02: posts big blind 800
*** HOLE CARDS ***
Dealt to jeje_sat [6h 8c Qh 5h]
jeje_sat: folds
NHBROOO: raises 2000 to 2800
RIZCHOU: folds
stephoumOPC: folds
Crakdeck: raises 2000 to 4800
phoud02: folds
NHBROOO: raises 2000 to 6800
Crakdeck: calls 188 and is all-in
Uncalled bet (1812) returned to NHBROOO
*** FLOP *** [Ac Kc 6c]
*** TURN *** [Ac Kc 6c] [As]
*** RIVER *** [Ac Kc 6c As] [9s]
*** SHOW DOWN ***
Crakdeck: shows [Ks 7h Td 8d] (two pair, Aces and Kings)
NHBROOO: shows [Qc Jc 7c Ts] (a flush, Ace high)
NHBROOO collected 10776 from pot
NHBROOO wins €0.08 for eliminating Crakdeck and their own bounty increases by €0.07 to €0.18
Crakdeck finished the tournament in 6th place
*** SUMMARY ***
Total pot 10776 | Rake 0
Board [Ac Kc 6c As 9s]
Seat 1: phoud02 (big blind) folded before Flop
Seat 2: jeje_sat folded before Flop (didn't bet)
Seat 3: NHBROOO showed [Qc Jc 7c Ts] and won (10776) with a flush, Ace high
Seat 4: RIZCHOU folded before Flop (didn't bet)
Seat 5: stephoumOPC (button) folded before Flop (didn't bet)
Seat 6: Crakdeck (small blind) showed [Ks 7h Td 8d] and lost with two pair, Aces and Kings


PokerStars Home Game Hand #235284554226: {Club #4837790} Tournament #3391835049, €0.13+€0.05+€0.02 EUR Omaha Pot Limit - Level XIII (400/800) - 2022/04/05 18:36:14 CET [2022/04/05 12:36:14 ET]
Table '3391835049 2' 6-max Seat #1 is the button
Seat 1: phoud02 (8581 in chips, €0.05 bounty)
Seat 2: jeje_sat (25558 in chips, €0.08 bounty)
Seat 3: NHBROOO (40786 in chips, €0.18 bounty)
Seat 4: RIZCHOU (7453 in chips, €0.05 bounty)
Seat 5: stephoumOPC (17622 in chips, €0.11 bounty)
jeje_sat: posts small blind 400
NHBROOO: posts big blind 800
*** HOLE CARDS ***
Dealt to jeje_sat [2s Qs 2h 4d]
RIZCHOU: raises 2000 to 2800
stephoumOPC: folds
phoud02: folds
jeje_sat: folds
NHBROOO: calls 2000
*** FLOP *** [3h Jc Kc]
NHBROOO: bets 6000
RIZCHOU: calls 4653 and is all-in
Uncalled bet (1347) returned to NHBROOO
*** TURN *** [3h Jc Kc] [8s]
*** RIVER *** [3h Jc Kc 8s] [7s]
*** SHOW DOWN ***
NHBROOO: shows [5h Tc 8c Td] (a pair of Tens)
RIZCHOU: shows [Ac 7h 5s Qc] (a pair of Sevens)
NHBROOO collected 15306 from pot
NHBROOO wins €0.03 for eliminating RIZCHOU and their own bounty increases by €0.02 to €0.20
RIZCHOU finished the tournament in 5th place
*** SUMMARY ***
Total pot 15306 | Rake 0
Board [3h Jc Kc 8s 7s]
Seat 1: phoud02 (button) folded before Flop (didn't bet)
Seat 2: jeje_sat (small blind) folded before Flop
Seat 3: NHBROOO (big blind) showed [5h Tc 8c Td] and won (15306) with a pair of Tens
Seat 4: RIZCHOU showed [Ac 7h 5s Qc] and lost with a pair of Sevens
Seat 5: stephoumOPC folded before Flop (didn't bet)


PokerStars Home Game Hand #235284571564: {Club #4837790} Tournament #3391835049, €0.13+€0.05+€0.02 EUR Omaha Pot Limit - Level XIII (400/800) - 2022/04/05 18:37:03 CET [2022/04/05 12:37:03 ET]
Table '3391835049 2' 6-max Seat #2 is the button
Seat 1: phoud02 (8581 in chips, €0.05 bounty)
Seat 2: jeje_sat (25158 in chips, €0.08 bounty)
Seat 3: NHBROOO (48639 in chips, €0.20 bounty)
Seat 5: stephoumOPC (17622 in chips, €0.11 bounty)
NHBROOO: posts small blind 400
stephoumOPC: posts big blind 800
*** HOLE CARDS ***
Dealt to jeje_sat [Jc 3s Kd 9c]
phoud02: raises 2000 to 2800
jeje_sat: folds
NHBROOO: folds
stephoumOPC: folds
Uncalled bet (2000) returned to phoud02
phoud02 collected 2000 from pot
phoud02: doesn't show hand
*** SUMMARY ***
Total pot 2000 | Rake 0
Seat 1: phoud02 collected (2000)
Seat 2: jeje_sat (button) folded before Flop (didn't bet)
Seat 3: NHBROOO (small blind) folded before Flop
Seat 5: stephoumOPC (big blind) folded before Flop


PokerStars Home Game Hand #235284579522: {Club #4837790} Tournament #3391835049, €0.13+€0.05+€0.02 EUR Omaha Pot Limit - Level XIII (400/800) - 2022/04/05 18:37:25 CET [2022/04/05 12:37:25 ET]
Table '3391835049 2' 6-max Seat #3 is the button
Seat 1: phoud02 (9781 in chips, €0.05 bounty)
Seat 2: jeje_sat (25158 in chips, €0.08 bounty)
Seat 3: NHBROOO (48239 in chips, €0.20 bounty)
Seat 5: stephoumOPC (16822 in chips, €0.11 bounty)
stephoumOPC: posts small blind 400
phoud02: posts big blind 800
*** HOLE CARDS ***
Dealt to jeje_sat [5s Ks Ac 9d]
jeje_sat: folds
NHBROOO: folds
stephoumOPC: raises 1600 to 2400
phoud02: folds
Uncalled bet (1600) returned to stephoumOPC
stephoumOPC collected 1600 from pot
stephoumOPC: doesn't show hand
*** SUMMARY ***
Total pot 1600 | Rake 0
Seat 1: phoud02 (big blind) folded before Flop
Seat 2: jeje_sat folded before Flop (didn't bet)
Seat 3: NHBROOO (button) folded before Flop (didn't bet)
Seat 5: stephoumOPC (small blind) collected (1600)


PokerStars Home Game Hand #235284586318: {Club #4837790} Tournament #3391835049, €0.13+€0.05+€0.02 EUR Omaha Pot Limit - Level XIII (400/800) - 2022/04/05 18:37:44 CET [2022/04/05 12:37:44 ET]
Table '3391835049 2' 6-max Seat #5 is the button
Seat 1: phoud02 (8981 in chips, €0.05 bounty)
Seat 2: jeje_sat (25158 in chips, €0.08 bounty)
Seat 3: NHBROOO (48239 in chips, €0.20 bounty)
Seat 5: stephoumOPC (17622 in chips, €0.11 bounty)
phoud02: posts small blind 400
jeje_sat: posts big blind 800
*** HOLE CARDS ***
Dealt to jeje_sat [3c 5s Qc 7d]
NHBROOO: calls 800
stephoumOPC: folds
phoud02: calls 400
jeje_sat: checks
*** FLOP *** [2h Ac 9s]
phoud02: checks
jeje_sat: checks
NHBROOO: bets 1680
phoud02: folds
jeje_sat: folds
Uncalled bet (1680) returned to NHBROOO
NHBROOO collected 2400 from pot
NHBROOO: doesn't show hand
*** SUMMARY ***
Total pot 2400 | Rake 0
Board [2h Ac 9s]
Seat 1: phoud02 (small blind) folded on the Flop
Seat 2: jeje_sat (big blind) folded on the Flop
Seat 3: NHBROOO collected (2400)
Seat 5: stephoumOPC (button) folded before Flop (didn't bet)


PokerStars Home Game Hand #235284602905: {Club #4837790} Tournament #3391835049, €0.13+€0.05+€0.02 EUR Omaha Pot Limit - Level XIII (400/800) - 2022/04/05 18:38:31 CET [2022/04/05 12:38:31 ET]
Table '3391835049 2' 6-max Seat #1 is the button
Seat 1: phoud02 (8181 in chips, €0.05 bounty)
Seat 2: jeje_sat (24358 in chips, €0.08 bounty)
Seat 3: NHBROOO (49839 in chips, €0.20 bounty)
Seat 5: stephoumOPC (17622 in chips, €0.11 bounty)
jeje_sat: posts small blind 400
NHBROOO: posts big blind 800
*** HOLE CARDS ***
Dealt to jeje_sat [2c Jd 3s 9d]
stephoumOPC: raises 800 to 1600
phoud02: raises 4400 to 6000
jeje_sat: folds
NHBROOO: folds
stephoumOPC: folds
Uncalled bet (4400) returned to phoud02
phoud02 collected 4400 from pot
phoud02: doesn't show hand
*** SUMMARY ***
Total pot 4400 | Rake 0
Seat 1: phoud02 (button) collected (4400)
Seat 2: jeje_sat (small blind) folded before Flop
Seat 3: NHBROOO (big blind) folded before Flop
Seat 5: stephoumOPC folded before Flop


PokerStars Home Game Hand #235284616244: {Club #4837790} Tournament #3391835049, €0.13+€0.05+€0.02 EUR Omaha Pot Limit - Level XIII (400/800) - 2022/04/05 18:39:09 CET [2022/04/05 12:39:09 ET]
Table '3391835049 2' 6-max Seat #2 is the button
Seat 1: phoud02 (10981 in chips, €0.05 bounty)
Seat 2: jeje_sat (23958 in chips, €0.08 bounty)
Seat 3: NHBROOO (49039 in chips, €0.20 bounty)
Seat 5: stephoumOPC (16022 in chips, €0.11 bounty)
NHBROOO: posts small blind 400
stephoumOPC: posts big blind 800
*** HOLE CARDS ***
Dealt to jeje_sat [Js Ah 5c 2d]
phoud02: folds
jeje_sat: folds
NHBROOO: calls 400
stephoumOPC: checks
*** FLOP *** [9h Qc 4c]
NHBROOO: checks
stephoumOPC: bets 800
NHBROOO: folds
Uncalled bet (800) returned to stephoumOPC
stephoumOPC collected 1600 from pot
stephoumOPC: doesn't show hand
*** SUMMARY ***
Total pot 1600 | Rake 0
Board [9h Qc 4c]
Seat 1: phoud02 folded before Flop (didn't bet)
Seat 2: jeje_sat (button) folded before Flop (didn't bet)
Seat 3: NHBROOO (small blind) folded on the Flop
Seat 5: stephoumOPC (big blind) collected (1600)


PokerStars Home Game Hand #235284623152: {Club #4837790} Tournament #3391835049, €0.13+€0.05+€0.02 EUR Omaha Pot Limit - Level XIII (400/800) - 2022/04/05 18:39:28 CET [2022/04/05 12:39:28 ET]
Table '3391835049 2' 6-max Seat #3 is the button
Seat 1: phoud02 (10981 in chips, €0.05 bounty)
Seat 2: jeje_sat (23958 in chips, €0.08 bounty)
Seat 3: NHBROOO (48239 in chips, €0.20 bounty)
Seat 5: stephoumOPC (16822 in chips, €0.11 bounty)
stephoumOPC: posts small blind 400
phoud02: posts big blind 800
*** HOLE CARDS ***
Dealt to jeje_sat [9c Kc 3d Qh]
jeje_sat: folds
NHBROOO: calls 800
stephoumOPC: calls 400
phoud02: checks
*** FLOP *** [Jc Kh Jd]
stephoumOPC: checks
phoud02: checks
NHBROOO: bets 1680
stephoumOPC: folds
phoud02: folds
Uncalled bet (1680) returned to NHBROOO
NHBROOO collected 2400 from pot
NHBROOO: doesn't show hand
*** SUMMARY ***
Total pot 2400 | Rake 0
Board [Jc Kh Jd]
Seat 1: phoud02 (big blind) folded on the Flop
Seat 2: jeje_sat folded before Flop (didn't bet)
Seat 3: NHBROOO (button) collected (2400)
Seat 5: stephoumOPC (small blind) folded on the Flop


PokerStars Home Game Hand #235284643725: {Club #4837790} Tournament #3391835049, €0.13+€0.05+€0.02 EUR Omaha Pot Limit - Level XIV (500/1000) - 2022/04/05 18:40:27 CET [2022/04/05 12:40:27 ET]
Table '3391835049 2' 6-max Seat #5 is the button
Seat 1: phoud02 (10181 in chips, €0.05 bounty)
Seat 2: jeje_sat (23958 in chips, €0.08 bounty)
Seat 3: NHBROOO (49839 in chips, €0.20 bounty)
Seat 5: stephoumOPC (16022 in chips, €0.11 bounty)
phoud02: posts small blind 500
jeje_sat: posts big blind 1000
*** HOLE CARDS ***
Dealt to jeje_sat [As 7h 7s 8c]
NHBROOO: folds
stephoumOPC: folds
phoud02: folds
Uncalled bet (500) returned to jeje_sat
jeje_sat collected 1000 from pot
jeje_sat: doesn't show hand
*** SUMMARY ***
Total pot 1000 | Rake 0
Seat 1: phoud02 (small blind) folded before Flop
Seat 2: jeje_sat (big blind) collected (1000)
Seat 3: NHBROOO folded before Flop (didn't bet)
Seat 5: stephoumOPC (button) folded before Flop (didn't bet)


PokerStars Home Game Hand #235284647129: {Club #4837790} Tournament #3391835049, €0.13+€0.05+€0.02 EUR Omaha Pot Limit - Level XIV (500/1000) - 2022/04/05 18:40:37 CET [2022/04/05 12:40:37 ET]
Table '3391835049 2' 6-max Seat #1 is the button
Seat 1: phoud02 (9681 in chips, €0.05 bounty)
Seat 2: jeje_sat (24458 in chips, €0.08 bounty)
Seat 3: NHBROOO (49839 in chips, €0.20 bounty)
Seat 5: stephoumOPC (16022 in chips, €0.11 bounty)
jeje_sat: posts small blind 500
NHBROOO: posts big blind 1000
*** HOLE CARDS ***
Dealt to jeje_sat [Ts 2s 5s Kc]
stephoumOPC: folds
phoud02: folds
jeje_sat: folds
Uncalled bet (500) returned to NHBROOO
NHBROOO collected 1000 from pot
NHBROOO: doesn't show hand
*** SUMMARY ***
Total pot 1000 | Rake 0
Seat 1: phoud02 (button) folded before Flop (didn't bet)
Seat 2: jeje_sat (small blind) folded before Flop
Seat 3: NHBROOO (big blind) collected (1000)
Seat 5: stephoumOPC folded before Flop (didn't bet)


PokerStars Home Game Hand #235284651400: {Club #4837790} Tournament #3391835049, €0.13+€0.05+€0.02 EUR Omaha Pot Limit - Level XIV (500/1000) - 2022/04/05 18:40:49 CET [2022/04/05 12:40:49 ET]
Table '3391835049 2' 6-max Seat #2 is the button
Seat 1: phoud02 (9681 in chips, €0.05 bounty)
Seat 2: jeje_sat (23958 in chips, €0.08 bounty)
Seat 3: NHBROOO (50339 in chips, €0.20 bounty)
Seat 5: stephoumOPC (16022 in chips, €0.11 bounty)
NHBROOO: posts small blind 500
stephoumOPC: posts big blind 1000
*** HOLE CARDS ***
Dealt to jeje_sat [9c 4s Tc 2d]
phoud02: folds
jeje_sat: folds
NHBROOO: calls 500
stephoumOPC: checks
*** FLOP *** [Ah 2c Jh]
NHBROOO: bets 1000
stephoumOPC: folds
Uncalled bet (1000) returned to NHBROOO
NHBROOO collected 2000 from pot
NHBROOO: doesn't show hand
*** SUMMARY ***
Total pot 2000 | Rake 0
Board [Ah 2c Jh]
Seat 1: phoud02 folded before Flop (didn't bet)
Seat 2: jeje_sat (button) folded before Flop (didn't bet)
Seat 3: NHBROOO (small blind) collected (2000)
Seat 5: stephoumOPC (big blind) folded on the Flop


PokerStars Home Game Hand #235284663909: {Club #4837790} Tournament #3391835049, €0.13+€0.05+€0.02 EUR Omaha Pot Limit - Level XIV (500/1000) - 2022/04/05 18:41:25 CET [2022/04/05 12:41:25 ET]
Table '3391835049 2' 6-max Seat #3 is the button
Seat 1: phoud02 (9681 in chips, €0.05 bounty)
Seat 2: jeje_sat (23958 in chips, €0.08 bounty)
Seat 3: NHBROOO (51339 in chips, €0.20 bounty)
Seat 5: stephoumOPC (15022 in chips, €0.11 bounty)
stephoumOPC: posts small blind 500
phoud02: posts big blind 1000
*** HOLE CARDS ***
Dealt to jeje_sat [4d 5h 5d 3s]
jeje_sat: folds
NHBROOO: folds
stephoumOPC: raises 2000 to 3000
phoud02: folds
Uncalled bet (2000) returned to stephoumOPC
stephoumOPC collected 2000 from pot
stephoumOPC: doesn't show hand
*** SUMMARY ***
Total pot 2000 | Rake 0
Seat 1: phoud02 (big blind) folded before Flop
Seat 2: jeje_sat folded before Flop (didn't bet)
Seat 3: NHBROOO (button) folded before Flop (didn't bet)
Seat 5: stephoumOPC (small blind) collected (2000)


PokerStars Home Game Hand #235284669232: {Club #4837790} Tournament #3391835049, €0.13+€0.05+€0.02 EUR Omaha Pot Limit - Level XIV (500/1000) - 2022/04/05 18:41:40 CET [2022/04/05 12:41:40 ET]
Table '3391835049 2' 6-max Seat #5 is the button
Seat 1: phoud02 (8681 in chips, €0.05 bounty)
Seat 2: jeje_sat (23958 in chips, €0.08 bounty)
Seat 3: NHBROOO (51339 in chips, €0.20 bounty)
Seat 5: stephoumOPC (16022 in chips, €0.11 bounty)
phoud02: posts small blind 500
jeje_sat: posts big blind 1000
*** HOLE CARDS ***
Dealt to jeje_sat [Qd 2s 9c 8s]
NHBROOO: raises 2500 to 3500
stephoumOPC: folds
phoud02: raises 5181 to 8681 and is all-in
jeje_sat: folds
NHBROOO: calls 5181
*** FLOP *** [As 5c 9s]
*** TURN *** [As 5c 9s] [Js]
*** RIVER *** [As 5c 9s Js] [5s]
*** SHOW DOWN ***
phoud02: shows [Kc Ah Jh Jc] (a full house, Jacks full of Fives)
NHBROOO: shows [6h Qs Qh Th] (two pair, Queens and Fives)
phoud02 collected 18362 from pot
*** SUMMARY ***
Total pot 18362 | Rake 0
Board [As 5c 9s Js 5s]
Seat 1: phoud02 (small blind) showed [Kc Ah Jh Jc] and won (18362) with a full house, Jacks full of Fives
Seat 2: jeje_sat (big blind) folded before Flop
Seat 3: NHBROOO showed [6h Qs Qh Th] and lost with two pair, Queens and Fives
Seat 5: stephoumOPC (button) folded before Flop (didn't bet)


PokerStars Home Game Hand #235284679306: {Club #4837790} Tournament #3391835049, €0.13+€0.05+€0.02 EUR Omaha Pot Limit - Level XIV (500/1000) - 2022/04/05 18:42:09 CET [2022/04/05 12:42:09 ET]
Table '3391835049 2' 6-max Seat #1 is the button
Seat 1: phoud02 (18362 in chips, €0.05 bounty)
Seat 2: jeje_sat (22958 in chips, €0.08 bounty)
Seat 3: NHBROOO (42658 in chips, €0.20 bounty)
Seat 5: stephoumOPC (16022 in chips, €0.11 bounty)
jeje_sat: posts small blind 500
NHBROOO: posts big blind 1000
*** HOLE CARDS ***
Dealt to jeje_sat [5c Ks Jd Td]
stephoumOPC: raises 2500 to 3500
phoud02: folds
jeje_sat: folds
NHBROOO: folds
Uncalled bet (2500) returned to stephoumOPC
stephoumOPC collected 2500 from pot
stephoumOPC: doesn't show hand
*** SUMMARY ***
Total pot 2500 | Rake 0
Seat 1: phoud02 (button) folded before Flop (didn't bet)
Seat 2: jeje_sat (small blind) folded before Flop
Seat 3: NHBROOO (big blind) folded before Flop
Seat 5: stephoumOPC collected (2500)


PokerStars Home Game Hand #235284683973: {Club #4837790} Tournament #3391835049, €0.13+€0.05+€0.02 EUR Omaha Pot Limit - Level XIV (500/1000) - 2022/04/05 18:42:22 CET [2022/04/05 12:42:22 ET]
Table '3391835049 2' 6-max Seat #2 is the button
Seat 1: phoud02 (18362 in chips, €0.05 bounty)
Seat 2: jeje_sat (22458 in chips, €0.08 bounty)
Seat 3: NHBROOO (41658 in chips, €0.20 bounty)
Seat 5: stephoumOPC (17522 in chips, €0.11 bounty)
NHBROOO: posts small blind 500
stephoumOPC: posts big blind 1000
*** HOLE CARDS ***
Dealt to jeje_sat [7d 5s 8h 8c]
phoud02: folds
jeje_sat: raises 2500 to 3500
NHBROOO: folds
stephoumOPC: calls 2500
*** FLOP *** [As Ac Qs]
stephoumOPC: checks
jeje_sat: bets 3750
stephoumOPC: calls 3750
*** TURN *** [As Ac Qs] [Ad]
stephoumOPC: checks
jeje_sat: bets 15000
stephoumOPC: calls 10272 and is all-in
Uncalled bet (4728) returned to jeje_sat
*** RIVER *** [As Ac Qs Ad] [5c]
*** SHOW DOWN ***
stephoumOPC: shows [5h Qd Qh Jh] (a full house, Aces full of Queens)
jeje_sat: shows [7d 5s 8h 8c] (a full house, Aces full of Eights)
stephoumOPC collected 35544 from pot
*** SUMMARY ***
Total pot 35544 | Rake 0
Board [As Ac Qs Ad 5c]
Seat 1: phoud02 folded before Flop (didn't bet)
Seat 2: jeje_sat (button) showed [7d 5s 8h 8c] and lost with a full house, Aces full of Eights
Seat 3: NHBROOO (small blind) folded before Flop
Seat 5: stephoumOPC (big blind) showed [5h Qd Qh Jh] and won (35544) with a full house, Aces full of Queens


PokerStars Home Game Hand #235284706727: {Club #4837790} Tournament #3391835049, €0.13+€0.05+€0.02 EUR Omaha Pot Limit - Level XIV (500/1000) - 2022/04/05 18:43:26 CET [2022/04/05 12:43:26 ET]
Table '3391835049 2' 6-max Seat #3 is the button
Seat 1: phoud02 (18362 in chips, €0.05 bounty)
Seat 2: jeje_sat (4936 in chips, €0.08 bounty)
Seat 3: NHBROOO (41158 in chips, €0.20 bounty)
Seat 5: stephoumOPC (35544 in chips, €0.11 bounty)
stephoumOPC: posts small blind 500
phoud02: posts big blind 1000
*** HOLE CARDS ***
Dealt to jeje_sat [Ts Kd 8d 3c]
jeje_sat: folds
NHBROOO: folds
stephoumOPC: calls 500
phoud02: checks
*** FLOP *** [9d Ks Td]
stephoumOPC: bets 1000
phoud02: folds
Uncalled bet (1000) returned to stephoumOPC
stephoumOPC collected 2000 from pot
stephoumOPC: doesn't show hand
*** SUMMARY ***
Total pot 2000 | Rake 0
Board [9d Ks Td]
Seat 1: phoud02 (big blind) folded on the Flop
Seat 2: jeje_sat folded before Flop (didn't bet)
Seat 3: NHBROOO (button) folded before Flop (didn't bet)
Seat 5: stephoumOPC (small blind) collected (2000)


PokerStars Home Game Hand #235284713269: {Club #4837790} Tournament #3391835049, €0.13+€0.05+€0.02 EUR Omaha Pot Limit - Level XIV (500/1000) - 2022/04/05 18:43:45 CET [2022/04/05 12:43:45 ET]
Table '3391835049 2' 6-max Seat #5 is the button
Seat 1: phoud02 (17362 in chips, €0.05 bounty)
Seat 2: jeje_sat (4936 in chips, €0.08 bounty)
Seat 3: NHBROOO (41158 in chips, €0.20 bounty)
Seat 5: stephoumOPC (36544 in chips, €0.11 bounty)
phoud02: posts small blind 500
jeje_sat: posts big blind 1000
*** HOLE CARDS ***
Dealt to jeje_sat [Td 8d Ts 4c]
NHBROOO: folds
stephoumOPC: raises 1000 to 2000
phoud02: folds
jeje_sat: raises 2936 to 4936 and is all-in
stephoumOPC: calls 2936
*** FLOP *** [2s Jc 9h]
*** TURN *** [2s Jc 9h] [5h]
*** RIVER *** [2s Jc 9h 5h] [3c]
*** SHOW DOWN ***
jeje_sat: shows [Td 8d Ts 4c] (a pair of Tens)
stephoumOPC: shows [Th Qc 7h 6c] (high card Queen)
jeje_sat collected 10372 from pot
*** SUMMARY ***
Total pot 10372 | Rake 0
Board [2s Jc 9h 5h 3c]
Seat 1: phoud02 (small blind) folded before Flop
Seat 2: jeje_sat (big blind) showed [Td 8d Ts 4c] and won (10372) with a pair of Tens
Seat 3: NHBROOO folded before Flop (didn't bet)
Seat 5: stephoumOPC (button) showed [Th Qc 7h 6c] and lost with high card Queen


PokerStars Home Game Hand #235284720936: {Club #4837790} Tournament #3391835049, €0.13+€0.05+€0.02 EUR Omaha Pot Limit - Level XIV (500/1000) - 2022/04/05 18:44:07 CET [2022/04/05 12:44:07 ET]
Table '3391835049 2' 6-max Seat #1 is the button
Seat 1: phoud02 (16862 in chips, €0.05 bounty)
Seat 2: jeje_sat (10372 in chips, €0.08 bounty)
Seat 3: NHBROOO (41158 in chips, €0.20 bounty)
Seat 5: stephoumOPC (31608 in chips, €0.11 bounty)
jeje_sat: posts small blind 500
NHBROOO: posts big blind 1000
*** HOLE CARDS ***
Dealt to jeje_sat [Kd 3h 3s Th]
stephoumOPC: folds
phoud02: folds
jeje_sat: folds
Uncalled bet (500) returned to NHBROOO
NHBROOO collected 1000 from pot
NHBROOO: doesn't show hand
*** SUMMARY ***
Total pot 1000 | Rake 0
Seat 1: phoud02 (button) folded before Flop (didn't bet)
Seat 2: jeje_sat (small blind) folded before Flop
Seat 3: NHBROOO (big blind) collected (1000)
Seat 5: stephoumOPC folded before Flop (didn't bet)


PokerStars Home Game Hand #235284723752: {Club #4837790} Tournament #3391835049, €0.13+€0.05+€0.02 EUR Omaha Pot Limit - Level XIV (500/1000) - 2022/04/05 18:44:14 CET [2022/04/05 12:44:14 ET]
Table '3391835049 2' 6-max Seat #2 is the button
Seat 1: phoud02 (16862 in chips, €0.05 bounty)
Seat 2: jeje_sat (9872 in chips, €0.08 bounty)
Seat 3: NHBROOO (41658 in chips, €0.20 bounty)
Seat 5: stephoumOPC (31608 in chips, €0.11 bounty)
NHBROOO: posts small blind 500
stephoumOPC: posts big blind 1000
*** HOLE CARDS ***
Dealt to jeje_sat [8d 3h 9d 3d]
phoud02: folds
jeje_sat: folds
NHBROOO: calls 500
stephoumOPC: checks
*** FLOP *** [2d 6h 6c]
NHBROOO: checks
stephoumOPC: checks
*** TURN *** [2d 6h 6c] [4d]
NHBROOO: bets 2000
stephoumOPC: calls 2000
*** RIVER *** [2d 6h 6c 4d] [9s]
NHBROOO: checks
stephoumOPC: bets 3000
NHBROOO: calls 3000
*** SHOW DOWN ***
stephoumOPC: shows [Qc As Tc Ah] (two pair, Aces and Sixes)
NHBROOO: shows [6d 8h Ts 7c] (three of a kind, Sixes)
NHBROOO collected 12000 from pot
*** SUMMARY ***
Total pot 12000 | Rake 0
Board [2d 6h 6c 4d 9s]
Seat 1: phoud02 folded before Flop (didn't bet)
Seat 2: jeje_sat (button) folded before Flop (didn't bet)
Seat 3: NHBROOO (small blind) showed [6d 8h Ts 7c] and won (12000) with three of a kind, Sixes
Seat 5: stephoumOPC (big blind) showed [Qc As Tc Ah] and lost with two pair, Aces and Sixes


PokerStars Home Game Hand #235284734436: {Club #4837790} Tournament #3391835049, €0.13+€0.05+€0.02 EUR Omaha Pot Limit - Level XIV (500/1000) - 2022/04/05 18:44:45 CET [2022/04/05 12:44:45 ET]
Table '3391835049 2' 6-max Seat #3 is the button
Seat 1: phoud02 (16862 in chips, €0.05 bounty)
Seat 2: jeje_sat (9872 in chips, €0.08 bounty)
Seat 3: NHBROOO (47658 in chips, €0.20 bounty)
Seat 5: stephoumOPC (25608 in chips, €0.11 bounty)
stephoumOPC: posts small blind 500
phoud02: posts big blind 1000
*** HOLE CARDS ***
Dealt to jeje_sat [As 8s Qh Td]
jeje_sat: raises 2500 to 3500
NHBROOO: folds
stephoumOPC: folds
phoud02: folds
Uncalled bet (2500) returned to jeje_sat
jeje_sat collected 2500 from pot
jeje_sat: doesn't show hand
*** SUMMARY ***
Total pot 2500 | Rake 0
Seat 1: phoud02 (big blind) folded before Flop
Seat 2: jeje_sat collected (2500)
Seat 3: NHBROOO (button) folded before Flop (didn't bet)
Seat 5: stephoumOPC (small blind) folded before Flop


PokerStars Home Game Hand #235284739541: {Club #4837790} Tournament #3391835049, €0.13+€0.05+€0.02 EUR Omaha Pot Limit - Level XIV (500/1000) - 2022/04/05 18:45:00 CET [2022/04/05 12:45:00 ET]
Table '3391835049 2' 6-max Seat #5 is the button
Seat 1: phoud02 (15862 in chips, €0.05 bounty)
Seat 2: jeje_sat (11372 in chips, €0.08 bounty)
Seat 3: NHBROOO (47658 in chips, €0.20 bounty)
Seat 5: stephoumOPC (25108 in chips, €0.11 bounty)
phoud02: posts small blind 500
jeje_sat: posts big blind 1000
*** HOLE CARDS ***
Dealt to jeje_sat [Kh 3h 4c 6s]
NHBROOO: calls 1000
stephoumOPC: folds
phoud02: folds
jeje_sat: checks
*** FLOP *** [9h 8s Qd]
jeje_sat: checks
NHBROOO: bets 2500
jeje_sat: folds
Uncalled bet (2500) returned to NHBROOO
NHBROOO collected 2500 from pot
NHBROOO: doesn't show hand
*** SUMMARY ***
Total pot 2500 | Rake 0
Board [9h 8s Qd]
Seat 1: phoud02 (small blind) folded before Flop
Seat 2: jeje_sat (big blind) folded on the Flop
Seat 3: NHBROOO collected (2500)
Seat 5: stephoumOPC (button) folded before Flop (didn't bet)


PokerStars Home Game Hand #235284746626: {Club #4837790} Tournament #3391835049, €0.13+€0.05+€0.02 EUR Omaha Pot Limit - Level XV (600/1200) - 2022/04/05 18:45:20 CET [2022/04/05 12:45:20 ET]
Table '3391835049 2' 6-max Seat #1 is the button
Seat 1: phoud02 (15362 in chips, €0.05 bounty)
Seat 2: jeje_sat (10372 in chips, €0.08 bounty)
Seat 3: NHBROOO (49158 in chips, €0.20 bounty)
Seat 5: stephoumOPC (25108 in chips, €0.11 bounty)
jeje_sat: posts small blind 600
NHBROOO: posts big blind 1200
*** HOLE CARDS ***
Dealt to jeje_sat [Ts 4c Ks As]
stephoumOPC: folds
phoud02: folds
jeje_sat: raises 2400 to 3600
NHBROOO: folds
Uncalled bet (2400) returned to jeje_sat
jeje_sat collected 2400 from pot
jeje_sat: doesn't show hand
*** SUMMARY ***
Total pot 2400 | Rake 0
Seat 1: phoud02 (button) folded before Flop (didn't bet)
Seat 2: jeje_sat (small blind) collected (2400)
Seat 3: NHBROOO (big blind) folded before Flop
Seat 5: stephoumOPC folded before Flop (didn't bet)


PokerStars Home Game Hand #235284751478: {Club #4837790} Tournament #3391835049, €0.13+€0.05+€0.02 EUR Omaha Pot Limit - Level XV (600/1200) - 2022/04/05 18:45:34 CET [2022/04/05 12:45:34 ET]
Table '3391835049 2' 6-max Seat #2 is the button
Seat 1: phoud02 (15362 in chips, €0.05 bounty)
Seat 2: jeje_sat (11572 in chips, €0.08 bounty)
Seat 3: NHBROOO (47958 in chips, €0.20 bounty)
Seat 5: stephoumOPC (25108 in chips, €0.11 bounty)
NHBROOO: posts small blind 600
stephoumOPC: posts big blind 1200
*** HOLE CARDS ***
Dealt to jeje_sat [9d 4c 2d 4d]
phoud02: folds
jeje_sat: folds
NHBROOO: calls 600
stephoumOPC: checks
*** FLOP *** [4s 9s Tc]
NHBROOO: checks
stephoumOPC: bets 1200
NHBROOO: folds
Uncalled bet (1200) returned to stephoumOPC
stephoumOPC collected 2400 from pot
stephoumOPC: doesn't show hand
*** SUMMARY ***
Total pot 2400 | Rake 0
Board [4s 9s Tc]
Seat 1: phoud02 folded before Flop (didn't bet)
Seat 2: jeje_sat (button) folded before Flop (didn't bet)
Seat 3: NHBROOO (small blind) folded on the Flop
Seat 5: stephoumOPC (big blind) collected (2400)


PokerStars Home Game Hand #235284759598: {Club #4837790} Tournament #3391835049, €0.13+€0.05+€0.02 EUR Omaha Pot Limit - Level XV (600/1200) - 2022/04/05 18:45:56 CET [2022/04/05 12:45:56 ET]
Table '3391835049 2' 6-max Seat #3 is the button
Seat 1: phoud02 (15362 in chips, €0.05 bounty)
Seat 2: jeje_sat (11572 in chips, €0.08 bounty)
Seat 3: NHBROOO (46758 in chips, €0.20 bounty)
Seat 5: stephoumOPC (26308 in chips, €0.11 bounty)
stephoumOPC: posts small blind 600
phoud02: posts big blind 1200
*** HOLE CARDS ***
Dealt to jeje_sat [9h 7d 3h Qc]
jeje_sat: folds
NHBROOO: calls 1200
stephoumOPC: calls 600
phoud02: checks
*** FLOP *** [6c 4h 7s]
stephoumOPC: checks
phoud02: checks
NHBROOO: bets 1200
stephoumOPC: calls 1200
phoud02: folds
*** TURN *** [6c 4h 7s] [Kd]
stephoumOPC: checks
NHBROOO: checks
*** RIVER *** [6c 4h 7s Kd] [Th]
stephoumOPC: checks
NHBROOO: checks
*** SHOW DOWN ***
stephoumOPC: shows [Ac Td Ah 5s] (a pair of Aces)
NHBROOO: mucks hand
stephoumOPC collected 6000 from pot
*** SUMMARY ***
Total pot 6000 | Rake 0
Board [6c 4h 7s Kd Th]
Seat 1: phoud02 (big blind) folded on the Flop
Seat 2: jeje_sat folded before Flop (didn't bet)
Seat 3: NHBROOO (button) mucked [8c 8s 6s 3s]
Seat 5: stephoumOPC (small blind) showed [Ac Td Ah 5s] and won (6000) with a pair of Aces


PokerStars Home Game Hand #235284775013: {Club #4837790} Tournament #3391835049, €0.13+€0.05+€0.02 EUR Omaha Pot Limit - Level XV (600/1200) - 2022/04/05 18:46:40 CET [2022/04/05 12:46:40 ET]
Table '3391835049 2' 6-max Seat #5 is the button
Seat 1: phoud02 (14162 in chips, €0.05 bounty)
Seat 2: jeje_sat (11572 in chips, €0.08 bounty)
Seat 3: NHBROOO (44358 in chips, €0.20 bounty)
Seat 5: stephoumOPC (29908 in chips, €0.11 bounty)
phoud02: posts small blind 600
jeje_sat: posts big blind 1200
*** HOLE CARDS ***
Dealt to jeje_sat [3h 3s 5c Ac]
NHBROOO: calls 1200
stephoumOPC: folds
phoud02: folds
jeje_sat: raises 3000 to 4200
NHBROOO: calls 3000
*** FLOP *** [7h 6h Kc]
jeje_sat: bets 7372 and is all-in
NHBROOO: calls 7372
*** TURN *** [7h 6h Kc] [2c]
*** RIVER *** [7h 6h Kc 2c] [Qs]
*** SHOW DOWN ***
jeje_sat: shows [3h 3s 5c Ac] (a pair of Threes)
NHBROOO: shows [Td Ks 8d Qh] (two pair, Kings and Queens)
NHBROOO collected 23744 from pot
NHBROOO wins €0.04 for eliminating jeje_sat and their own bounty increases by €0.04 to €0.24
jeje_sat finished the tournament in 4th place and received €0.26.
*** SUMMARY ***
Total pot 23744 | Rake 0
Board [7h 6h Kc 2c Qs]
Seat 1: phoud02 (small blind) folded before Flop
Seat 2: jeje_sat (big blind) showed [3h 3s 5c Ac] and lost with a pair of Threes
Seat 3: NHBROOO showed [Td Ks 8d Qh] and won (23744) with two pair, Kings and Queens
Seat 5: stephoumOPC (button) folded before Flop (didn't bet)


