PokerStars Home Game Hand #235261198098: {Club #4837790} Tournament #3391322540, €0.13+€0.05+€0.02 EUR Hold'em No Limit - Level I (15/30) - 2022/04/04 17:30:00 CET [2022/04/04 11:30:00 ET]
Table '3391322540 2' 6-max Seat #2 is the button
Seat 2: jeje_sat (10000 in chips, €0.05 bounty)
Seat 3: jeannono24 (10000 in chips, €0.05 bounty)
Seat 4: Reyzous (10000 in chips, €0.05 bounty)
Seat 6: LDM54 (10000 in chips, €0.05 bounty)
jeje_sat: posts the ante 4
jeannono24: posts the ante 4
Reyzous: posts the ante 4
LDM54: posts the ante 4
jeannono24: posts small blind 15
Reyzous: posts big blind 30
*** HOLE CARDS ***
Dealt to jeje_sat [As Jd]
LDM54: folds
jeje_sat: raises 60 to 90
jeannono24: folds
Reyzous: calls 60
*** FLOP *** [3d Ks Qh]
Reyzous: checks
jeje_sat: bets 106
Reyzous: calls 106
*** TURN *** [3d Ks Qh] [9h]
Reyzous: bets 210
jeje_sat: calls 210
*** RIVER *** [3d Ks Qh 9h] [2d]
Reyzous: bets 585
jeje_sat: folds
Uncalled bet (585) returned to Reyzous
Reyzous collected 843 from pot
Reyzous: doesn't show hand
*** SUMMARY ***
Total pot 843 | Rake 0
Board [3d Ks Qh 9h 2d]
Seat 2: jeje_sat (button) folded on the River
Seat 3: jeannono24 (small blind) folded before Flop
Seat 4: Reyzous (big blind) collected (843)
Seat 6: LDM54 folded before Flop (didn't bet)


PokerStars Home Game Hand #235261218950: {Club #4837790} Tournament #3391322540, €0.13+€0.05+€0.02 EUR Hold'em No Limit - Level I (15/30) - 2022/04/04 17:31:07 CET [2022/04/04 11:31:07 ET]
Table '3391322540 2' 6-max Seat #3 is the button
Seat 2: jeje_sat (9590 in chips, €0.05 bounty)
Seat 3: jeannono24 (9981 in chips, €0.05 bounty)
Seat 4: Reyzous (10433 in chips, €0.05 bounty)
Seat 5: CoucouRico24 (10000 in chips, €0.05 bounty)
Seat 6: LDM54 (9996 in chips, €0.05 bounty)
jeje_sat: posts the ante 4
jeannono24: posts the ante 4
Reyzous: posts the ante 4
CoucouRico24: posts the ante 4
LDM54: posts the ante 4
Reyzous: posts small blind 15
CoucouRico24: posts big blind 30
*** HOLE CARDS ***
Dealt to jeje_sat [7s 9s]
LDM54: folds
jeje_sat: folds
jeannono24: raises 45 to 75
Reyzous: folds
CoucouRico24: folds
Uncalled bet (45) returned to jeannono24
jeannono24 collected 95 from pot
jeannono24: doesn't show hand
*** SUMMARY ***
Total pot 95 | Rake 0
Seat 2: jeje_sat folded before Flop (didn't bet)
Seat 3: jeannono24 (button) collected (95)
Seat 4: Reyzous (small blind) folded before Flop
Seat 5: CoucouRico24 (big blind) folded before Flop
Seat 6: LDM54 folded before Flop (didn't bet)


PokerStars Home Game Hand #235261232430: {Club #4837790} Tournament #3391322540, €0.13+€0.05+€0.02 EUR Hold'em No Limit - Level I (15/30) - 2022/04/04 17:31:50 CET [2022/04/04 11:31:50 ET]
Table '3391322540 2' 6-max Seat #4 is the button
Seat 2: jeje_sat (9586 in chips, €0.05 bounty)
Seat 3: jeannono24 (10042 in chips, €0.05 bounty)
Seat 4: Reyzous (10414 in chips, €0.05 bounty)
Seat 5: CoucouRico24 (9966 in chips, €0.05 bounty)
Seat 6: LDM54 (9992 in chips, €0.05 bounty)
jeje_sat: posts the ante 4
jeannono24: posts the ante 4
Reyzous: posts the ante 4
CoucouRico24: posts the ante 4
LDM54: posts the ante 4
CoucouRico24: posts small blind 15
LDM54: posts big blind 30
*** HOLE CARDS ***
Dealt to jeje_sat [9s 4s]
jeje_sat: folds
jeannono24: folds
Reyzous: raises 60 to 90
CoucouRico24: folds
LDM54: calls 60
*** FLOP *** [9c 5d As]
LDM54: checks
Reyzous: bets 60
LDM54: calls 60
*** TURN *** [9c 5d As] [4d]
LDM54: checks
Reyzous: checks
*** RIVER *** [9c 5d As 4d] [4h]
LDM54: bets 135
Reyzous: raises 255 to 390
LDM54: calls 255
*** SHOW DOWN ***
Reyzous: shows [Ts Ah] (two pair, Aces and Fours)
LDM54: shows [Ad Js] (two pair, Aces and Fours - Jack kicker)
LDM54 collected 1115 from pot
*** SUMMARY ***
Total pot 1115 | Rake 0
Board [9c 5d As 4d 4h]
Seat 2: jeje_sat folded before Flop (didn't bet)
Seat 3: jeannono24 folded before Flop (didn't bet)
Seat 4: Reyzous (button) showed [Ts Ah] and lost with two pair, Aces and Fours
Seat 5: CoucouRico24 (small blind) folded before Flop
Seat 6: LDM54 (big blind) showed [Ad Js] and won (1115) with two pair, Aces and Fours


PokerStars Home Game Hand #235261253817: {Club #4837790} Tournament #3391322540, €0.13+€0.05+€0.02 EUR Hold'em No Limit - Level I (15/30) - 2022/04/04 17:32:57 CET [2022/04/04 11:32:57 ET]
Table '3391322540 2' 6-max Seat #5 is the button
Seat 2: jeje_sat (9582 in chips, €0.05 bounty)
Seat 3: jeannono24 (10038 in chips, €0.05 bounty)
Seat 4: Reyzous (9870 in chips, €0.05 bounty)
Seat 5: CoucouRico24 (9947 in chips, €0.05 bounty)
Seat 6: LDM54 (10563 in chips, €0.05 bounty)
jeje_sat: posts the ante 4
jeannono24: posts the ante 4
Reyzous: posts the ante 4
CoucouRico24: posts the ante 4
LDM54: posts the ante 4
LDM54: posts small blind 15
jeje_sat: posts big blind 30
*** HOLE CARDS ***
Dealt to jeje_sat [3s 5d]
jeannono24: folds
Reyzous: raises 30 to 60
CoucouRico24: folds
LDM54: folds
jeje_sat: folds
Uncalled bet (30) returned to Reyzous
Reyzous collected 95 from pot
Reyzous: doesn't show hand
*** SUMMARY ***
Total pot 95 | Rake 0
Seat 2: jeje_sat (big blind) folded before Flop
Seat 3: jeannono24 folded before Flop (didn't bet)
Seat 4: Reyzous collected (95)
Seat 5: CoucouRico24 (button) folded before Flop (didn't bet)
Seat 6: LDM54 (small blind) folded before Flop


PokerStars Home Game Hand #235261261718: {Club #4837790} Tournament #3391322540, €0.13+€0.05+€0.02 EUR Hold'em No Limit - Level I (15/30) - 2022/04/04 17:33:22 CET [2022/04/04 11:33:22 ET]
Table '3391322540 2' 6-max Seat #6 is the button
Seat 2: jeje_sat (9548 in chips, €0.05 bounty)
Seat 3: jeannono24 (10034 in chips, €0.05 bounty)
Seat 4: Reyzous (9931 in chips, €0.05 bounty)
Seat 5: CoucouRico24 (9943 in chips, €0.05 bounty)
Seat 6: LDM54 (10544 in chips, €0.05 bounty)
jeje_sat: posts the ante 4
jeannono24: posts the ante 4
Reyzous: posts the ante 4
CoucouRico24: posts the ante 4
LDM54: posts the ante 4
jeje_sat: posts small blind 15
jeannono24: posts big blind 30
*** HOLE CARDS ***
Dealt to jeje_sat [2s 7h]
Reyzous: folds
CoucouRico24: raises 60 to 90
LDM54: folds
jeje_sat: folds
jeannono24: folds
Uncalled bet (60) returned to CoucouRico24
CoucouRico24 collected 95 from pot
CoucouRico24: doesn't show hand
*** SUMMARY ***
Total pot 95 | Rake 0
Seat 2: jeje_sat (small blind) folded before Flop
Seat 3: jeannono24 (big blind) folded before Flop
Seat 4: Reyzous folded before Flop (didn't bet)
Seat 5: CoucouRico24 collected (95)
Seat 6: LDM54 (button) folded before Flop (didn't bet)


PokerStars Home Game Hand #235261274797: {Club #4837790} Tournament #3391322540, €0.13+€0.05+€0.02 EUR Hold'em No Limit - Level I (15/30) - 2022/04/04 17:34:04 CET [2022/04/04 11:34:04 ET]
Table '3391322540 2' 6-max Seat #2 is the button
Seat 2: jeje_sat (9529 in chips, €0.05 bounty)
Seat 3: jeannono24 (10000 in chips, €0.05 bounty)
Seat 4: Reyzous (9927 in chips, €0.05 bounty)
Seat 5: CoucouRico24 (10004 in chips, €0.05 bounty)
Seat 6: LDM54 (10540 in chips, €0.05 bounty)
jeje_sat: posts the ante 4
jeannono24: posts the ante 4
Reyzous: posts the ante 4
CoucouRico24: posts the ante 4
LDM54: posts the ante 4
jeannono24: posts small blind 15
Reyzous: posts big blind 30
*** HOLE CARDS ***
Dealt to jeje_sat [Ah 5c]
CoucouRico24: folds
LDM54: folds
jeje_sat: raises 60 to 90
jeannono24: calls 75
Reyzous: calls 60
*** FLOP *** [Tc 7c 6h]
jeannono24: checks
Reyzous: checks
jeje_sat: bets 145
jeannono24: folds
Reyzous: calls 145
*** TURN *** [Tc 7c 6h] [5d]
Reyzous: checks
jeje_sat: bets 300
Reyzous: calls 300
*** RIVER *** [Tc 7c 6h 5d] [Ad]
Reyzous: checks
jeje_sat: bets 840
Reyzous: folds
Uncalled bet (840) returned to jeje_sat
jeje_sat collected 1180 from pot
jeje_sat: doesn't show hand
*** SUMMARY ***
Total pot 1180 | Rake 0
Board [Tc 7c 6h 5d Ad]
Seat 2: jeje_sat (button) collected (1180)
Seat 3: jeannono24 (small blind) folded on the Flop
Seat 4: Reyzous (big blind) folded on the River
Seat 5: CoucouRico24 folded before Flop (didn't bet)
Seat 6: LDM54 folded before Flop (didn't bet)


PokerStars Home Game Hand #235261303532: {Club #4837790} Tournament #3391322540, €0.13+€0.05+€0.02 EUR Hold'em No Limit - Level II (25/50) - 2022/04/04 17:35:35 CET [2022/04/04 11:35:35 ET]
Table '3391322540 2' 6-max Seat #3 is the button
Seat 2: jeje_sat (10170 in chips, €0.05 bounty)
Seat 3: jeannono24 (9906 in chips, €0.05 bounty)
Seat 4: Reyzous (9388 in chips, €0.05 bounty)
Seat 5: CoucouRico24 (10000 in chips, €0.05 bounty)
Seat 6: LDM54 (10536 in chips, €0.05 bounty)
jeje_sat: posts the ante 6
jeannono24: posts the ante 6
Reyzous: posts the ante 6
CoucouRico24: posts the ante 6
LDM54: posts the ante 6
Reyzous: posts small blind 25
CoucouRico24: posts big blind 50
*** HOLE CARDS ***
Dealt to jeje_sat [Jc Qs]
LDM54: folds
jeje_sat: raises 100 to 150
jeannono24: folds
Reyzous: folds
CoucouRico24: calls 100
*** FLOP *** [2h Js 4c]
CoucouRico24: bets 178
jeje_sat: calls 178
*** TURN *** [2h Js 4c] [5h]
CoucouRico24: checks
jeje_sat: bets 450
CoucouRico24: folds
Uncalled bet (450) returned to jeje_sat
jeje_sat collected 711 from pot
jeje_sat: doesn't show hand
*** SUMMARY ***
Total pot 711 | Rake 0
Board [2h Js 4c 5h]
Seat 2: jeje_sat collected (711)
Seat 3: jeannono24 (button) folded before Flop (didn't bet)
Seat 4: Reyzous (small blind) folded before Flop
Seat 5: CoucouRico24 (big blind) folded on the Turn
Seat 6: LDM54 folded before Flop (didn't bet)


PokerStars Home Game Hand #235261327343: {Club #4837790} Tournament #3391322540, €0.13+€0.05+€0.02 EUR Hold'em No Limit - Level II (25/50) - 2022/04/04 17:36:50 CET [2022/04/04 11:36:50 ET]
Table '3391322540 2' 6-max Seat #4 is the button
Seat 1: sygowin (10000 in chips, €0.05 bounty)
Seat 2: jeje_sat (10547 in chips, €0.05 bounty)
Seat 3: jeannono24 (9900 in chips, €0.05 bounty)
Seat 4: Reyzous (9357 in chips, €0.05 bounty)
Seat 5: CoucouRico24 (9666 in chips, €0.05 bounty)
Seat 6: LDM54 (10530 in chips, €0.05 bounty)
sygowin: posts the ante 6
jeje_sat: posts the ante 6
jeannono24: posts the ante 6
Reyzous: posts the ante 6
CoucouRico24: posts the ante 6
LDM54: posts the ante 6
CoucouRico24: posts small blind 25
LDM54: posts big blind 50
*** HOLE CARDS ***
Dealt to jeje_sat [Kc 8c]
sygowin: raises 100 to 150
jeje_sat: folds
jeannono24: folds
Reyzous: folds
CoucouRico24: calls 125
LDM54: calls 100
*** FLOP *** [Ks 5d 6h]
sygowin said, "slt tlm"
CoucouRico24: checks
LDM54: checks
sygowin: checks
*** TURN *** [Ks 5d 6h] [Th]
CoucouRico24: checks
LDM54: checks
sygowin: checks
*** RIVER *** [Ks 5d 6h Th] [Qs]
LDM54 said, "slt sygo"
CoucouRico24: checks
LDM54: bets 160
sygowin: raises 290 to 450
CoucouRico24: folds
LDM54: calls 290
*** SHOW DOWN ***
sygowin: shows [Ah Jc] (a straight, Ten to Ace)
LDM54: mucks hand
sygowin collected 1386 from pot
*** SUMMARY ***
Total pot 1386 | Rake 0
Board [Ks 5d 6h Th Qs]
Seat 1: sygowin showed [Ah Jc] and won (1386) with a straight, Ten to Ace
Seat 2: jeje_sat folded before Flop (didn't bet)
Seat 3: jeannono24 folded before Flop (didn't bet)
Seat 4: Reyzous (button) folded before Flop (didn't bet)
Seat 5: CoucouRico24 (small blind) folded on the River
Seat 6: LDM54 (big blind) mucked [Jd 9d]


PokerStars Home Game Hand #235261349223: {Club #4837790} Tournament #3391322540, €0.13+€0.05+€0.02 EUR Hold'em No Limit - Level II (25/50) - 2022/04/04 17:38:00 CET [2022/04/04 11:38:00 ET]
Table '3391322540 2' 6-max Seat #5 is the button
Seat 1: sygowin (10780 in chips, €0.05 bounty)
Seat 2: jeje_sat (10541 in chips, €0.05 bounty)
Seat 3: jeannono24 (9894 in chips, €0.05 bounty)
Seat 4: Reyzous (9351 in chips, €0.05 bounty)
Seat 5: CoucouRico24 (9510 in chips, €0.05 bounty)
Seat 6: LDM54 (9924 in chips, €0.05 bounty)
sygowin: posts the ante 6
jeje_sat: posts the ante 6
jeannono24: posts the ante 6
Reyzous: posts the ante 6
CoucouRico24: posts the ante 6
LDM54: posts the ante 6
LDM54: posts small blind 25
sygowin: posts big blind 50
*** HOLE CARDS ***
Dealt to jeje_sat [Th Kh]
jeje_sat: folds
jeannono24: folds
Reyzous: folds
CoucouRico24: folds
LDM54: folds
Uncalled bet (25) returned to sygowin
sygowin collected 86 from pot
sygowin: doesn't show hand
*** SUMMARY ***
Total pot 86 | Rake 0
Seat 1: sygowin (big blind) collected (86)
Seat 2: jeje_sat folded before Flop (didn't bet)
Seat 3: jeannono24 folded before Flop (didn't bet)
Seat 4: Reyzous folded before Flop (didn't bet)
Seat 5: CoucouRico24 (button) folded before Flop (didn't bet)
Seat 6: LDM54 (small blind) folded before Flop


PokerStars Home Game Hand #235261352911: {Club #4837790} Tournament #3391322540, €0.13+€0.05+€0.02 EUR Hold'em No Limit - Level II (25/50) - 2022/04/04 17:38:11 CET [2022/04/04 11:38:11 ET]
Table '3391322540 2' 6-max Seat #6 is the button
Seat 1: sygowin (10835 in chips, €0.05 bounty)
Seat 2: jeje_sat (10535 in chips, €0.05 bounty)
Seat 3: jeannono24 (9888 in chips, €0.05 bounty)
Seat 4: Reyzous (9345 in chips, €0.05 bounty)
Seat 5: CoucouRico24 (9504 in chips, €0.05 bounty)
Seat 6: LDM54 (9893 in chips, €0.05 bounty)
sygowin: posts the ante 6
jeje_sat: posts the ante 6
jeannono24: posts the ante 6
Reyzous: posts the ante 6
CoucouRico24: posts the ante 6
LDM54: posts the ante 6
sygowin: posts small blind 25
jeje_sat: posts big blind 50
*** HOLE CARDS ***
Dealt to jeje_sat [4s 2d]
jeannono24: folds
Reyzous: raises 50 to 100
CoucouRico24: folds
LDM54: folds
sygowin: folds
jeje_sat: folds
Uncalled bet (50) returned to Reyzous
Reyzous collected 161 from pot
Reyzous: doesn't show hand
*** SUMMARY ***
Total pot 161 | Rake 0
Seat 1: sygowin (small blind) folded before Flop
Seat 2: jeje_sat (big blind) folded before Flop
Seat 3: jeannono24 folded before Flop (didn't bet)
Seat 4: Reyzous collected (161)
Seat 5: CoucouRico24 folded before Flop (didn't bet)
Seat 6: LDM54 (button) folded before Flop (didn't bet)


PokerStars Home Game Hand #235261359439: {Club #4837790} Tournament #3391322540, €0.13+€0.05+€0.02 EUR Hold'em No Limit - Level II (25/50) - 2022/04/04 17:38:32 CET [2022/04/04 11:38:32 ET]
Table '3391322540 2' 6-max Seat #1 is the button
Seat 1: sygowin (10804 in chips, €0.05 bounty)
Seat 2: jeje_sat (10479 in chips, €0.05 bounty)
Seat 3: jeannono24 (9882 in chips, €0.05 bounty)
Seat 4: Reyzous (9450 in chips, €0.05 bounty)
Seat 5: CoucouRico24 (9498 in chips, €0.05 bounty)
Seat 6: LDM54 (9887 in chips, €0.05 bounty)
sygowin: posts the ante 6
jeje_sat: posts the ante 6
jeannono24: posts the ante 6
Reyzous: posts the ante 6
CoucouRico24: posts the ante 6
LDM54: posts the ante 6
jeje_sat: posts small blind 25
jeannono24: posts big blind 50
*** HOLE CARDS ***
Dealt to jeje_sat [2s Qd]
Reyzous: folds
CoucouRico24: raises 50 to 100
LDM54: folds
sygowin: folds
jeje_sat: folds
jeannono24: folds
Uncalled bet (50) returned to CoucouRico24
CoucouRico24 collected 161 from pot
CoucouRico24: doesn't show hand
*** SUMMARY ***
Total pot 161 | Rake 0
Seat 1: sygowin (button) folded before Flop (didn't bet)
Seat 2: jeje_sat (small blind) folded before Flop
Seat 3: jeannono24 (big blind) folded before Flop
Seat 4: Reyzous folded before Flop (didn't bet)
Seat 5: CoucouRico24 collected (161)
Seat 6: LDM54 folded before Flop (didn't bet)


PokerStars Home Game Hand #235261366098: {Club #4837790} Tournament #3391322540, €0.13+€0.05+€0.02 EUR Hold'em No Limit - Level II (25/50) - 2022/04/04 17:38:53 CET [2022/04/04 11:38:53 ET]
Table '3391322540 2' 6-max Seat #2 is the button
Seat 1: sygowin (10798 in chips, €0.05 bounty)
Seat 2: jeje_sat (10448 in chips, €0.05 bounty)
Seat 3: jeannono24 (9826 in chips, €0.05 bounty)
Seat 4: Reyzous (9444 in chips, €0.05 bounty)
Seat 5: CoucouRico24 (9603 in chips, €0.05 bounty)
Seat 6: LDM54 (9881 in chips, €0.05 bounty)
sygowin: posts the ante 6
jeje_sat: posts the ante 6
jeannono24: posts the ante 6
Reyzous: posts the ante 6
CoucouRico24: posts the ante 6
LDM54: posts the ante 6
jeannono24: posts small blind 25
Reyzous: posts big blind 50
*** HOLE CARDS ***
Dealt to jeje_sat [6h Qs]
CoucouRico24: folds
LDM54: folds
sygowin: folds
jeje_sat: raises 100 to 150
jeannono24: folds
Reyzous: calls 100
*** FLOP *** [5d 6d 3s]
Reyzous: checks
jeje_sat: bets 181
Reyzous: calls 181
*** TURN *** [5d 6d 3s] [8c]
Reyzous: bets 350
jeje_sat: folds
Uncalled bet (350) returned to Reyzous
Reyzous collected 723 from pot
Reyzous: doesn't show hand
*** SUMMARY ***
Total pot 723 | Rake 0
Board [5d 6d 3s 8c]
Seat 1: sygowin folded before Flop (didn't bet)
Seat 2: jeje_sat (button) folded on the Turn
Seat 3: jeannono24 (small blind) folded before Flop
Seat 4: Reyzous (big blind) collected (723)
Seat 5: CoucouRico24 folded before Flop (didn't bet)
Seat 6: LDM54 folded before Flop (didn't bet)


PokerStars Home Game Hand #235261383214: {Club #4837790} Tournament #3391322540, €0.13+€0.05+€0.02 EUR Hold'em No Limit - Level II (25/50) - 2022/04/04 17:39:46 CET [2022/04/04 11:39:46 ET]
Table '3391322540 2' 6-max Seat #3 is the button
Seat 1: sygowin (10792 in chips, €0.05 bounty)
Seat 2: jeje_sat (10111 in chips, €0.05 bounty)
Seat 3: jeannono24 (9795 in chips, €0.05 bounty)
Seat 4: Reyzous (9830 in chips, €0.05 bounty)
Seat 5: CoucouRico24 (9597 in chips, €0.05 bounty)
Seat 6: LDM54 (9875 in chips, €0.05 bounty)
sygowin: posts the ante 6
jeje_sat: posts the ante 6
jeannono24: posts the ante 6
Reyzous: posts the ante 6
CoucouRico24: posts the ante 6
LDM54: posts the ante 6
Reyzous: posts small blind 25
CoucouRico24: posts big blind 50
*** HOLE CARDS ***
Dealt to jeje_sat [8h 3s]
LDM54: folds
sygowin: folds
jeje_sat: folds
jeannono24: raises 100 to 150
Reyzous: raises 375 to 525
CoucouRico24: folds
jeannono24: calls 375
*** FLOP *** [8s Jh 6d]
Reyzous: bets 720
jeannono24: calls 720
*** TURN *** [8s Jh 6d] [7h]
Reyzous: checks
jeannono24: checks
*** RIVER *** [8s Jh 6d 7h] [4c]
Reyzous: checks
jeannono24: checks
*** SHOW DOWN ***
Reyzous: shows [Ah 2s] (high card Ace)
jeannono24: shows [Th Td] (a pair of Tens)
jeannono24 collected 2576 from pot
*** SUMMARY ***
Total pot 2576 | Rake 0
Board [8s Jh 6d 7h 4c]
Seat 1: sygowin folded before Flop (didn't bet)
Seat 2: jeje_sat folded before Flop (didn't bet)
Seat 3: jeannono24 (button) showed [Th Td] and won (2576) with a pair of Tens
Seat 4: Reyzous (small blind) showed [Ah 2s] and lost with high card Ace
Seat 5: CoucouRico24 (big blind) folded before Flop
Seat 6: LDM54 folded before Flop (didn't bet)


PokerStars Home Game Hand #235261407600: {Club #4837790} Tournament #3391322540, €0.13+€0.05+€0.02 EUR Hold'em No Limit - Level III (35/70) - 2022/04/04 17:41:03 CET [2022/04/04 11:41:03 ET]
Table '3391322540 2' 6-max Seat #4 is the button
Seat 1: sygowin (10786 in chips, €0.05 bounty)
Seat 2: jeje_sat (10105 in chips, €0.05 bounty)
Seat 3: jeannono24 (11120 in chips, €0.05 bounty)
Seat 4: Reyzous (8579 in chips, €0.05 bounty)
Seat 5: CoucouRico24 (9541 in chips, €0.05 bounty)
Seat 6: LDM54 (9869 in chips, €0.05 bounty)
sygowin: posts the ante 9
jeje_sat: posts the ante 9
jeannono24: posts the ante 9
Reyzous: posts the ante 9
CoucouRico24: posts the ante 9
LDM54: posts the ante 9
CoucouRico24: posts small blind 35
LDM54: posts big blind 70
*** HOLE CARDS ***
Dealt to jeje_sat [7c 7h]
sygowin: folds
jeje_sat: raises 140 to 210
jeannono24: raises 420 to 630
Reyzous: folds
CoucouRico24: folds
LDM54: folds
jeje_sat: calls 420
*** FLOP *** [9h 3d 6d]
jeje_sat: checks
jeannono24: bets 1093
jeje_sat: folds
Uncalled bet (1093) returned to jeannono24
jeannono24 collected 1419 from pot
jeannono24: doesn't show hand
*** SUMMARY ***
Total pot 1419 | Rake 0
Board [9h 3d 6d]
Seat 1: sygowin folded before Flop (didn't bet)
Seat 2: jeje_sat folded on the Flop
Seat 3: jeannono24 collected (1419)
Seat 4: Reyzous (button) folded before Flop (didn't bet)
Seat 5: CoucouRico24 (small blind) folded before Flop
Seat 6: LDM54 (big blind) folded before Flop


PokerStars Home Game Hand #235261419694: {Club #4837790} Tournament #3391322540, €0.13+€0.05+€0.02 EUR Hold'em No Limit - Level III (35/70) - 2022/04/04 17:41:41 CET [2022/04/04 11:41:41 ET]
Table '3391322540 2' 6-max Seat #5 is the button
Seat 1: sygowin (10777 in chips, €0.05 bounty)
Seat 2: jeje_sat (9466 in chips, €0.05 bounty)
Seat 3: jeannono24 (11900 in chips, €0.05 bounty)
Seat 4: Reyzous (8570 in chips, €0.05 bounty)
Seat 5: CoucouRico24 (9497 in chips, €0.05 bounty)
Seat 6: LDM54 (9790 in chips, €0.05 bounty)
sygowin: posts the ante 9
jeje_sat: posts the ante 9
jeannono24: posts the ante 9
Reyzous: posts the ante 9
CoucouRico24: posts the ante 9
LDM54: posts the ante 9
LDM54: posts small blind 35
sygowin: posts big blind 70
*** HOLE CARDS ***
Dealt to jeje_sat [2d 5h]
jeje_sat: folds
jeannono24: folds
Reyzous: raises 70 to 140
CoucouRico24: folds
LDM54: folds
sygowin: folds
Uncalled bet (70) returned to Reyzous
Reyzous collected 229 from pot
Reyzous: doesn't show hand
*** SUMMARY ***
Total pot 229 | Rake 0
Seat 1: sygowin (big blind) folded before Flop
Seat 2: jeje_sat folded before Flop (didn't bet)
Seat 3: jeannono24 folded before Flop (didn't bet)
Seat 4: Reyzous collected (229)
Seat 5: CoucouRico24 (button) folded before Flop (didn't bet)
Seat 6: LDM54 (small blind) folded before Flop


PokerStars Home Game Hand #235261426419: {Club #4837790} Tournament #3391322540, €0.13+€0.05+€0.02 EUR Hold'em No Limit - Level III (35/70) - 2022/04/04 17:42:02 CET [2022/04/04 11:42:02 ET]
Table '3391322540 2' 6-max Seat #6 is the button
Seat 1: sygowin (10698 in chips, €0.05 bounty)
Seat 2: jeje_sat (9457 in chips, €0.05 bounty)
Seat 3: jeannono24 (11891 in chips, €0.05 bounty)
Seat 4: Reyzous (8720 in chips, €0.05 bounty)
Seat 5: CoucouRico24 (9488 in chips, €0.05 bounty)
Seat 6: LDM54 (9746 in chips, €0.05 bounty)
sygowin: posts the ante 9
jeje_sat: posts the ante 9
jeannono24: posts the ante 9
Reyzous: posts the ante 9
CoucouRico24: posts the ante 9
LDM54: posts the ante 9
sygowin: posts small blind 35
jeje_sat: posts big blind 70
*** HOLE CARDS ***
Dealt to jeje_sat [4s 6s]
jeannono24: raises 140 to 210
Reyzous: folds
CoucouRico24: folds
LDM54: folds
sygowin: folds
jeje_sat: folds
Uncalled bet (140) returned to jeannono24
jeannono24 collected 229 from pot
jeannono24: doesn't show hand
*** SUMMARY ***
Total pot 229 | Rake 0
Seat 1: sygowin (small blind) folded before Flop
Seat 2: jeje_sat (big blind) folded before Flop
Seat 3: jeannono24 collected (229)
Seat 4: Reyzous folded before Flop (didn't bet)
Seat 5: CoucouRico24 folded before Flop (didn't bet)
Seat 6: LDM54 (button) folded before Flop (didn't bet)


PokerStars Home Game Hand #235261431401: {Club #4837790} Tournament #3391322540, €0.13+€0.05+€0.02 EUR Hold'em No Limit - Level III (35/70) - 2022/04/04 17:42:17 CET [2022/04/04 11:42:17 ET]
Table '3391322540 2' 6-max Seat #1 is the button
Seat 1: sygowin (10654 in chips, €0.05 bounty)
Seat 2: jeje_sat (9378 in chips, €0.05 bounty)
Seat 3: jeannono24 (12041 in chips, €0.05 bounty)
Seat 4: Reyzous (8711 in chips, €0.05 bounty)
Seat 5: CoucouRico24 (9479 in chips, €0.05 bounty)
Seat 6: LDM54 (9737 in chips, €0.05 bounty)
sygowin: posts the ante 9
jeje_sat: posts the ante 9
jeannono24: posts the ante 9
Reyzous: posts the ante 9
CoucouRico24: posts the ante 9
LDM54: posts the ante 9
jeje_sat: posts small blind 35
jeannono24: posts big blind 70
*** HOLE CARDS ***
Dealt to jeje_sat [8s 6c]
Reyzous: raises 70 to 140
CoucouRico24: folds
LDM54: folds
sygowin: folds
jeje_sat: folds
jeannono24: calls 70
*** FLOP *** [Qd 7d 2c]
jeannono24: checks
Reyzous: checks
*** TURN *** [Qd 7d 2c] [Tc]
jeannono24: bets 122
Reyzous: folds
Uncalled bet (122) returned to jeannono24
jeannono24 collected 369 from pot
jeannono24: doesn't show hand
*** SUMMARY ***
Total pot 369 | Rake 0
Board [Qd 7d 2c Tc]
Seat 1: sygowin (button) folded before Flop (didn't bet)
Seat 2: jeje_sat (small blind) folded before Flop
Seat 3: jeannono24 (big blind) collected (369)
Seat 4: Reyzous folded on the Turn
Seat 5: CoucouRico24 folded before Flop (didn't bet)
Seat 6: LDM54 folded before Flop (didn't bet)


PokerStars Home Game Hand #235261441345: {Club #4837790} Tournament #3391322540, €0.13+€0.05+€0.02 EUR Hold'em No Limit - Level III (35/70) - 2022/04/04 17:42:48 CET [2022/04/04 11:42:48 ET]
Table '3391322540 2' 6-max Seat #2 is the button
Seat 1: sygowin (10645 in chips, €0.05 bounty)
Seat 2: jeje_sat (9334 in chips, €0.05 bounty)
Seat 3: jeannono24 (12261 in chips, €0.05 bounty)
Seat 5: CoucouRico24 (9470 in chips, €0.05 bounty)
Seat 6: LDM54 (9728 in chips, €0.05 bounty)
sygowin: posts the ante 9
jeje_sat: posts the ante 9
jeannono24: posts the ante 9
CoucouRico24: posts the ante 9
LDM54: posts the ante 9
jeannono24: posts small blind 35
CoucouRico24: posts big blind 70
*** HOLE CARDS ***
Dealt to jeje_sat [Qd Jd]
LDM54: folds
sygowin: folds
jeje_sat: raises 140 to 210
jeannono24: folds
CoucouRico24: folds
Uncalled bet (140) returned to jeje_sat
jeje_sat collected 220 from pot
jeje_sat: doesn't show hand
*** SUMMARY ***
Total pot 220 | Rake 0
Seat 1: sygowin folded before Flop (didn't bet)
Seat 2: jeje_sat (button) collected (220)
Seat 3: jeannono24 (small blind) folded before Flop
Seat 5: CoucouRico24 (big blind) folded before Flop
Seat 6: LDM54 folded before Flop (didn't bet)


PokerStars Home Game Hand #235261446470: {Club #4837790} Tournament #3391322540, €0.13+€0.05+€0.02 EUR Hold'em No Limit - Level III (35/70) - 2022/04/04 17:43:04 CET [2022/04/04 11:43:04 ET]
Table '3391322540 2' 6-max Seat #3 is the button
Seat 1: sygowin (10636 in chips, €0.05 bounty)
Seat 2: jeje_sat (9475 in chips, €0.05 bounty)
Seat 3: jeannono24 (12217 in chips, €0.05 bounty)
Seat 5: CoucouRico24 (9391 in chips, €0.05 bounty)
sygowin: posts the ante 9
jeje_sat: posts the ante 9
jeannono24: posts the ante 9
CoucouRico24: posts the ante 9
CoucouRico24: posts small blind 35
sygowin: posts big blind 70
*** HOLE CARDS ***
Dealt to jeje_sat [3s Kh]
jeje_sat: folds
jeannono24: raises 140 to 210
CoucouRico24: folds
sygowin: folds
Uncalled bet (140) returned to jeannono24
jeannono24 collected 211 from pot
jeannono24: doesn't show hand
*** SUMMARY ***
Total pot 211 | Rake 0
Seat 1: sygowin (big blind) folded before Flop
Seat 2: jeje_sat folded before Flop (didn't bet)
Seat 3: jeannono24 (button) collected (211)
Seat 5: CoucouRico24 (small blind) folded before Flop


PokerStars Home Game Hand #235261456747: {Club #4837790} Tournament #3391322540, €0.13+€0.05+€0.02 EUR Hold'em No Limit - Level III (35/70) - 2022/04/04 17:43:36 CET [2022/04/04 11:43:36 ET]
Table '3391322540 2' 6-max Seat #5 is the button
Seat 1: sygowin (10557 in chips, €0.05 bounty)
Seat 2: jeje_sat (9466 in chips, €0.05 bounty)
Seat 3: jeannono24 (12349 in chips, €0.05 bounty)
Seat 5: CoucouRico24 (9347 in chips, €0.05 bounty)
sygowin: posts the ante 9
jeje_sat: posts the ante 9
jeannono24: posts the ante 9
CoucouRico24: posts the ante 9
sygowin: posts small blind 35
jeje_sat: posts big blind 70
*** HOLE CARDS ***
Dealt to jeje_sat [7h Tc]
jeannono24: folds
CoucouRico24: raises 70 to 140
sygowin: folds
jeje_sat: calls 70
*** FLOP *** [6d 2d 5c]
jeje_sat: checks
CoucouRico24: bets 176
jeje_sat: folds
Uncalled bet (176) returned to CoucouRico24
CoucouRico24 collected 351 from pot
CoucouRico24: doesn't show hand
*** SUMMARY ***
Total pot 351 | Rake 0
Board [6d 2d 5c]
Seat 1: sygowin (small blind) folded before Flop
Seat 2: jeje_sat (big blind) folded on the Flop
Seat 3: jeannono24 folded before Flop (didn't bet)
Seat 5: CoucouRico24 (button) collected (351)


PokerStars Home Game Hand #235261468648: {Club #4837790} Tournament #3391322540, €0.13+€0.05+€0.02 EUR Hold'em No Limit - Level III (35/70) - 2022/04/04 17:44:14 CET [2022/04/04 11:44:14 ET]
Table '3391322540 2' 6-max Seat #1 is the button
Seat 1: sygowin (10513 in chips, €0.05 bounty)
Seat 2: jeje_sat (9317 in chips, €0.05 bounty)
Seat 3: jeannono24 (12340 in chips, €0.05 bounty)
Seat 5: CoucouRico24 (9549 in chips, €0.05 bounty)
sygowin: posts the ante 9
jeje_sat: posts the ante 9
jeannono24: posts the ante 9
CoucouRico24: posts the ante 9
jeje_sat: posts small blind 35
jeannono24: posts big blind 70
*** HOLE CARDS ***
Dealt to jeje_sat [Ah 3h]
CoucouRico24: folds
sygowin: folds
jeje_sat: raises 140 to 210
jeannono24: folds
Uncalled bet (140) returned to jeje_sat
jeje_sat collected 176 from pot
jeje_sat: doesn't show hand
*** SUMMARY ***
Total pot 176 | Rake 0
Seat 1: sygowin (button) folded before Flop (didn't bet)
Seat 2: jeje_sat (small blind) collected (176)
Seat 3: jeannono24 (big blind) folded before Flop
Seat 5: CoucouRico24 folded before Flop (didn't bet)


PokerStars Home Game Hand #235261473278: {Club #4837790} Tournament #3391322540, €0.13+€0.05+€0.02 EUR Hold'em No Limit - Level III (35/70) - 2022/04/04 17:44:28 CET [2022/04/04 11:44:28 ET]
Table '3391322540 2' 6-max Seat #2 is the button
Seat 1: sygowin (10504 in chips, €0.05 bounty)
Seat 2: jeje_sat (9414 in chips, €0.05 bounty)
Seat 3: jeannono24 (12261 in chips, €0.05 bounty)
Seat 5: CoucouRico24 (9540 in chips, €0.05 bounty)
sygowin: posts the ante 9
jeje_sat: posts the ante 9
jeannono24: posts the ante 9
CoucouRico24: posts the ante 9
jeannono24: posts small blind 35
CoucouRico24: posts big blind 70
*** HOLE CARDS ***
Dealt to jeje_sat [8s 5d]
sygowin: folds
jeje_sat: folds
jeannono24: calls 35
CoucouRico24: checks
*** FLOP *** [7d 7s Tc]
jeannono24: checks
CoucouRico24: checks
*** TURN *** [7d 7s Tc] [3h]
jeannono24: checks
CoucouRico24: bets 88
jeannono24: raises 271 to 359
CoucouRico24: folds
Uncalled bet (271) returned to jeannono24
jeannono24 collected 352 from pot
jeannono24: doesn't show hand
*** SUMMARY ***
Total pot 352 | Rake 0
Board [7d 7s Tc 3h]
Seat 1: sygowin folded before Flop (didn't bet)
Seat 2: jeje_sat (button) folded before Flop (didn't bet)
Seat 3: jeannono24 (small blind) collected (352)
Seat 5: CoucouRico24 (big blind) folded on the Turn


PokerStars Home Game Hand #235261486592: {Club #4837790} Tournament #3391322540, €0.13+€0.05+€0.02 EUR Hold'em No Limit - Level IV (50/100) - 2022/04/04 17:45:10 CET [2022/04/04 11:45:10 ET]
Table '3391322540 2' 6-max Seat #3 is the button
Seat 1: sygowin (10495 in chips, €0.05 bounty)
Seat 2: jeje_sat (9405 in chips, €0.05 bounty)
Seat 3: jeannono24 (12446 in chips, €0.05 bounty)
Seat 5: CoucouRico24 (9373 in chips, €0.05 bounty)
sygowin: posts the ante 12
jeje_sat: posts the ante 12
jeannono24: posts the ante 12
CoucouRico24: posts the ante 12
CoucouRico24: posts small blind 50
sygowin: posts big blind 100
*** HOLE CARDS ***
Dealt to jeje_sat [Th 3c]
jeje_sat: folds
jeannono24: folds
CoucouRico24: calls 50
sygowin: raises 300 to 400
CoucouRico24: folds
Uncalled bet (300) returned to sygowin
sygowin collected 248 from pot
sygowin: doesn't show hand
*** SUMMARY ***
Total pot 248 | Rake 0
Seat 1: sygowin (big blind) collected (248)
Seat 2: jeje_sat folded before Flop (didn't bet)
Seat 3: jeannono24 (button) folded before Flop (didn't bet)
Seat 5: CoucouRico24 (small blind) folded before Flop


PokerStars Home Game Hand #235261495277: {Club #4837790} Tournament #3391322540, €0.13+€0.05+€0.02 EUR Hold'em No Limit - Level IV (50/100) - 2022/04/04 17:45:38 CET [2022/04/04 11:45:38 ET]
Table '3391322540 2' 6-max Seat #5 is the button
Seat 1: sygowin (10631 in chips, €0.05 bounty)
Seat 2: jeje_sat (9393 in chips, €0.05 bounty)
Seat 3: jeannono24 (12434 in chips, €0.05 bounty)
Seat 5: CoucouRico24 (9261 in chips, €0.05 bounty)
sygowin: posts the ante 12
jeje_sat: posts the ante 12
jeannono24: posts the ante 12
CoucouRico24: posts the ante 12
sygowin: posts small blind 50
jeje_sat: posts big blind 100
*** HOLE CARDS ***
Dealt to jeje_sat [Ac Td]
jeannono24: folds
CoucouRico24: folds
sygowin: raises 200 to 300
jeje_sat: calls 200
*** FLOP *** [7c Kd 2s]
sygowin: checks
jeje_sat: checks
*** TURN *** [7c Kd 2s] [Ah]
sygowin: bets 300
jeje_sat: calls 300
*** RIVER *** [7c Kd 2s Ah] [Qd]
sygowin: bets 500
jeje_sat: raises 2248 to 2748
sygowin: folds
Uncalled bet (2248) returned to jeje_sat
jeje_sat collected 2248 from pot
jeje_sat: doesn't show hand
*** SUMMARY ***
Total pot 2248 | Rake 0
Board [7c Kd 2s Ah Qd]
Seat 1: sygowin (small blind) folded on the River
Seat 2: jeje_sat (big blind) collected (2248)
Seat 3: jeannono24 folded before Flop (didn't bet)
Seat 5: CoucouRico24 (button) folded before Flop (didn't bet)


PokerStars Home Game Hand #235261516297: {Club #4837790} Tournament #3391322540, €0.13+€0.05+€0.02 EUR Hold'em No Limit - Level IV (50/100) - 2022/04/04 17:46:45 CET [2022/04/04 11:46:45 ET]
Table '3391322540 2' 6-max Seat #1 is the button
Seat 1: sygowin (9519 in chips, €0.05 bounty)
Seat 2: jeje_sat (10529 in chips, €0.05 bounty)
Seat 3: jeannono24 (12422 in chips, €0.05 bounty)
Seat 5: CoucouRico24 (9249 in chips, €0.05 bounty)
sygowin: posts the ante 12
jeje_sat: posts the ante 12
jeannono24: posts the ante 12
CoucouRico24: posts the ante 12
jeje_sat: posts small blind 50
jeannono24: posts big blind 100
*** HOLE CARDS ***
Dealt to jeje_sat [6h Qc]
CoucouRico24: folds
sygowin: folds
jeje_sat: folds
Uncalled bet (50) returned to jeannono24
jeannono24 collected 148 from pot
jeannono24: doesn't show hand
*** SUMMARY ***
Total pot 148 | Rake 0
Seat 1: sygowin (button) folded before Flop (didn't bet)
Seat 2: jeje_sat (small blind) folded before Flop
Seat 3: jeannono24 (big blind) collected (148)
Seat 5: CoucouRico24 folded before Flop (didn't bet)


PokerStars Home Game Hand #235261518707: {Club #4837790} Tournament #3391322540, €0.13+€0.05+€0.02 EUR Hold'em No Limit - Level IV (50/100) - 2022/04/04 17:46:52 CET [2022/04/04 11:46:52 ET]
Table '3391322540 2' 6-max Seat #2 is the button
Seat 1: sygowin (9507 in chips, €0.05 bounty)
Seat 2: jeje_sat (10467 in chips, €0.05 bounty)
Seat 3: jeannono24 (12508 in chips, €0.05 bounty)
Seat 5: CoucouRico24 (9237 in chips, €0.05 bounty)
sygowin: posts the ante 12
jeje_sat: posts the ante 12
jeannono24: posts the ante 12
CoucouRico24: posts the ante 12
jeannono24: posts small blind 50
CoucouRico24: posts big blind 100
*** HOLE CARDS ***
Dealt to jeje_sat [2d 7s]
sygowin: folds
jeje_sat: folds
jeannono24: raises 150 to 250
CoucouRico24: folds
Uncalled bet (150) returned to jeannono24
jeannono24 collected 248 from pot
jeannono24: doesn't show hand
*** SUMMARY ***
Total pot 248 | Rake 0
Seat 1: sygowin folded before Flop (didn't bet)
Seat 2: jeje_sat (button) folded before Flop (didn't bet)
Seat 3: jeannono24 (small blind) collected (248)
Seat 5: CoucouRico24 (big blind) folded before Flop


PokerStars Home Game Hand #235261522432: {Club #4837790} Tournament #3391322540, €0.13+€0.05+€0.02 EUR Hold'em No Limit - Level IV (50/100) - 2022/04/04 17:47:04 CET [2022/04/04 11:47:04 ET]
Table '3391322540 2' 6-max Seat #3 is the button
Seat 1: sygowin (9495 in chips, €0.05 bounty)
Seat 2: jeje_sat (10455 in chips, €0.05 bounty)
Seat 3: jeannono24 (12644 in chips, €0.05 bounty)
Seat 5: CoucouRico24 (9125 in chips, €0.05 bounty)
sygowin: posts the ante 12
jeje_sat: posts the ante 12
jeannono24: posts the ante 12
CoucouRico24: posts the ante 12
CoucouRico24: posts small blind 50
sygowin: posts big blind 100
*** HOLE CARDS ***
Dealt to jeje_sat [Ks Ts]
jeje_sat: raises 200 to 300
jeannono24: calls 300
CoucouRico24: folds
sygowin: folds
*** FLOP *** [2c 7h 2h]
jeje_sat: bets 399
jeannono24: folds
Uncalled bet (399) returned to jeje_sat
jeje_sat collected 798 from pot
jeje_sat: doesn't show hand
*** SUMMARY ***
Total pot 798 | Rake 0
Board [2c 7h 2h]
Seat 1: sygowin (big blind) folded before Flop
Seat 2: jeje_sat collected (798)
Seat 3: jeannono24 (button) folded on the Flop
Seat 5: CoucouRico24 (small blind) folded before Flop


PokerStars Home Game Hand #235261535008: {Club #4837790} Tournament #3391322540, €0.13+€0.05+€0.02 EUR Hold'em No Limit - Level IV (50/100) - 2022/04/04 17:47:44 CET [2022/04/04 11:47:44 ET]
Table '3391322540 2' 6-max Seat #5 is the button
Seat 1: sygowin (9383 in chips, €0.05 bounty)
Seat 2: jeje_sat (10941 in chips, €0.05 bounty)
Seat 3: jeannono24 (12332 in chips, €0.05 bounty)
Seat 5: CoucouRico24 (9063 in chips, €0.05 bounty)
sygowin: posts the ante 12
jeje_sat: posts the ante 12
jeannono24: posts the ante 12
CoucouRico24: posts the ante 12
sygowin: posts small blind 50
jeje_sat: posts big blind 100
*** HOLE CARDS ***
Dealt to jeje_sat [Jd Tc]
jeannono24: folds
CoucouRico24: folds
sygowin: folds
Uncalled bet (50) returned to jeje_sat
jeje_sat collected 148 from pot
jeje_sat: doesn't show hand
*** SUMMARY ***
Total pot 148 | Rake 0
Seat 1: sygowin (small blind) folded before Flop
Seat 2: jeje_sat (big blind) collected (148)
Seat 3: jeannono24 folded before Flop (didn't bet)
Seat 5: CoucouRico24 (button) folded before Flop (didn't bet)


PokerStars Home Game Hand #235261540176: {Club #4837790} Tournament #3391322540, €0.13+€0.05+€0.02 EUR Hold'em No Limit - Level IV (50/100) - 2022/04/04 17:48:00 CET [2022/04/04 11:48:00 ET]
Table '3391322540 2' 6-max Seat #1 is the button
Seat 1: sygowin (9321 in chips, €0.05 bounty)
Seat 2: jeje_sat (11027 in chips, €0.05 bounty)
Seat 3: jeannono24 (12320 in chips, €0.05 bounty)
Seat 5: CoucouRico24 (9051 in chips, €0.05 bounty)
sygowin: posts the ante 12
jeje_sat: posts the ante 12
jeannono24: posts the ante 12
CoucouRico24: posts the ante 12
jeje_sat: posts small blind 50
jeannono24: posts big blind 100
*** HOLE CARDS ***
Dealt to jeje_sat [6s Ks]
CoucouRico24: folds
sygowin: raises 200 to 300
jeje_sat: folds
jeannono24: folds
Uncalled bet (200) returned to sygowin
sygowin collected 298 from pot
sygowin: doesn't show hand
*** SUMMARY ***
Total pot 298 | Rake 0
Seat 1: sygowin (button) collected (298)
Seat 2: jeje_sat (small blind) folded before Flop
Seat 3: jeannono24 (big blind) folded before Flop
Seat 5: CoucouRico24 folded before Flop (didn't bet)


PokerStars Home Game Hand #235261545688: {Club #4837790} Tournament #3391322540, €0.13+€0.05+€0.02 EUR Hold'em No Limit - Level IV (50/100) - 2022/04/04 17:48:18 CET [2022/04/04 11:48:18 ET]
Table '3391322540 2' 6-max Seat #2 is the button
Seat 1: sygowin (9507 in chips, €0.05 bounty)
Seat 2: jeje_sat (10965 in chips, €0.05 bounty)
Seat 3: jeannono24 (12208 in chips, €0.05 bounty)
Seat 5: CoucouRico24 (9039 in chips, €0.05 bounty)
sygowin: posts the ante 12
jeje_sat: posts the ante 12
jeannono24: posts the ante 12
CoucouRico24: posts the ante 12
jeannono24: posts small blind 50
CoucouRico24: posts big blind 100
*** HOLE CARDS ***
Dealt to jeje_sat [As Kd]
sygowin: raises 200 to 300
jeje_sat: raises 600 to 900
jeannono24: folds
CoucouRico24: folds
sygowin: calls 600
*** FLOP *** [3s 4s Js]
sygowin: checks
jeje_sat: checks
*** TURN *** [3s 4s Js] [8c]
sygowin: checks
jeje_sat: checks
*** RIVER *** [3s 4s Js 8c] [4d]
sygowin: checks
jeje_sat: checks
*** SHOW DOWN ***
sygowin: shows [Th Kh] (a pair of Fours)
jeje_sat: shows [As Kd] (a pair of Fours - Ace kicker)
jeje_sat collected 1998 from pot
*** SUMMARY ***
Total pot 1998 | Rake 0
Board [3s 4s Js 8c 4d]
Seat 1: sygowin showed [Th Kh] and lost with a pair of Fours
Seat 2: jeje_sat (button) showed [As Kd] and won (1998) with a pair of Fours
Seat 3: jeannono24 (small blind) folded before Flop
Seat 5: CoucouRico24 (big blind) folded before Flop


PokerStars Home Game Hand #235261562459: {Club #4837790} Tournament #3391322540, €0.13+€0.05+€0.02 EUR Hold'em No Limit - Level IV (50/100) - 2022/04/04 17:49:11 CET [2022/04/04 11:49:11 ET]
Table '3391322540 2' 6-max Seat #3 is the button
Seat 1: sygowin (8595 in chips, €0.05 bounty)
Seat 2: jeje_sat (12051 in chips, €0.05 bounty)
Seat 3: jeannono24 (12146 in chips, €0.05 bounty)
Seat 5: CoucouRico24 (8927 in chips, €0.05 bounty)
sygowin: posts the ante 12
jeje_sat: posts the ante 12
jeannono24: posts the ante 12
CoucouRico24: posts the ante 12
CoucouRico24: posts small blind 50
sygowin: posts big blind 100
*** HOLE CARDS ***
Dealt to jeje_sat [6h 8c]
jeje_sat: folds
jeannono24: raises 200 to 300
CoucouRico24: folds
sygowin: calls 200
*** FLOP *** [5h Ad Tc]
sygowin: checks
jeannono24: checks
*** TURN *** [5h Ad Tc] [8h]
sygowin: checks
jeannono24: checks
*** RIVER *** [5h Ad Tc 8h] [4c]
sygowin: bets 384
jeannono24: folds
Uncalled bet (384) returned to sygowin
sygowin collected 698 from pot
sygowin: doesn't show hand
*** SUMMARY ***
Total pot 698 | Rake 0
Board [5h Ad Tc 8h 4c]
Seat 1: sygowin (big blind) collected (698)
Seat 2: jeje_sat folded before Flop (didn't bet)
Seat 3: jeannono24 (button) folded on the River
Seat 5: CoucouRico24 (small blind) folded before Flop


PokerStars Home Game Hand #235261573191: {Club #4837790} Tournament #3391322540, €0.13+€0.05+€0.02 EUR Hold'em No Limit - Level IV (50/100) - 2022/04/04 17:49:45 CET [2022/04/04 11:49:45 ET]
Table '3391322540 2' 6-max Seat #5 is the button
Seat 1: sygowin (8981 in chips, €0.05 bounty)
Seat 2: jeje_sat (12039 in chips, €0.05 bounty)
Seat 3: jeannono24 (11834 in chips, €0.05 bounty)
Seat 5: CoucouRico24 (8865 in chips, €0.05 bounty)
sygowin: posts the ante 12
jeje_sat: posts the ante 12
jeannono24: posts the ante 12
CoucouRico24: posts the ante 12
sygowin: posts small blind 50
jeje_sat: posts big blind 100
*** HOLE CARDS ***
Dealt to jeje_sat [4c 5d]
jeannono24: folds
CoucouRico24: folds
sygowin: folds
Uncalled bet (50) returned to jeje_sat
jeje_sat collected 148 from pot
jeje_sat: doesn't show hand
*** SUMMARY ***
Total pot 148 | Rake 0
Seat 1: sygowin (small blind) folded before Flop
Seat 2: jeje_sat (big blind) collected (148)
Seat 3: jeannono24 folded before Flop (didn't bet)
Seat 5: CoucouRico24 (button) folded before Flop (didn't bet)


PokerStars Home Game Hand #235261576314: {Club #4837790} Tournament #3391322540, €0.13+€0.05+€0.02 EUR Hold'em No Limit - Level IV (50/100) - 2022/04/04 17:49:55 CET [2022/04/04 11:49:55 ET]
Table '3391322540 2' 6-max Seat #1 is the button
Seat 1: sygowin (8919 in chips, €0.05 bounty)
Seat 2: jeje_sat (12125 in chips, €0.05 bounty)
Seat 3: jeannono24 (11822 in chips, €0.05 bounty)
Seat 5: CoucouRico24 (8853 in chips, €0.05 bounty)
sygowin: posts the ante 12
jeje_sat: posts the ante 12
jeannono24: posts the ante 12
CoucouRico24: posts the ante 12
jeje_sat: posts small blind 50
jeannono24: posts big blind 100
*** HOLE CARDS ***
Dealt to jeje_sat [7c Ks]
CoucouRico24: raises 200 to 300
sygowin: folds
jeje_sat: folds
jeannono24: calls 200
*** FLOP *** [Jd 9s Tc]
jeannono24: bets 230
CoucouRico24: raises 579 to 809
jeannono24: calls 579
*** TURN *** [Jd 9s Tc] [2s]
jeannono24: checks
CoucouRico24: bets 1158
jeannono24: calls 1158
*** RIVER *** [Jd 9s Tc 2s] [8d]
jeannono24: checks
CoucouRico24: checks
*** SHOW DOWN ***
jeannono24: shows [Jc 8h] (two pair, Jacks and Eights)
CoucouRico24: mucks hand
jeannono24 collected 4632 from pot
*** SUMMARY ***
Total pot 4632 | Rake 0
Board [Jd 9s Tc 2s 8d]
Seat 1: sygowin (button) folded before Flop (didn't bet)
Seat 2: jeje_sat (small blind) folded before Flop
Seat 3: jeannono24 (big blind) showed [Jc 8h] and won (4632) with two pair, Jacks and Eights
Seat 5: CoucouRico24 mucked [Kd 2d]


PokerStars Home Game Hand #235261593204: {Club #4837790} Tournament #3391322540, €0.13+€0.05+€0.02 EUR Hold'em No Limit - Level V (75/150) - 2022/04/04 17:50:49 CET [2022/04/04 11:50:49 ET]
Table '3391322540 2' 6-max Seat #2 is the button
Seat 1: sygowin (8907 in chips, €0.05 bounty)
Seat 2: jeje_sat (12063 in chips, €0.05 bounty)
Seat 3: jeannono24 (14175 in chips, €0.05 bounty)
Seat 5: CoucouRico24 (6574 in chips, €0.05 bounty)
sygowin: posts the ante 20
jeje_sat: posts the ante 20
jeannono24: posts the ante 20
CoucouRico24: posts the ante 20
jeannono24: posts small blind 75
CoucouRico24: posts big blind 150
*** HOLE CARDS ***
Dealt to jeje_sat [6d 3s]
sygowin: folds
jeje_sat: folds
jeannono24: folds
Uncalled bet (75) returned to CoucouRico24
CoucouRico24 collected 230 from pot
CoucouRico24: doesn't show hand
*** SUMMARY ***
Total pot 230 | Rake 0
Seat 1: sygowin folded before Flop (didn't bet)
Seat 2: jeje_sat (button) folded before Flop (didn't bet)
Seat 3: jeannono24 (small blind) folded before Flop
Seat 5: CoucouRico24 (big blind) collected (230)


PokerStars Home Game Hand #235261597245: {Club #4837790} Tournament #3391322540, €0.13+€0.05+€0.02 EUR Hold'em No Limit - Level V (75/150) - 2022/04/04 17:51:02 CET [2022/04/04 11:51:02 ET]
Table '3391322540 2' 6-max Seat #3 is the button
Seat 1: sygowin (8887 in chips, €0.05 bounty)
Seat 2: jeje_sat (12043 in chips, €0.05 bounty)
Seat 3: jeannono24 (14080 in chips, €0.05 bounty)
Seat 5: CoucouRico24 (6709 in chips, €0.05 bounty)
sygowin: posts the ante 20
jeje_sat: posts the ante 20
jeannono24: posts the ante 20
CoucouRico24: posts the ante 20
CoucouRico24: posts small blind 75
sygowin: posts big blind 150
*** HOLE CARDS ***
Dealt to jeje_sat [6d Tc]
jeje_sat: folds
jeannono24: folds
CoucouRico24: raises 380 to 530
sygowin: calls 380
*** FLOP *** [9s 5h 9d]
CoucouRico24: bets 570
sygowin: folds
Uncalled bet (570) returned to CoucouRico24
CoucouRico24 collected 1140 from pot
CoucouRico24: doesn't show hand
*** SUMMARY ***
Total pot 1140 | Rake 0
Board [9s 5h 9d]
Seat 1: sygowin (big blind) folded on the Flop
Seat 2: jeje_sat folded before Flop (didn't bet)
Seat 3: jeannono24 (button) folded before Flop (didn't bet)
Seat 5: CoucouRico24 (small blind) collected (1140)


PokerStars Home Game Hand #235261604303: {Club #4837790} Tournament #3391322540, €0.13+€0.05+€0.02 EUR Hold'em No Limit - Level V (75/150) - 2022/04/04 17:51:24 CET [2022/04/04 11:51:24 ET]
Table '3391322540 2' 6-max Seat #5 is the button
Seat 1: sygowin (8337 in chips, €0.05 bounty)
Seat 2: jeje_sat (12023 in chips, €0.05 bounty)
Seat 3: jeannono24 (14060 in chips, €0.05 bounty)
Seat 5: CoucouRico24 (7299 in chips, €0.05 bounty)
sygowin: posts the ante 20
jeje_sat: posts the ante 20
jeannono24: posts the ante 20
CoucouRico24: posts the ante 20
sygowin: posts small blind 75
jeje_sat: posts big blind 150
*** HOLE CARDS ***
Dealt to jeje_sat [3d 8h]
jeannono24: folds
CoucouRico24: raises 455 to 605
sygowin: folds
jeje_sat: folds
Uncalled bet (455) returned to CoucouRico24
CoucouRico24 collected 455 from pot
CoucouRico24: doesn't show hand
*** SUMMARY ***
Total pot 455 | Rake 0
Seat 1: sygowin (small blind) folded before Flop
Seat 2: jeje_sat (big blind) folded before Flop
Seat 3: jeannono24 folded before Flop (didn't bet)
Seat 5: CoucouRico24 (button) collected (455)


PokerStars Home Game Hand #235261612308: {Club #4837790} Tournament #3391322540, €0.13+€0.05+€0.02 EUR Hold'em No Limit - Level V (75/150) - 2022/04/04 17:51:50 CET [2022/04/04 11:51:50 ET]
Table '3391322540 2' 6-max Seat #1 is the button
Seat 1: sygowin (8242 in chips, €0.05 bounty)
Seat 2: jeje_sat (11853 in chips, €0.05 bounty)
Seat 3: jeannono24 (14040 in chips, €0.05 bounty)
Seat 5: CoucouRico24 (7584 in chips, €0.05 bounty)
sygowin: posts the ante 20
jeje_sat: posts the ante 20
jeannono24: posts the ante 20
CoucouRico24: posts the ante 20
jeje_sat: posts small blind 75
jeannono24: posts big blind 150
*** HOLE CARDS ***
Dealt to jeje_sat [9d Ts]
CoucouRico24: raises 300 to 450
sygowin: folds
jeje_sat: calls 375
jeannono24: calls 300
*** FLOP *** [Jd Tc Kh]
jeje_sat: checks
jeannono24: checks
CoucouRico24: checks
*** TURN *** [Jd Tc Kh] [Ad]
jeje_sat: checks
jeannono24: checks
CoucouRico24: checks
*** RIVER *** [Jd Tc Kh Ad] [Qc]
jeje_sat: checks
jeannono24: checks
CoucouRico24: bets 7114 and is all-in
jeje_sat: calls 7114
jeannono24: calls 7114
*** SHOW DOWN ***
CoucouRico24: shows [2s Ac] (a straight, Ten to Ace)
jeje_sat: shows [9d Ts] (a straight, Ten to Ace)
jeannono24: shows [8s Ah] (a straight, Ten to Ace)
jeje_sat collected 7591 from pot
jeannono24 collected 7591 from pot
CoucouRico24 collected 7590 from pot
*** SUMMARY ***
Total pot 22772 | Rake 0
Board [Jd Tc Kh Ad Qc]
Seat 1: sygowin (button) folded before Flop (didn't bet)
Seat 2: jeje_sat (small blind) showed [9d Ts] and won (7591) with a straight, Ten to Ace
Seat 3: jeannono24 (big blind) showed [8s Ah] and won (7591) with a straight, Ten to Ace
Seat 5: CoucouRico24 showed [2s Ac] and won (7590) with a straight, Ten to Ace


PokerStars Home Game Hand #235261636493: {Club #4837790} Tournament #3391322540, €0.13+€0.05+€0.02 EUR Hold'em No Limit - Level V (75/150) - 2022/04/04 17:52:48 CET [2022/04/04 11:52:48 ET]
Table '3391322540 2' 6-max Seat #2 is the button
Seat 1: sygowin (8222 in chips, €0.05 bounty)
Seat 2: jeje_sat (11860 in chips, €0.05 bounty)
Seat 3: jeannono24 (14047 in chips, €0.05 bounty)
Seat 5: CoucouRico24 (7590 in chips, €0.05 bounty)
sygowin: posts the ante 20
jeje_sat: posts the ante 20
jeannono24: posts the ante 20
CoucouRico24: posts the ante 20
jeannono24: posts small blind 75
CoucouRico24: posts big blind 150
*** HOLE CARDS ***
Dealt to jeje_sat [6c 7c]
sygowin: raises 225 to 375
jeje_sat said, "lol"
jeje_sat: calls 375
jeannono24: raises 975 to 1350
CoucouRico24: folds
sygowin: calls 975
jeje_sat: calls 975
*** FLOP *** [3c 8s 9c]
jeannono24: checks
sygowin: checks
jeje_sat: bets 10490 and is all-in
jeannono24: folds
sygowin: calls 6852 and is all-in
Uncalled bet (3638) returned to jeje_sat
*** TURN *** [3c 8s 9c] [7s]
*** RIVER *** [3c 8s 9c 7s] [4c]
*** SHOW DOWN ***
sygowin: shows [Jc Js] (a pair of Jacks)
jeje_sat: shows [6c 7c] (a flush, Nine high)
jeje_sat collected 17984 from pot
jeje_sat wins €0.03 for eliminating sygowin and their own bounty increases by €0.02 to €0.07
sygowin finished the tournament
*** SUMMARY ***
Total pot 17984 | Rake 0
Board [3c 8s 9c 7s 4c]
Seat 1: sygowin showed [Jc Js] and lost with a pair of Jacks
Seat 2: jeje_sat (button) showed [6c 7c] and won (17984) with a flush, Nine high
Seat 3: jeannono24 (small blind) folded on the Flop
Seat 5: CoucouRico24 (big blind) folded before Flop


PokerStars Home Game Hand #235261650640: {Club #4837790} Tournament #3391322540, €0.13+€0.05+€0.02 EUR Hold'em No Limit - Level V (75/150) - 2022/04/04 17:53:34 CET [2022/04/04 11:53:34 ET]
Table '3391322540 2' 6-max Seat #3 is the button
Seat 2: jeje_sat (21622 in chips, €0.07 bounty)
Seat 3: jeannono24 (12677 in chips, €0.05 bounty)
Seat 5: CoucouRico24 (7420 in chips, €0.05 bounty)
jeje_sat: posts the ante 20
jeannono24: posts the ante 20
CoucouRico24: posts the ante 20
CoucouRico24: posts small blind 75
jeje_sat: posts big blind 150
*** HOLE CARDS ***
Dealt to jeje_sat [6c 3h]
jeannono24: folds
CoucouRico24: folds
Uncalled bet (75) returned to jeje_sat
jeje_sat collected 210 from pot
jeje_sat: doesn't show hand
*** SUMMARY ***
Total pot 210 | Rake 0
Seat 2: jeje_sat (big blind) collected (210)
Seat 3: jeannono24 (button) folded before Flop (didn't bet)
Seat 5: CoucouRico24 (small blind) folded before Flop


PokerStars Home Game Hand #235261653969: {Club #4837790} Tournament #3391322540, €0.13+€0.05+€0.02 EUR Hold'em No Limit - Level V (75/150) - 2022/04/04 17:53:44 CET [2022/04/04 11:53:44 ET]
Table '3391322540 2' 6-max Seat #5 is the button
Seat 1: sygowin (10000 in chips) out of hand (moved from another table into small blind)
Seat 2: jeje_sat (21737 in chips, €0.07 bounty)
Seat 3: jeannono24 (12657 in chips, €0.05 bounty)
Seat 5: CoucouRico24 (7325 in chips, €0.05 bounty)
sygowin will be allowed to play after the button
jeje_sat: posts the ante 20
jeannono24: posts the ante 20
CoucouRico24: posts the ante 20
jeje_sat: posts small blind 75
jeannono24: posts big blind 150
*** HOLE CARDS ***
Dealt to jeje_sat [9d As]
CoucouRico24: folds
jeje_sat: raises 300 to 450
jeannono24: calls 300
*** FLOP *** [8c 2d Kh]
jeje_sat: bets 480
jeannono24: raises 11707 to 12187 and is all-in
jeje_sat: folds
Uncalled bet (11707) returned to jeannono24
jeannono24 collected 1920 from pot
jeannono24: doesn't show hand
*** SUMMARY ***
Total pot 1920 | Rake 0
Board [8c 2d Kh]
Seat 2: jeje_sat (small blind) folded on the Flop
Seat 3: jeannono24 (big blind) collected (1920)
Seat 5: CoucouRico24 (button) folded before Flop (didn't bet)


PokerStars Home Game Hand #235261660850: {Club #4837790} Tournament #3391322540, €0.13+€0.05+€0.02 EUR Hold'em No Limit - Level V (75/150) - 2022/04/04 17:54:06 CET [2022/04/04 11:54:06 ET]
Table '3391322540 2' 6-max Seat #2 is the button
Seat 1: sygowin (10000 in chips, €0.05 bounty)
Seat 2: jeje_sat (20787 in chips, €0.07 bounty)
Seat 3: jeannono24 (13627 in chips, €0.05 bounty)
Seat 5: CoucouRico24 (7305 in chips, €0.05 bounty)
sygowin: posts the ante 20
jeje_sat: posts the ante 20
jeannono24: posts the ante 20
CoucouRico24: posts the ante 20
jeannono24: posts small blind 75
CoucouRico24: posts big blind 150
*** HOLE CARDS ***
Dealt to jeje_sat [Jc Jh]
sygowin: folds
jeje_sat: raises 300 to 450
jeannono24: calls 375
CoucouRico24: calls 300
*** FLOP *** [6d Qs 9c]
jeannono24: checks
CoucouRico24: bets 1430
jeje_sat: folds
jeannono24: folds
Uncalled bet (1430) returned to CoucouRico24
CoucouRico24 collected 1430 from pot
CoucouRico24: doesn't show hand
*** SUMMARY ***
Total pot 1430 | Rake 0
Board [6d Qs 9c]
Seat 1: sygowin folded before Flop (didn't bet)
Seat 2: jeje_sat (button) folded on the Flop
Seat 3: jeannono24 (small blind) folded on the Flop
Seat 5: CoucouRico24 (big blind) collected (1430)


PokerStars Home Game Hand #235261668403: {Club #4837790} Tournament #3391322540, €0.13+€0.05+€0.02 EUR Hold'em No Limit - Level V (75/150) - 2022/04/04 17:54:30 CET [2022/04/04 11:54:30 ET]
Table '3391322540 2' 6-max Seat #3 is the button
Seat 1: sygowin (9980 in chips, €0.05 bounty)
Seat 2: jeje_sat (20317 in chips, €0.07 bounty)
Seat 3: jeannono24 (13157 in chips, €0.05 bounty)
Seat 5: CoucouRico24 (8265 in chips, €0.05 bounty)
sygowin: posts the ante 20
jeje_sat: posts the ante 20
jeannono24: posts the ante 20
CoucouRico24: posts the ante 20
CoucouRico24: posts small blind 75
sygowin: posts big blind 150
*** HOLE CARDS ***
Dealt to jeje_sat [Qc 7d]
jeje_sat: folds
jeannono24: folds
CoucouRico24: calls 75
sygowin: checks
*** FLOP *** [3d Jc 2c]
CoucouRico24: bets 380
sygowin: calls 380
*** TURN *** [3d Jc 2c] [Qd]
CoucouRico24: checks
sygowin: bets 627
CoucouRico24: folds
Uncalled bet (627) returned to sygowin
sygowin collected 1140 from pot
sygowin: doesn't show hand
*** SUMMARY ***
Total pot 1140 | Rake 0
Board [3d Jc 2c Qd]
Seat 1: sygowin (big blind) collected (1140)
Seat 2: jeje_sat folded before Flop (didn't bet)
Seat 3: jeannono24 (button) folded before Flop (didn't bet)
Seat 5: CoucouRico24 (small blind) folded on the Turn


PokerStars Home Game Hand #235261675894: {Club #4837790} Tournament #3391322540, €0.13+€0.05+€0.02 EUR Hold'em No Limit - Level V (75/150) - 2022/04/04 17:54:54 CET [2022/04/04 11:54:54 ET]
Table '3391322540 2' 6-max Seat #5 is the button
Seat 1: sygowin (10570 in chips, €0.05 bounty)
Seat 2: jeje_sat (20297 in chips, €0.07 bounty)
Seat 3: jeannono24 (13137 in chips, €0.05 bounty)
Seat 5: CoucouRico24 (7715 in chips, €0.05 bounty)
sygowin: posts the ante 20
jeje_sat: posts the ante 20
jeannono24: posts the ante 20
CoucouRico24: posts the ante 20
sygowin: posts small blind 75
jeje_sat: posts big blind 150
*** HOLE CARDS ***
Dealt to jeje_sat [4d Jh]
jeannono24: raises 225 to 375
CoucouRico24: calls 375
sygowin: calls 300
jeje_sat: folds
*** FLOP *** [8h 9d 8c]
sygowin: checks
jeannono24: checks
CoucouRico24: bets 1355
sygowin: folds
jeannono24: folds
Uncalled bet (1355) returned to CoucouRico24
CoucouRico24 collected 1355 from pot
CoucouRico24: doesn't show hand
*** SUMMARY ***
Total pot 1355 | Rake 0
Board [8h 9d 8c]
Seat 1: sygowin (small blind) folded on the Flop
Seat 2: jeje_sat (big blind) folded before Flop
Seat 3: jeannono24 folded on the Flop
Seat 5: CoucouRico24 (button) collected (1355)


PokerStars Home Game Hand #235261685416: {Club #4837790} Tournament #3391322540, €0.13+€0.05+€0.02 EUR Hold'em No Limit - Level VI (100/200) - 2022/04/04 17:55:28 CET [2022/04/04 11:55:28 ET]
Table '3391322540 2' 6-max Seat #1 is the button
Seat 1: sygowin (10175 in chips, €0.05 bounty)
Seat 2: jeje_sat (20127 in chips, €0.07 bounty)
Seat 3: jeannono24 (12742 in chips, €0.05 bounty)
Seat 5: CoucouRico24 (8675 in chips, €0.05 bounty)
sygowin: posts the ante 25
jeje_sat: posts the ante 25
jeannono24: posts the ante 25
CoucouRico24: posts the ante 25
jeje_sat: posts small blind 100
jeannono24: posts big blind 200
*** HOLE CARDS ***
Dealt to jeje_sat [Ad Ks]
CoucouRico24: folds
sygowin: folds
RIZCHOU is sitting out
RIZCHOU has returned
jeje_sat: raises 400 to 600
jeannono24: folds
Uncalled bet (400) returned to jeje_sat
jeje_sat collected 500 from pot
jeje_sat: doesn't show hand
*** SUMMARY ***
Total pot 500 | Rake 0
Seat 1: sygowin (button) folded before Flop (didn't bet)
Seat 2: jeje_sat (small blind) collected (500)
Seat 3: jeannono24 (big blind) folded before Flop
Seat 5: CoucouRico24 folded before Flop (didn't bet)


PokerStars Home Game Hand #235261690827: {Club #4837790} Tournament #3391322540, €0.13+€0.05+€0.02 EUR Hold'em No Limit - Level VI (100/200) - 2022/04/04 17:55:49 CET [2022/04/04 11:55:49 ET]
Table '3391322540 2' 6-max Seat #2 is the button
Seat 1: sygowin (10150 in chips, €0.05 bounty)
Seat 2: jeje_sat (20402 in chips, €0.07 bounty)
Seat 3: jeannono24 (12517 in chips, €0.05 bounty)
Seat 4: RIZCHOU (11929 in chips, €0.05 bounty)
Seat 6: tinluu (17811 in chips, €0.07 bounty)
sygowin: posts the ante 25
jeje_sat: posts the ante 25
jeannono24: posts the ante 25
RIZCHOU: posts the ante 25
tinluu: posts the ante 25
jeannono24: posts small blind 100
RIZCHOU: posts big blind 200
*** HOLE CARDS ***
Dealt to jeje_sat [7h 9h]
tinluu: folds
sygowin: raises 300 to 500
jeje_sat: calls 500
jeannono24: folds
RIZCHOU: folds
*** FLOP *** [Ks 6s 7d]
sygowin: bets 470
jeje_sat: calls 470
*** TURN *** [Ks 6s 7d] [As]
sygowin: bets 1774
jeje_sat: folds
Uncalled bet (1774) returned to sygowin
sygowin collected 2365 from pot
sygowin: doesn't show hand
*** SUMMARY ***
Total pot 2365 | Rake 0
Board [Ks 6s 7d As]
Seat 1: sygowin collected (2365)
Seat 2: jeje_sat (button) folded on the Turn
Seat 3: jeannono24 (small blind) folded before Flop
Seat 4: RIZCHOU (big blind) folded before Flop
Seat 6: tinluu folded before Flop (didn't bet)


PokerStars Home Game Hand #235261714226: {Club #4837790} Tournament #3391322540, €0.13+€0.05+€0.02 EUR Hold'em No Limit - Level VI (100/200) - 2022/04/04 17:57:17 CET [2022/04/04 11:57:17 ET]
Table '3391322540 4' 6-max Seat #1 is the button
Seat 1: jamesHRoss (9921 in chips, €0.05 bounty)
Seat 3: stephoumOPC (18050 in chips, €0.07 bounty)
Seat 4: Reyzous (16902 in chips, €0.05 bounty)
Seat 5: jeje_sat (19407 in chips, €0.07 bounty)
jamesHRoss: posts the ante 25
stephoumOPC: posts the ante 25
Reyzous: posts the ante 25
jeje_sat: posts the ante 25
stephoumOPC: posts small blind 100
Reyzous: posts big blind 200
*** HOLE CARDS ***
Dealt to jeje_sat [6d Qd]
jeje_sat: folds
jamesHRoss: raises 300 to 500
stephoumOPC: calls 400
Reyzous: raises 1700 to 2200
jamesHRoss: folds
stephoumOPC: folds
Uncalled bet (1700) returned to Reyzous
Reyzous collected 1600 from pot
Reyzous: doesn't show hand
*** SUMMARY ***
Total pot 1600 | Rake 0
Seat 1: jamesHRoss (button) folded before Flop
Seat 3: stephoumOPC (small blind) folded before Flop
Seat 4: Reyzous (big blind) collected (1600)
Seat 5: jeje_sat folded before Flop (didn't bet)


PokerStars Home Game Hand #235261724858: {Club #4837790} Tournament #3391322540, €0.13+€0.05+€0.02 EUR Hold'em No Limit - Level VI (100/200) - 2022/04/04 17:57:57 CET [2022/04/04 11:57:57 ET]
Table '3391322540 4' 6-max Seat #3 is the button
Seat 1: jamesHRoss (9396 in chips, €0.05 bounty)
Seat 3: stephoumOPC (17525 in chips, €0.07 bounty)
Seat 4: Reyzous (17977 in chips, €0.05 bounty)
Seat 5: jeje_sat (19382 in chips, €0.07 bounty)
jamesHRoss: posts the ante 25
stephoumOPC: posts the ante 25
Reyzous: posts the ante 25
jeje_sat: posts the ante 25
Reyzous: posts small blind 100
jeje_sat: posts big blind 200
*** HOLE CARDS ***
Dealt to jeje_sat [3d Kd]
jamesHRoss: folds
stephoumOPC: folds
Reyzous: calls 100
jeje_sat: checks
*** FLOP *** [Qd Ks Ad]
Reyzous: checks
jeje_sat: bets 250
Reyzous: folds
Uncalled bet (250) returned to jeje_sat
jeje_sat collected 500 from pot
jeje_sat: doesn't show hand
*** SUMMARY ***
Total pot 500 | Rake 0
Board [Qd Ks Ad]
Seat 1: jamesHRoss folded before Flop (didn't bet)
Seat 3: stephoumOPC (button) folded before Flop (didn't bet)
Seat 4: Reyzous (small blind) folded on the Flop
Seat 5: jeje_sat (big blind) collected (500)


PokerStars Home Game Hand #235261733867: {Club #4837790} Tournament #3391322540, €0.13+€0.05+€0.02 EUR Hold'em No Limit - Level VI (100/200) - 2022/04/04 17:58:32 CET [2022/04/04 11:58:32 ET]
Table '3391322540 4' 6-max Seat #4 is the button
Seat 1: jamesHRoss (9371 in chips, €0.05 bounty)
Seat 3: stephoumOPC (17500 in chips, €0.07 bounty)
Seat 4: Reyzous (17752 in chips, €0.05 bounty)
Seat 5: jeje_sat (19657 in chips, €0.07 bounty)
jamesHRoss: posts the ante 25
stephoumOPC: posts the ante 25
Reyzous: posts the ante 25
jeje_sat: posts the ante 25
jeje_sat: posts small blind 100
jamesHRoss: posts big blind 200
*** HOLE CARDS ***
Dealt to jeje_sat [4c 2c]
stephoumOPC: raises 300 to 500
Reyzous: folds
jeje_sat: calls 400
jamesHRoss: calls 300
*** FLOP *** [6s Ah 3d]
jeje_sat: checks
jamesHRoss: checks
stephoumOPC: bets 528
jeje_sat: calls 528
jamesHRoss: folds
*** TURN *** [6s Ah 3d] [5s]
jeje_sat: bets 18604 and is all-in
stephoumOPC: folds
Uncalled bet (18604) returned to jeje_sat
jeje_sat collected 2656 from pot
jeje_sat: doesn't show hand
*** SUMMARY ***
Total pot 2656 | Rake 0
Board [6s Ah 3d 5s]
Seat 1: jamesHRoss (big blind) folded on the Flop
Seat 3: stephoumOPC folded on the Turn
Seat 4: Reyzous (button) folded before Flop (didn't bet)
Seat 5: jeje_sat (small blind) collected (2656)


PokerStars Home Game Hand #235261745329: {Club #4837790} Tournament #3391322540, €0.13+€0.05+€0.02 EUR Hold'em No Limit - Level VI (100/200) - 2022/04/04 17:59:15 CET [2022/04/04 11:59:15 ET]
Table '3391322540 4' 6-max Seat #5 is the button
Seat 1: jamesHRoss (8846 in chips, €0.05 bounty)
Seat 3: stephoumOPC (16447 in chips, €0.07 bounty)
Seat 4: Reyzous (17727 in chips, €0.05 bounty)
Seat 5: jeje_sat (21260 in chips, €0.07 bounty)
jamesHRoss: posts the ante 25
stephoumOPC: posts the ante 25
Reyzous: posts the ante 25
jeje_sat: posts the ante 25
jamesHRoss: posts small blind 100
stephoumOPC: posts big blind 200
*** HOLE CARDS ***
Dealt to jeje_sat [8s Ts]
Reyzous: raises 200 to 400
jeje_sat: calls 400
jamesHRoss: calls 300
stephoumOPC: raises 16022 to 16422 and is all-in
Reyzous: folds
jeje_sat: folds
RIZCHOU is sitting out
jamesHRoss: folds
Uncalled bet (16022) returned to stephoumOPC
RIZCHOU has returned
stephoumOPC collected 1700 from pot
stephoumOPC: doesn't show hand
*** SUMMARY ***
Total pot 1700 | Rake 0
Seat 1: jamesHRoss (small blind) folded before Flop
Seat 3: stephoumOPC (big blind) collected (1700)
Seat 4: Reyzous folded before Flop
Seat 5: jeje_sat (button) folded before Flop


PokerStars Home Game Hand #235261759547: {Club #4837790} Tournament #3391322540, €0.13+€0.05+€0.02 EUR Hold'em No Limit - Level VII (125/250) - 2022/04/04 18:00:10 CET [2022/04/04 12:00:10 ET]
Table '3391322540 4' 6-max Seat #1 is the button
Seat 1: jamesHRoss (8421 in chips, €0.05 bounty)
Seat 2: jeannono24 (12921 in chips) out of hand (moved from another table into small blind)
Seat 3: stephoumOPC (17722 in chips, €0.07 bounty)
Seat 4: Reyzous (17302 in chips, €0.05 bounty)
Seat 5: jeje_sat (20835 in chips, €0.07 bounty)
Seat 6: RIZCHOU (11129 in chips, €0.05 bounty)
jeannono24 will be allowed to play after the button
jamesHRoss: posts the ante 30
stephoumOPC: posts the ante 30
Reyzous: posts the ante 30
jeje_sat: posts the ante 30
RIZCHOU: posts the ante 30
stephoumOPC: posts small blind 125
Reyzous: posts big blind 250
*** HOLE CARDS ***
Dealt to jeje_sat [8s Jh]
jeje_sat: folds
RIZCHOU: folds
jamesHRoss: raises 250 to 500
stephoumOPC: calls 375
Reyzous: folds
*** FLOP *** [6c 6d Js]
stephoumOPC: checks
jamesHRoss: checks
*** TURN *** [6c 6d Js] [Th]
stephoumOPC: checks
jamesHRoss: checks
*** RIVER *** [6c 6d Js Th] [7c]
stephoumOPC: checks
jamesHRoss: checks
*** SHOW DOWN ***
stephoumOPC: shows [8h 8c] (two pair, Eights and Sixes)
jamesHRoss: mucks hand
stephoumOPC collected 1400 from pot
*** SUMMARY ***
Total pot 1400 | Rake 0
Board [6c 6d Js Th 7c]
Seat 1: jamesHRoss (button) mucked [As 3c]
Seat 3: stephoumOPC (small blind) showed [8h 8c] and won (1400) with two pair, Eights and Sixes
Seat 4: Reyzous (big blind) folded before Flop
Seat 5: jeje_sat folded before Flop (didn't bet)
Seat 6: RIZCHOU folded before Flop (didn't bet)


PokerStars Home Game Hand #235261777024: {Club #4837790} Tournament #3391322540, €0.13+€0.05+€0.02 EUR Hold'em No Limit - Level VII (125/250) - 2022/04/04 18:01:11 CET [2022/04/04 12:01:11 ET]
Table '3391322540 4' 6-max Seat #3 is the button
Seat 1: jamesHRoss (7891 in chips, €0.05 bounty)
Seat 2: jeannono24 (12921 in chips, €0.05 bounty)
Seat 3: stephoumOPC (18592 in chips, €0.07 bounty)
Seat 4: Reyzous (17022 in chips, €0.05 bounty)
Seat 5: jeje_sat (20805 in chips, €0.07 bounty)
Seat 6: RIZCHOU (11099 in chips, €0.05 bounty)
jamesHRoss: posts the ante 30
jeannono24: posts the ante 30
stephoumOPC: posts the ante 30
Reyzous: posts the ante 30
jeje_sat: posts the ante 30
RIZCHOU: posts the ante 30
Reyzous: posts small blind 125
jeje_sat: posts big blind 250
*** HOLE CARDS ***
Dealt to jeje_sat [9s 2s]
RIZCHOU: folds
jamesHRoss: raises 250 to 500
jeannono24: folds
stephoumOPC: calls 500
Reyzous: folds
jeje_sat: folds
*** FLOP *** [9h 7c 3c]
jamesHRoss: bets 500
stephoumOPC: folds
Uncalled bet (500) returned to jamesHRoss
jamesHRoss collected 1555 from pot
jamesHRoss: doesn't show hand
*** SUMMARY ***
Total pot 1555 | Rake 0
Board [9h 7c 3c]
Seat 1: jamesHRoss collected (1555)
Seat 2: jeannono24 folded before Flop (didn't bet)
Seat 3: stephoumOPC (button) folded on the Flop
Seat 4: Reyzous (small blind) folded before Flop
Seat 5: jeje_sat (big blind) folded before Flop
Seat 6: RIZCHOU folded before Flop (didn't bet)


PokerStars Home Game Hand #235261784320: {Club #4837790} Tournament #3391322540, €0.13+€0.05+€0.02 EUR Hold'em No Limit - Level VII (125/250) - 2022/04/04 18:01:35 CET [2022/04/04 12:01:35 ET]
Table '3391322540 4' 6-max Seat #4 is the button
Seat 1: jamesHRoss (8916 in chips, €0.05 bounty)
Seat 2: jeannono24 (12891 in chips, €0.05 bounty)
Seat 3: stephoumOPC (18062 in chips, €0.07 bounty)
Seat 4: Reyzous (16867 in chips, €0.05 bounty)
Seat 5: jeje_sat (20525 in chips, €0.07 bounty)
Seat 6: RIZCHOU (11069 in chips, €0.05 bounty)
jamesHRoss: posts the ante 30
jeannono24: posts the ante 30
stephoumOPC: posts the ante 30
Reyzous: posts the ante 30
jeje_sat: posts the ante 30
RIZCHOU: posts the ante 30
jeje_sat: posts small blind 125
RIZCHOU: posts big blind 250
*** HOLE CARDS ***
Dealt to jeje_sat [As Jh]
jamesHRoss: folds
jeannono24: folds
stephoumOPC: folds
Reyzous: raises 250 to 500
jeje_sat: raises 1430 to 1930
RIZCHOU: folds
Reyzous: folds [Ac]
Uncalled bet (1430) returned to jeje_sat
jeje_sat collected 1430 from pot
jeje_sat: doesn't show hand
*** SUMMARY ***
Total pot 1430 | Rake 0
Seat 1: jamesHRoss folded before Flop (didn't bet)
Seat 2: jeannono24 folded before Flop (didn't bet)
Seat 3: stephoumOPC folded before Flop (didn't bet)
Seat 4: Reyzous (button) folded before Flop
Seat 5: jeje_sat (small blind) collected (1430)
Seat 6: RIZCHOU (big blind) folded before Flop


PokerStars Home Game Hand #235261795486: {Club #4837790} Tournament #3391322540, €0.13+€0.05+€0.02 EUR Hold'em No Limit - Level VII (125/250) - 2022/04/04 18:02:11 CET [2022/04/04 12:02:11 ET]
Table '3391322540 4' 6-max Seat #5 is the button
Seat 1: jamesHRoss (8886 in chips, €0.05 bounty)
Seat 2: jeannono24 (12861 in chips, €0.05 bounty)
Seat 3: stephoumOPC (18032 in chips, €0.07 bounty)
Seat 4: Reyzous (16337 in chips, €0.05 bounty)
Seat 5: jeje_sat (21425 in chips, €0.07 bounty)
Seat 6: RIZCHOU (10789 in chips, €0.05 bounty)
jamesHRoss: posts the ante 30
jeannono24: posts the ante 30
stephoumOPC: posts the ante 30
Reyzous: posts the ante 30
jeje_sat: posts the ante 30
RIZCHOU: posts the ante 30
RIZCHOU: posts small blind 125
jamesHRoss: posts big blind 250
*** HOLE CARDS ***
Dealt to jeje_sat [Ks Th]
jeannono24: folds
stephoumOPC: folds
Reyzous: folds
jeje_sat: raises 500 to 750
RIZCHOU: folds
jamesHRoss: folds
Uncalled bet (500) returned to jeje_sat
jeje_sat collected 805 from pot
jeje_sat: doesn't show hand
*** SUMMARY ***
Total pot 805 | Rake 0
Seat 1: jamesHRoss (big blind) folded before Flop
Seat 2: jeannono24 folded before Flop (didn't bet)
Seat 3: stephoumOPC folded before Flop (didn't bet)
Seat 4: Reyzous folded before Flop (didn't bet)
Seat 5: jeje_sat (button) collected (805)
Seat 6: RIZCHOU (small blind) folded before Flop


PokerStars Home Game Hand #235261810051: {Club #4837790} Tournament #3391322540, €0.13+€0.05+€0.02 EUR Hold'em No Limit - Level VII (125/250) - 2022/04/04 18:02:31 CET [2022/04/04 12:02:31 ET]
Table '3391322540 4' 6-max Seat #6 is the button
Seat 1: jamesHRoss (8606 in chips, €0.05 bounty)
Seat 2: jeannono24 (12831 in chips, €0.05 bounty)
Seat 3: stephoumOPC (18002 in chips, €0.07 bounty)
Seat 4: Reyzous (16307 in chips, €0.05 bounty)
Seat 5: jeje_sat (21950 in chips, €0.07 bounty)
Seat 6: RIZCHOU (10634 in chips, €0.05 bounty)
jamesHRoss: posts the ante 30
jeannono24: posts the ante 30
stephoumOPC: posts the ante 30
Reyzous: posts the ante 30
jeje_sat: posts the ante 30
RIZCHOU: posts the ante 30
jamesHRoss: posts small blind 125
jeannono24: posts big blind 250
*** HOLE CARDS ***
Dealt to jeje_sat [2s 3c]
stephoumOPC: raises 250 to 500
Reyzous: folds
jeje_sat: folds
RIZCHOU: folds
jamesHRoss: folds
jeannono24: raises 1750 to 2250
stephoumOPC: calls 1750
*** FLOP *** [8c 6d Jh]
jeannono24: checks
stephoumOPC: checks
*** TURN *** [8c 6d Jh] [Kh]
jeannono24: bets 3700
stephoumOPC: calls 3700
*** RIVER *** [8c 6d Jh Kh] [Kc]
jeannono24: bets 6851 and is all-in
stephoumOPC: calls 6851
*** SHOW DOWN ***
jeannono24: shows [Js Jd] (a full house, Jacks full of Kings)
stephoumOPC: shows [Kd Td] (three of a kind, Kings)
jeannono24 collected 25907 from pot
*** SUMMARY ***
Total pot 25907 | Rake 0
Board [8c 6d Jh Kh Kc]
Seat 1: jamesHRoss (small blind) folded before Flop
Seat 2: jeannono24 (big blind) showed [Js Jd] and won (25907) with a full house, Jacks full of Kings
Seat 3: stephoumOPC showed [Kd Td] and lost with three of a kind, Kings
Seat 4: Reyzous folded before Flop (didn't bet)
Seat 5: jeje_sat folded before Flop (didn't bet)
Seat 6: RIZCHOU (button) folded before Flop (didn't bet)


PokerStars Home Game Hand #235261823711: {Club #4837790} Tournament #3391322540, €0.13+€0.05+€0.02 EUR Hold'em No Limit - Level VII (125/250) - 2022/04/04 18:03:15 CET [2022/04/04 12:03:15 ET]
Table '3391322540 4' 6-max Seat #1 is the button
Seat 1: jamesHRoss (8451 in chips, €0.05 bounty)
Seat 2: jeannono24 (25907 in chips, €0.05 bounty)
Seat 3: stephoumOPC (5171 in chips, €0.07 bounty)
Seat 4: Reyzous (16277 in chips, €0.05 bounty)
Seat 5: jeje_sat (21920 in chips, €0.07 bounty)
Seat 6: RIZCHOU (10604 in chips, €0.05 bounty)
jamesHRoss: posts the ante 30
jeannono24: posts the ante 30
stephoumOPC: posts the ante 30
Reyzous: posts the ante 30
jeje_sat: posts the ante 30
RIZCHOU: posts the ante 30
jeannono24: posts small blind 125
stephoumOPC: posts big blind 250
*** HOLE CARDS ***
Dealt to jeje_sat [9h Qc]
Reyzous: raises 250 to 500
jeje_sat: folds
RIZCHOU: folds
jamesHRoss: folds
jeannono24: calls 375
stephoumOPC: folds
*** FLOP *** [7d Kc 2s]
jeannono24: checks
Reyzous: bets 500
jeannono24: calls 500
*** TURN *** [7d Kc 2s] [2d]
jeannono24: checks
Reyzous: checks
*** RIVER *** [7d Kc 2s 2d] [Kh]
jeannono24: checks
Reyzous: bets 1215
jeannono24: calls 1215
*** SHOW DOWN ***
Reyzous: shows [Jd Kd] (a full house, Kings full of Deuces)
jeannono24: mucks hand
Reyzous collected 4860 from pot
*** SUMMARY ***
Total pot 4860 | Rake 0
Board [7d Kc 2s 2d Kh]
Seat 1: jamesHRoss (button) folded before Flop (didn't bet)
Seat 2: jeannono24 (small blind) mucked [Ts Tc]
Seat 3: stephoumOPC (big blind) folded before Flop
Seat 4: Reyzous showed [Jd Kd] and won (4860) with a full house, Kings full of Deuces
Seat 5: jeje_sat folded before Flop (didn't bet)
Seat 6: RIZCHOU folded before Flop (didn't bet)


PokerStars Home Game Hand #235261838180: {Club #4837790} Tournament #3391322540, €0.13+€0.05+€0.02 EUR Hold'em No Limit - Level VII (125/250) - 2022/04/04 18:03:59 CET [2022/04/04 12:03:59 ET]
Table '3391322540 4' 6-max Seat #2 is the button
Seat 1: jamesHRoss (8421 in chips, €0.05 bounty)
Seat 2: jeannono24 (23662 in chips, €0.05 bounty)
Seat 3: stephoumOPC (4891 in chips, €0.07 bounty)
Seat 4: Reyzous (18892 in chips, €0.05 bounty)
Seat 5: jeje_sat (21890 in chips, €0.07 bounty)
Seat 6: RIZCHOU (10574 in chips, €0.05 bounty)
jamesHRoss: posts the ante 30
jeannono24: posts the ante 30
stephoumOPC: posts the ante 30
Reyzous: posts the ante 30
jeje_sat: posts the ante 30
RIZCHOU: posts the ante 30
stephoumOPC: posts small blind 125
Reyzous: posts big blind 250
*** HOLE CARDS ***
Dealt to jeje_sat [Td 3s]
jeje_sat: folds
RIZCHOU: folds
jamesHRoss: folds
jeannono24: folds
stephoumOPC: folds
Uncalled bet (125) returned to Reyzous
Reyzous collected 430 from pot
Reyzous: doesn't show hand
*** SUMMARY ***
Total pot 430 | Rake 0
Seat 1: jamesHRoss folded before Flop (didn't bet)
Seat 2: jeannono24 (button) folded before Flop (didn't bet)
Seat 3: stephoumOPC (small blind) folded before Flop
Seat 4: Reyzous (big blind) collected (430)
Seat 5: jeje_sat folded before Flop (didn't bet)
Seat 6: RIZCHOU folded before Flop (didn't bet)


PokerStars Home Game Hand #235261848169: {Club #4837790} Tournament #3391322540, €0.13+€0.05+€0.02 EUR Hold'em No Limit - Level VII (125/250) - 2022/04/04 18:04:30 CET [2022/04/04 12:04:30 ET]
Table '3391322540 4' 6-max Seat #3 is the button
Seat 1: jamesHRoss (8391 in chips, €0.05 bounty)
Seat 2: jeannono24 (23632 in chips, €0.05 bounty)
Seat 3: stephoumOPC (4736 in chips, €0.07 bounty)
Seat 4: Reyzous (19167 in chips, €0.05 bounty)
Seat 5: jeje_sat (21860 in chips, €0.07 bounty)
Seat 6: RIZCHOU (10544 in chips, €0.05 bounty)
jamesHRoss: posts the ante 30
jeannono24: posts the ante 30
stephoumOPC: posts the ante 30
Reyzous: posts the ante 30
jeje_sat: posts the ante 30
RIZCHOU: posts the ante 30
Reyzous: posts small blind 125
jeje_sat: posts big blind 250
*** HOLE CARDS ***
Dealt to jeje_sat [Qd 3s]
RIZCHOU: folds
jamesHRoss: folds
jeannono24: raises 375 to 625
stephoumOPC: folds
Reyzous: folds
jeje_sat: folds
Uncalled bet (375) returned to jeannono24
jeannono24 collected 805 from pot
jeannono24: doesn't show hand
*** SUMMARY ***
Total pot 805 | Rake 0
Seat 1: jamesHRoss folded before Flop (didn't bet)
Seat 2: jeannono24 collected (805)
Seat 3: stephoumOPC (button) folded before Flop (didn't bet)
Seat 4: Reyzous (small blind) folded before Flop
Seat 5: jeje_sat (big blind) folded before Flop
Seat 6: RIZCHOU folded before Flop (didn't bet)


PokerStars Home Game Hand #235261856363: {Club #4837790} Tournament #3391322540, €0.13+€0.05+€0.02 EUR Hold'em No Limit - Level VII (125/250) - 2022/04/04 18:04:55 CET [2022/04/04 12:04:55 ET]
Table '3391322540 4' 6-max Seat #4 is the button
Seat 1: jamesHRoss (8361 in chips, €0.05 bounty)
Seat 2: jeannono24 (24157 in chips, €0.05 bounty)
Seat 3: stephoumOPC (4706 in chips, €0.07 bounty)
Seat 4: Reyzous (19012 in chips, €0.05 bounty)
Seat 5: jeje_sat (21580 in chips, €0.07 bounty)
Seat 6: RIZCHOU (10514 in chips, €0.05 bounty)
jamesHRoss: posts the ante 30
jeannono24: posts the ante 30
stephoumOPC: posts the ante 30
Reyzous: posts the ante 30
jeje_sat: posts the ante 30
RIZCHOU: posts the ante 30
jeje_sat: posts small blind 125
RIZCHOU: posts big blind 250
*** HOLE CARDS ***
Dealt to jeje_sat [2d 2s]
jamesHRoss: folds
jeannono24: folds
stephoumOPC: raises 250 to 500
Reyzous: raises 750 to 1250
jeje_sat: calls 1125
RIZCHOU: folds
stephoumOPC: raises 3426 to 4676 and is all-in
Reyzous: raises 14306 to 18982 and is all-in
jeje_sat: folds
Uncalled bet (14306) returned to Reyzous
*** FLOP *** [Ah 7d Tc]
*** TURN *** [Ah 7d Tc] [Ac]
*** RIVER *** [Ah 7d Tc Ac] [6s]
*** SHOW DOWN ***
stephoumOPC: shows [Js Qh] (a pair of Aces)
Reyzous: shows [Qs Qc] (two pair, Aces and Queens)
Reyzous collected 11032 from pot
Reyzous wins €0.04 for eliminating stephoumOPC and their own bounty increases by €0.03 to €0.08
stephoumOPC finished the tournament in 12th place
*** SUMMARY ***
Total pot 11032 | Rake 0
Board [Ah 7d Tc Ac 6s]
Seat 1: jamesHRoss folded before Flop (didn't bet)
Seat 2: jeannono24 folded before Flop (didn't bet)
Seat 3: stephoumOPC showed [Js Qh] and lost with a pair of Aces
Seat 4: Reyzous (button) showed [Qs Qc] and won (11032) with two pair, Aces and Queens
Seat 5: jeje_sat (small blind) folded before Flop
Seat 6: RIZCHOU (big blind) folded before Flop


PokerStars Home Game Hand #235261881740: {Club #4837790} Tournament #3391322540, €0.13+€0.05+€0.02 EUR Hold'em No Limit - Level VIII (150/300) - 2022/04/04 18:06:12 CET [2022/04/04 12:06:12 ET]
Table '3391322540 4' 6-max Seat #5 is the button
Seat 1: jamesHRoss (8331 in chips, €0.05 bounty)
Seat 2: jeannono24 (24127 in chips, €0.05 bounty)
Seat 4: Reyzous (25338 in chips, €0.08 bounty)
Seat 5: jeje_sat (20300 in chips, €0.07 bounty)
Seat 6: RIZCHOU (10234 in chips, €0.05 bounty)
jamesHRoss: posts the ante 40
jeannono24: posts the ante 40
Reyzous: posts the ante 40
jeje_sat: posts the ante 40
RIZCHOU: posts the ante 40
RIZCHOU: posts small blind 150
jamesHRoss: posts big blind 300
*** HOLE CARDS ***
Dealt to jeje_sat [2s 6c]
jeannono24: folds
Reyzous: raises 300 to 600
jeje_sat: folds
RIZCHOU: raises 1700 to 2300
jamesHRoss: folds
Reyzous: folds
Uncalled bet (1700) returned to RIZCHOU
RIZCHOU collected 1700 from pot
RIZCHOU: doesn't show hand
*** SUMMARY ***
Total pot 1700 | Rake 0
Seat 1: jamesHRoss (big blind) folded before Flop
Seat 2: jeannono24 folded before Flop (didn't bet)
Seat 4: Reyzous folded before Flop
Seat 5: jeje_sat (button) folded before Flop (didn't bet)
Seat 6: RIZCHOU (small blind) collected (1700)


PokerStars Home Game Hand #235261892482: {Club #4837790} Tournament #3391322540, €0.13+€0.05+€0.02 EUR Hold'em No Limit - Level VIII (150/300) - 2022/04/04 18:06:45 CET [2022/04/04 12:06:45 ET]
Table '3391322540 4' 6-max Seat #6 is the button
Seat 1: jamesHRoss (7991 in chips, €0.05 bounty)
Seat 2: jeannono24 (24087 in chips, €0.05 bounty)
Seat 4: Reyzous (24698 in chips, €0.08 bounty)
Seat 5: jeje_sat (20260 in chips, €0.07 bounty)
Seat 6: RIZCHOU (11294 in chips, €0.05 bounty)
jamesHRoss: posts the ante 40
jeannono24: posts the ante 40
Reyzous: posts the ante 40
jeje_sat: posts the ante 40
RIZCHOU: posts the ante 40
jamesHRoss: posts small blind 150
jeannono24: posts big blind 300
*** HOLE CARDS ***
Dealt to jeje_sat [9s 4c]
Reyzous: folds
jeje_sat: folds
RIZCHOU: folds
jamesHRoss: calls 150
jeannono24: checks
*** FLOP *** [9c 2s Ac]
jamesHRoss: checks
jeannono24: bets 456
jamesHRoss: calls 456
*** TURN *** [9c 2s Ac] [As]
jamesHRoss: checks
jeannono24: checks
*** RIVER *** [9c 2s Ac As] [Ad]
jamesHRoss: bets 750
jeannono24: calls 750
*** SHOW DOWN ***
jamesHRoss: shows [2h Th] (a full house, Aces full of Deuces)
jeannono24: shows [7c 2c] (a full house, Aces full of Deuces)
jamesHRoss collected 1606 from pot
jeannono24 collected 1606 from pot
*** SUMMARY ***
Total pot 3212 | Rake 0
Board [9c 2s Ac As Ad]
Seat 1: jamesHRoss (small blind) showed [2h Th] and won (1606) with a full house, Aces full of Deuces
Seat 2: jeannono24 (big blind) showed [7c 2c] and won (1606) with a full house, Aces full of Deuces
Seat 4: Reyzous folded before Flop (didn't bet)
Seat 5: jeje_sat folded before Flop (didn't bet)
Seat 6: RIZCHOU (button) folded before Flop (didn't bet)


PokerStars Home Game Hand #235261918492: {Club #4837790} Tournament #3391322540, €0.13+€0.05+€0.02 EUR Hold'em No Limit - Level VIII (150/300) - 2022/04/04 18:08:06 CET [2022/04/04 12:08:06 ET]
Table '3391322540 4' 6-max Seat #1 is the button
Seat 1: jamesHRoss (8051 in chips, €0.05 bounty)
Seat 2: jeannono24 (24147 in chips, €0.05 bounty)
Seat 4: Reyzous (24658 in chips, €0.08 bounty)
Seat 5: jeje_sat (20220 in chips, €0.07 bounty)
Seat 6: RIZCHOU (11254 in chips, €0.05 bounty)
jamesHRoss: posts the ante 40
jeannono24: posts the ante 40
Reyzous: posts the ante 40
jeje_sat: posts the ante 40
RIZCHOU: posts the ante 40
jeannono24: posts small blind 150
Reyzous: posts big blind 300
*** HOLE CARDS ***
Dealt to jeje_sat [Tc Ah]
jeje_sat: raises 600 to 900
RIZCHOU: folds
jamesHRoss: calls 900
jeannono24: folds
Reyzous: calls 600
*** FLOP *** [3d 6d 6s]
Reyzous: checks
jeje_sat: bets 1525
jamesHRoss: folds
Reyzous: folds
Uncalled bet (1525) returned to jeje_sat
jeje_sat collected 3050 from pot
jeje_sat: doesn't show hand
*** SUMMARY ***
Total pot 3050 | Rake 0
Board [3d 6d 6s]
Seat 1: jamesHRoss (button) folded on the Flop
Seat 2: jeannono24 (small blind) folded before Flop
Seat 4: Reyzous (big blind) folded on the Flop
Seat 5: jeje_sat collected (3050)
Seat 6: RIZCHOU folded before Flop (didn't bet)


PokerStars Home Game Hand #235261934843: {Club #4837790} Tournament #3391322540, €0.13+€0.05+€0.02 EUR Hold'em No Limit - Level VIII (150/300) - 2022/04/04 18:08:56 CET [2022/04/04 12:08:56 ET]
Table '3391322540 4' 6-max Seat #2 is the button
Seat 1: jamesHRoss (7111 in chips, €0.05 bounty)
Seat 2: jeannono24 (23957 in chips, €0.05 bounty)
Seat 4: Reyzous (23718 in chips, €0.08 bounty)
Seat 5: jeje_sat (22330 in chips, €0.07 bounty)
Seat 6: RIZCHOU (11214 in chips, €0.05 bounty)
jamesHRoss: posts the ante 40
jeannono24: posts the ante 40
Reyzous: posts the ante 40
jeje_sat: posts the ante 40
RIZCHOU: posts the ante 40
Reyzous: posts small blind 150
jeje_sat: posts big blind 300
*** HOLE CARDS ***
Dealt to jeje_sat [5s 2c]
RIZCHOU: folds
jamesHRoss: folds
jeannono24: raises 450 to 750
Reyzous: folds
jeje_sat: folds
Uncalled bet (450) returned to jeannono24
jeannono24 collected 950 from pot
jeannono24: doesn't show hand
*** SUMMARY ***
Total pot 950 | Rake 0
Seat 1: jamesHRoss folded before Flop (didn't bet)
Seat 2: jeannono24 (button) collected (950)
Seat 4: Reyzous (small blind) folded before Flop
Seat 5: jeje_sat (big blind) folded before Flop
Seat 6: RIZCHOU folded before Flop (didn't bet)


PokerStars Home Game Hand #235261940083: {Club #4837790} Tournament #3391322540, €0.13+€0.05+€0.02 EUR Hold'em No Limit - Level VIII (150/300) - 2022/04/04 18:09:12 CET [2022/04/04 12:09:12 ET]
Table '3391322540 4' 6-max Seat #4 is the button
Seat 1: jamesHRoss (7071 in chips, €0.05 bounty)
Seat 2: jeannono24 (24567 in chips, €0.05 bounty)
Seat 4: Reyzous (23528 in chips, €0.08 bounty)
Seat 5: jeje_sat (21990 in chips, €0.07 bounty)
Seat 6: RIZCHOU (11174 in chips, €0.05 bounty)
jamesHRoss: posts the ante 40
jeannono24: posts the ante 40
Reyzous: posts the ante 40
jeje_sat: posts the ante 40
RIZCHOU: posts the ante 40
jeje_sat: posts small blind 150
RIZCHOU: posts big blind 300
*** HOLE CARDS ***
Dealt to jeje_sat [9s 2h]
jamesHRoss: folds
jeannono24: raises 450 to 750
Reyzous: folds
jeje_sat: folds
RIZCHOU: folds
Uncalled bet (450) returned to jeannono24
jeannono24 collected 950 from pot
jeannono24: doesn't show hand
*** SUMMARY ***
Total pot 950 | Rake 0
Seat 1: jamesHRoss folded before Flop (didn't bet)
Seat 2: jeannono24 collected (950)
Seat 4: Reyzous (button) folded before Flop (didn't bet)
Seat 5: jeje_sat (small blind) folded before Flop
Seat 6: RIZCHOU (big blind) folded before Flop


PokerStars Home Game Hand #235261949354: {Club #4837790} Tournament #3391322540, €0.13+€0.05+€0.02 EUR Hold'em No Limit - Level VIII (150/300) - 2022/04/04 18:09:40 CET [2022/04/04 12:09:40 ET]
Table '3391322540 4' 6-max Seat #5 is the button
Seat 1: jamesHRoss (7031 in chips, €0.05 bounty)
Seat 2: jeannono24 (25177 in chips, €0.05 bounty)
Seat 4: Reyzous (23488 in chips, €0.08 bounty)
Seat 5: jeje_sat (21800 in chips, €0.07 bounty)
Seat 6: RIZCHOU (10834 in chips, €0.05 bounty)
jamesHRoss: posts the ante 40
jeannono24: posts the ante 40
Reyzous: posts the ante 40
jeje_sat: posts the ante 40
RIZCHOU: posts the ante 40
RIZCHOU: posts small blind 150
jamesHRoss: posts big blind 300
*** HOLE CARDS ***
Dealt to jeje_sat [7d 4h]
jeannono24: folds
Reyzous: raises 300 to 600
jeje_sat: folds
RIZCHOU: folds
jamesHRoss: folds
Uncalled bet (300) returned to Reyzous
Reyzous collected 950 from pot
Reyzous: doesn't show hand
*** SUMMARY ***
Total pot 950 | Rake 0
Seat 1: jamesHRoss (big blind) folded before Flop
Seat 2: jeannono24 folded before Flop (didn't bet)
Seat 4: Reyzous collected (950)
Seat 5: jeje_sat (button) folded before Flop (didn't bet)
Seat 6: RIZCHOU (small blind) folded before Flop


PokerStars Home Game Hand #235261954520: {Club #4837790} Tournament #3391322540, €0.13+€0.05+€0.02 EUR Hold'em No Limit - Level VIII (150/300) - 2022/04/04 18:09:56 CET [2022/04/04 12:09:56 ET]
Table '3391322540 4' 6-max Seat #6 is the button
Seat 1: jamesHRoss (6691 in chips, €0.05 bounty)
Seat 2: jeannono24 (25137 in chips, €0.05 bounty)
Seat 4: Reyzous (24098 in chips, €0.08 bounty)
Seat 5: jeje_sat (21760 in chips, €0.07 bounty)
Seat 6: RIZCHOU (10644 in chips, €0.05 bounty)
jamesHRoss: posts the ante 40
jeannono24: posts the ante 40
Reyzous: posts the ante 40
jeje_sat: posts the ante 40
RIZCHOU: posts the ante 40
jamesHRoss: posts small blind 150
jeannono24: posts big blind 300
*** HOLE CARDS ***
Dealt to jeje_sat [5s Ad]
Reyzous: folds
jeje_sat: raises 600 to 900
RIZCHOU: raises 2450 to 3350
jamesHRoss: folds
jeannono24: folds
jeje_sat: folds
Uncalled bet (2450) returned to RIZCHOU
RIZCHOU collected 2450 from pot
RIZCHOU: doesn't show hand
*** SUMMARY ***
Total pot 2450 | Rake 0
Seat 1: jamesHRoss (small blind) folded before Flop
Seat 2: jeannono24 (big blind) folded before Flop
Seat 4: Reyzous folded before Flop (didn't bet)
Seat 5: jeje_sat folded before Flop
Seat 6: RIZCHOU (button) collected (2450)


PokerStars Home Game Hand #235261967975: {Club #4837790} Tournament #3391322540, €0.13+€0.05+€0.02 EUR Hold'em No Limit - Level IX (200/400) - 2022/04/04 18:10:37 CET [2022/04/04 12:10:37 ET]
Table '3391322540 4' 6-max Seat #1 is the button
Seat 1: jamesHRoss (6501 in chips, €0.05 bounty)
Seat 2: jeannono24 (24797 in chips, €0.05 bounty)
Seat 4: Reyzous (24058 in chips, €0.08 bounty)
Seat 5: jeje_sat (20820 in chips, €0.07 bounty)
Seat 6: RIZCHOU (12154 in chips, €0.05 bounty)
jamesHRoss: posts the ante 50
jeannono24: posts the ante 50
Reyzous: posts the ante 50
jeje_sat: posts the ante 50
RIZCHOU: posts the ante 50
jeannono24: posts small blind 200
Reyzous: posts big blind 400
*** HOLE CARDS ***
Dealt to jeje_sat [Kh 6h]
jeje_sat: folds
RIZCHOU: raises 400 to 800
jamesHRoss: raises 5651 to 6451 and is all-in
jeannono24: folds
Reyzous: folds
RIZCHOU: folds
Uncalled bet (5651) returned to jamesHRoss
jamesHRoss collected 2450 from pot
jamesHRoss: doesn't show hand
*** SUMMARY ***
Total pot 2450 | Rake 0
Seat 1: jamesHRoss (button) collected (2450)
Seat 2: jeannono24 (small blind) folded before Flop
Seat 4: Reyzous (big blind) folded before Flop
Seat 5: jeje_sat folded before Flop (didn't bet)
Seat 6: RIZCHOU folded before Flop


PokerStars Home Game Hand #235261977019: {Club #4837790} Tournament #3391322540, €0.13+€0.05+€0.02 EUR Hold'em No Limit - Level IX (200/400) - 2022/04/04 18:11:05 CET [2022/04/04 12:11:05 ET]
Table '3391322540 4' 6-max Seat #2 is the button
Seat 1: jamesHRoss (8101 in chips, €0.05 bounty)
Seat 2: jeannono24 (24547 in chips, €0.05 bounty)
Seat 4: Reyzous (23608 in chips, €0.08 bounty)
Seat 5: jeje_sat (20770 in chips, €0.07 bounty)
Seat 6: RIZCHOU (11304 in chips, €0.05 bounty)
jamesHRoss: posts the ante 50
jeannono24: posts the ante 50
Reyzous: posts the ante 50
jeje_sat: posts the ante 50
RIZCHOU: posts the ante 50
Reyzous: posts small blind 200
jeje_sat: posts big blind 400
*** HOLE CARDS ***
Dealt to jeje_sat [Ts Tc]
RIZCHOU: folds
jamesHRoss: folds
jeannono24: folds
Reyzous: calls 200
jeje_sat: raises 1050 to 1450
Reyzous: folds
Uncalled bet (1050) returned to jeje_sat
jeje_sat collected 1050 from pot
jeje_sat: doesn't show hand
*** SUMMARY ***
Total pot 1050 | Rake 0
Seat 1: jamesHRoss folded before Flop (didn't bet)
Seat 2: jeannono24 (button) folded before Flop (didn't bet)
Seat 4: Reyzous (small blind) folded before Flop
Seat 5: jeje_sat (big blind) collected (1050)
Seat 6: RIZCHOU folded before Flop (didn't bet)


PokerStars Home Game Hand #235261984891: {Club #4837790} Tournament #3391322540, €0.13+€0.05+€0.02 EUR Hold'em No Limit - Level IX (200/400) - 2022/04/04 18:11:28 CET [2022/04/04 12:11:28 ET]
Table '3391322540 4' 6-max Seat #4 is the button
Seat 1: jamesHRoss (8051 in chips, €0.05 bounty)
Seat 2: jeannono24 (24497 in chips, €0.05 bounty)
Seat 4: Reyzous (23158 in chips, €0.08 bounty)
Seat 5: jeje_sat (21370 in chips, €0.07 bounty)
Seat 6: RIZCHOU (11254 in chips, €0.05 bounty)
jamesHRoss: posts the ante 50
jeannono24: posts the ante 50
Reyzous: posts the ante 50
jeje_sat: posts the ante 50
RIZCHOU: posts the ante 50
jeje_sat: posts small blind 200
RIZCHOU: posts big blind 400
*** HOLE CARDS ***
Dealt to jeje_sat [6d 9s]
jamesHRoss: raises 400 to 800
jeannono24: folds
Reyzous: folds
jeje_sat: folds
RIZCHOU: folds
Uncalled bet (400) returned to jamesHRoss
jamesHRoss collected 1250 from pot
jamesHRoss: doesn't show hand
*** SUMMARY ***
Total pot 1250 | Rake 0
Seat 1: jamesHRoss collected (1250)
Seat 2: jeannono24 folded before Flop (didn't bet)
Seat 4: Reyzous (button) folded before Flop (didn't bet)
Seat 5: jeje_sat (small blind) folded before Flop
Seat 6: RIZCHOU (big blind) folded before Flop


PokerStars Home Game Hand #235261993180: {Club #4837790} Tournament #3391322540, €0.13+€0.05+€0.02 EUR Hold'em No Limit - Level IX (200/400) - 2022/04/04 18:11:53 CET [2022/04/04 12:11:53 ET]
Table '3391322540 4' 6-max Seat #5 is the button
Seat 1: jamesHRoss (8851 in chips, €0.05 bounty)
Seat 2: jeannono24 (24447 in chips, €0.05 bounty)
Seat 4: Reyzous (23108 in chips, €0.08 bounty)
Seat 5: jeje_sat (21120 in chips, €0.07 bounty)
Seat 6: RIZCHOU (10804 in chips, €0.05 bounty)
jamesHRoss: posts the ante 50
jeannono24: posts the ante 50
Reyzous: posts the ante 50
jeje_sat: posts the ante 50
RIZCHOU: posts the ante 50
RIZCHOU: posts small blind 200
jamesHRoss: posts big blind 400
*** HOLE CARDS ***
Dealt to jeje_sat [2d Ah]
jeannono24: folds
Reyzous: folds
jeje_sat: raises 800 to 1200
RIZCHOU: folds
jamesHRoss: calls 800
*** FLOP *** [Td 6c 4c]
jamesHRoss: checks
jeje_sat: bets 1425
jamesHRoss: calls 1425
*** TURN *** [Td 6c 4c] [Jd]
jamesHRoss: checks
jeje_sat: checks
*** RIVER *** [Td 6c 4c Jd] [Js]
jamesHRoss: bets 1800
jeje_sat said, "suspect ce petit bet"
jeje_sat has timed out
jeje_sat: folds
jeje_sat is sitting out
Uncalled bet (1800) returned to jamesHRoss
jeje_sat has returned
jamesHRoss collected 5700 from pot
jamesHRoss: doesn't show hand
*** SUMMARY ***
Total pot 5700 | Rake 0
Board [Td 6c 4c Jd Js]
Seat 1: jamesHRoss (big blind) collected (5700)
Seat 2: jeannono24 folded before Flop (didn't bet)
Seat 4: Reyzous folded before Flop (didn't bet)
Seat 5: jeje_sat (button) folded on the River
Seat 6: RIZCHOU (small blind) folded before Flop


PokerStars Home Game Hand #235262027048: {Club #4837790} Tournament #3391322540, €0.13+€0.05+€0.02 EUR Hold'em No Limit - Level IX (200/400) - 2022/04/04 18:13:36 CET [2022/04/04 12:13:36 ET]
Table '3391322540 4' 6-max Seat #6 is the button
Seat 1: jamesHRoss (11876 in chips, €0.05 bounty)
Seat 2: jeannono24 (24397 in chips, €0.05 bounty)
Seat 4: Reyzous (23058 in chips, €0.08 bounty)
Seat 5: jeje_sat (18445 in chips, €0.07 bounty)
Seat 6: RIZCHOU (10554 in chips, €0.05 bounty)
jamesHRoss: posts the ante 50
jeannono24: posts the ante 50
Reyzous: posts the ante 50
jeje_sat: posts the ante 50
RIZCHOU: posts the ante 50
jamesHRoss: posts small blind 200
jeannono24: posts big blind 400
*** HOLE CARDS ***
Dealt to jeje_sat [7d 6c]
Reyzous: raises 400 to 800
jeje_sat: folds
RIZCHOU: folds
jamesHRoss: calls 600
jeannono24: folds
*** FLOP *** [Qs 3h Kc]
jamesHRoss: checks
Reyzous: bets 800
jamesHRoss: calls 800
*** TURN *** [Qs 3h Kc] [4c]
jamesHRoss: checks
Reyzous: bets 1200
jamesHRoss: calls 1200
*** RIVER *** [Qs 3h Kc 4c] [Js]
jamesHRoss: checks
Reyzous: checks
*** SHOW DOWN ***
jamesHRoss: shows [Jd Qc] (two pair, Queens and Jacks)
Reyzous: mucks hand
jamesHRoss collected 6250 from pot
*** SUMMARY ***
Total pot 6250 | Rake 0
Board [Qs 3h Kc 4c Js]
Seat 1: jamesHRoss (small blind) showed [Jd Qc] and won (6250) with two pair, Queens and Jacks
Seat 2: jeannono24 (big blind) folded before Flop
Seat 4: Reyzous mucked [8h 8d]
Seat 5: jeje_sat folded before Flop (didn't bet)
Seat 6: RIZCHOU (button) folded before Flop (didn't bet)


PokerStars Home Game Hand #235262045112: {Club #4837790} Tournament #3391322540, €0.13+€0.05+€0.02 EUR Hold'em No Limit - Level IX (200/400) - 2022/04/04 18:14:31 CET [2022/04/04 12:14:31 ET]
Table '3391322540 4' 6-max Seat #1 is the button
Seat 1: jamesHRoss (15276 in chips, €0.05 bounty)
Seat 2: jeannono24 (23947 in chips, €0.05 bounty)
Seat 4: Reyzous (20208 in chips, €0.08 bounty)
Seat 5: jeje_sat (18395 in chips, €0.07 bounty)
Seat 6: RIZCHOU (10504 in chips, €0.05 bounty)
jamesHRoss: posts the ante 50
jeannono24: posts the ante 50
Reyzous: posts the ante 50
jeje_sat: posts the ante 50
RIZCHOU: posts the ante 50
jeannono24: posts small blind 200
Reyzous: posts big blind 400
*** HOLE CARDS ***
Dealt to jeje_sat [8s Jd]
jeje_sat: folds
RIZCHOU: folds
jamesHRoss: folds
jeannono24: folds
Uncalled bet (200) returned to Reyzous
Reyzous collected 650 from pot
Reyzous: doesn't show hand
*** SUMMARY ***
Total pot 650 | Rake 0
Seat 1: jamesHRoss (button) folded before Flop (didn't bet)
Seat 2: jeannono24 (small blind) folded before Flop
Seat 4: Reyzous (big blind) collected (650)
Seat 5: jeje_sat folded before Flop (didn't bet)
Seat 6: RIZCHOU folded before Flop (didn't bet)


PokerStars Home Game Hand #235262050441: {Club #4837790} Tournament #3391322540, €0.13+€0.05+€0.02 EUR Hold'em No Limit - Level IX (200/400) - 2022/04/04 18:14:47 CET [2022/04/04 12:14:47 ET]
Table '3391322540 4' 6-max Seat #2 is the button
Seat 1: jamesHRoss (15226 in chips, €0.05 bounty)
Seat 2: jeannono24 (23697 in chips, €0.05 bounty)
Seat 4: Reyzous (20608 in chips, €0.08 bounty)
Seat 5: jeje_sat (18345 in chips, €0.07 bounty)
Seat 6: RIZCHOU (10454 in chips, €0.05 bounty)
jamesHRoss: posts the ante 50
jeannono24: posts the ante 50
Reyzous: posts the ante 50
jeje_sat: posts the ante 50
RIZCHOU: posts the ante 50
Reyzous: posts small blind 200
jeje_sat: posts big blind 400
*** HOLE CARDS ***
Dealt to jeje_sat [Ad Ac]
RIZCHOU: folds
jamesHRoss: folds
jeannono24: folds
Reyzous: calls 200
jeje_sat: raises 1050 to 1450
Reyzous: raises 19108 to 20558 and is all-in
jeje_sat: calls 16845 and is all-in
Uncalled bet (2263) returned to Reyzous
*** FLOP *** [9c 4d 2c]
*** TURN *** [9c 4d 2c] [Kc]
*** RIVER *** [9c 4d 2c Kc] [5d]
*** SHOW DOWN ***
Reyzous: shows [As Jh] (high card Ace)
jeje_sat: shows [Ad Ac] (a pair of Aces)
jeje_sat collected 36840 from pot
*** SUMMARY ***
Total pot 36840 | Rake 0
Board [9c 4d 2c Kc 5d]
Seat 1: jamesHRoss folded before Flop (didn't bet)
Seat 2: jeannono24 (button) folded before Flop (didn't bet)
Seat 4: Reyzous (small blind) showed [As Jh] and lost with high card Ace
Seat 5: jeje_sat (big blind) showed [Ad Ac] and won (36840) with a pair of Aces
Seat 6: RIZCHOU folded before Flop (didn't bet)


PokerStars Home Game Hand #235262059773: {Club #4837790} Tournament #3391322540, €0.13+€0.05+€0.02 EUR Hold'em No Limit - Level X (250/500) - 2022/04/04 18:15:15 CET [2022/04/04 12:15:15 ET]
Table '3391322540 4' 6-max Seat #4 is the button
Seat 1: jamesHRoss (15176 in chips, €0.05 bounty)
Seat 2: jeannono24 (23647 in chips, €0.05 bounty)
Seat 4: Reyzous (2263 in chips, €0.08 bounty)
Seat 5: jeje_sat (36840 in chips, €0.07 bounty)
Seat 6: RIZCHOU (10404 in chips, €0.05 bounty)
jamesHRoss: posts the ante 65
jeannono24: posts the ante 65
Reyzous: posts the ante 65
jeje_sat: posts the ante 65
RIZCHOU: posts the ante 65
jeje_sat: posts small blind 250
RIZCHOU: posts big blind 500
*** HOLE CARDS ***
Dealt to jeje_sat [Qc Ac]
jamesHRoss: folds
jeannono24: folds
Reyzous: folds
jeje_sat: raises 1325 to 1825
RIZCHOU: raises 8514 to 10339 and is all-in
jeje_sat: calls 8514
*** FLOP *** [Ad Td 4c]
*** TURN *** [Ad Td 4c] [Tc]
*** RIVER *** [Ad Td 4c Tc] [9d]
*** SHOW DOWN ***
jeje_sat: shows [Qc Ac] (two pair, Aces and Tens)
RIZCHOU: shows [Th Ts] (four of a kind, Tens)
RIZCHOU collected 21003 from pot
*** SUMMARY ***
Total pot 21003 | Rake 0
Board [Ad Td 4c Tc 9d]
Seat 1: jamesHRoss folded before Flop (didn't bet)
Seat 2: jeannono24 folded before Flop (didn't bet)
Seat 4: Reyzous (button) folded before Flop (didn't bet)
Seat 5: jeje_sat (small blind) showed [Qc Ac] and lost with two pair, Aces and Tens
Seat 6: RIZCHOU (big blind) showed [Th Ts] and won (21003) with four of a kind, Tens


PokerStars Home Game Hand #235262073601: {Club #4837790} Tournament #3391322540, €0.13+€0.05+€0.02 EUR Hold'em No Limit - Level X (250/500) - 2022/04/04 18:15:57 CET [2022/04/04 12:15:57 ET]
Table '3391322540 4' 6-max Seat #5 is the button
Seat 1: jamesHRoss (15111 in chips, €0.05 bounty)
Seat 2: jeannono24 (23582 in chips, €0.05 bounty)
Seat 4: Reyzous (2198 in chips, €0.08 bounty)
Seat 5: jeje_sat (26436 in chips, €0.07 bounty)
Seat 6: RIZCHOU (21003 in chips, €0.05 bounty)
jamesHRoss: posts the ante 65
jeannono24: posts the ante 65
Reyzous: posts the ante 65
jeje_sat: posts the ante 65
RIZCHOU: posts the ante 65
RIZCHOU: posts small blind 250
jamesHRoss: posts big blind 500
*** HOLE CARDS ***
Dealt to jeje_sat [9d Kd]
jeannono24: folds
Reyzous: folds
jeje_sat: raises 1000 to 1500
RIZCHOU: calls 1250
jamesHRoss: folds
*** FLOP *** [Qs 4c Qd]
RIZCHOU: checks
jeje_sat: bets 1913
RIZCHOU: folds
Uncalled bet (1913) returned to jeje_sat
jeje_sat collected 3825 from pot
jeje_sat: doesn't show hand
*** SUMMARY ***
Total pot 3825 | Rake 0
Board [Qs 4c Qd]
Seat 1: jamesHRoss (big blind) folded before Flop
Seat 2: jeannono24 folded before Flop (didn't bet)
Seat 4: Reyzous folded before Flop (didn't bet)
Seat 5: jeje_sat (button) collected (3825)
Seat 6: RIZCHOU (small blind) folded on the Flop


PokerStars Home Game Hand #235262082358: {Club #4837790} Tournament #3391322540, €0.13+€0.05+€0.02 EUR Hold'em No Limit - Level X (250/500) - 2022/04/04 18:16:23 CET [2022/04/04 12:16:23 ET]
Table '3391322540 4' 6-max Seat #6 is the button
Seat 1: jamesHRoss (14546 in chips, €0.05 bounty)
Seat 2: jeannono24 (23517 in chips, €0.05 bounty)
Seat 4: Reyzous (2133 in chips, €0.08 bounty)
Seat 5: jeje_sat (28696 in chips, €0.07 bounty)
Seat 6: RIZCHOU (19438 in chips, €0.05 bounty)
jamesHRoss: posts the ante 65
jeannono24: posts the ante 65
Reyzous: posts the ante 65
jeje_sat: posts the ante 65
RIZCHOU: posts the ante 65
jamesHRoss: posts small blind 250
jeannono24: posts big blind 500
*** HOLE CARDS ***
Dealt to jeje_sat [5h 2h]
Reyzous: raises 1568 to 2068 and is all-in
jeje_sat: folds
RIZCHOU: folds
jamesHRoss: folds
jeannono24: calls 1568
*** FLOP *** [7h Td 2c]
*** TURN *** [7h Td 2c] [3c]
*** RIVER *** [7h Td 2c 3c] [Qh]
*** SHOW DOWN ***
jeannono24: shows [3s 2s] (two pair, Threes and Deuces)
Reyzous: shows [Kc Qs] (a pair of Queens)
jeannono24 collected 4711 from pot
jeannono24 wins €0.04 for eliminating Reyzous and their own bounty increases by €0.04 to €0.09
Reyzous finished the tournament in 10th place
*** SUMMARY ***
Total pot 4711 | Rake 0
Board [7h Td 2c 3c Qh]
Seat 1: jamesHRoss (small blind) folded before Flop
Seat 2: jeannono24 (big blind) showed [3s 2s] and won (4711) with two pair, Threes and Deuces
Seat 4: Reyzous showed [Kc Qs] and lost with a pair of Queens
Seat 5: jeje_sat folded before Flop (didn't bet)
Seat 6: RIZCHOU (button) folded before Flop (didn't bet)


PokerStars Home Game Hand #235262093197: {Club #4837790} Tournament #3391322540, €0.13+€0.05+€0.02 EUR Hold'em No Limit - Level X (250/500) - 2022/04/04 18:16:56 CET [2022/04/04 12:16:56 ET]
Table '3391322540 4' 6-max Seat #1 is the button
Seat 1: jamesHRoss (14231 in chips, €0.05 bounty)
Seat 2: jeannono24 (26095 in chips, €0.09 bounty)
Seat 5: jeje_sat (28631 in chips, €0.07 bounty)
Seat 6: RIZCHOU (19373 in chips, €0.05 bounty)
jamesHRoss: posts the ante 65
jeannono24: posts the ante 65
jeje_sat: posts the ante 65
RIZCHOU: posts the ante 65
jeannono24: posts small blind 250
jeje_sat: posts big blind 500
*** HOLE CARDS ***
Dealt to jeje_sat [8c Ts]
RIZCHOU: folds
jamesHRoss: raises 500 to 1000
jeannono24: folds
jeje_sat: calls 500
*** FLOP *** [Ah 7c 6h]
jeje_sat: checks
jamesHRoss: bets 1000
jeje_sat: calls 1000
*** TURN *** [Ah 7c 6h] [6s]
jeje_sat: checks
jamesHRoss: bets 1750
jeje_sat: folds
Uncalled bet (1750) returned to jamesHRoss
jamesHRoss collected 4510 from pot
jamesHRoss: doesn't show hand
*** SUMMARY ***
Total pot 4510 | Rake 0
Board [Ah 7c 6h 6s]
Seat 1: jamesHRoss (button) collected (4510)
Seat 2: jeannono24 (small blind) folded before Flop
Seat 5: jeje_sat (big blind) folded on the Turn
Seat 6: RIZCHOU folded before Flop (didn't bet)


PokerStars Home Game Hand #235262115131: {Club #4837790} Tournament #3391322540, €0.13+€0.05+€0.02 EUR Hold'em No Limit - Level X (250/500) - 2022/04/04 18:18:02 CET [2022/04/04 12:18:02 ET]
Table '3391322540 4' 6-max Seat #2 is the button
Seat 1: jamesHRoss (16676 in chips, €0.05 bounty)
Seat 2: jeannono24 (25780 in chips, €0.09 bounty)
Seat 5: jeje_sat (26566 in chips, €0.07 bounty)
Seat 6: RIZCHOU (19308 in chips, €0.05 bounty)
jamesHRoss: posts the ante 65
jeannono24: posts the ante 65
jeje_sat: posts the ante 65
RIZCHOU: posts the ante 65
jeje_sat: posts small blind 250
RIZCHOU: posts big blind 500
*** HOLE CARDS ***
Dealt to jeje_sat [8s As]
jamesHRoss: raises 500 to 1000
jeannono24: folds
jeje_sat: calls 750
RIZCHOU: folds
*** FLOP *** [Qd Js Kh]
jeje_sat: checks
jamesHRoss: checks
*** TURN *** [Qd Js Kh] [Qc]
jeje_sat: checks
jamesHRoss: checks
*** RIVER *** [Qd Js Kh Qc] [Kd]
jeje_sat: checks
jamesHRoss: checks
*** SHOW DOWN ***
jeje_sat: shows [8s As] (two pair, Kings and Queens)
jamesHRoss: mucks hand
jeje_sat collected 2760 from pot
*** SUMMARY ***
Total pot 2760 | Rake 0
Board [Qd Js Kh Qc Kd]
Seat 1: jamesHRoss mucked [2d 2h]
Seat 2: jeannono24 (button) folded before Flop (didn't bet)
Seat 5: jeje_sat (small blind) showed [8s As] and won (2760) with two pair, Kings and Queens
Seat 6: RIZCHOU (big blind) folded before Flop


PokerStars Home Game Hand #235262128046: {Club #4837790} Tournament #3391322540, €0.13+€0.05+€0.02 EUR Hold'em No Limit - Level X (250/500) - 2022/04/04 18:18:40 CET [2022/04/04 12:18:40 ET]
Table '3391322540 4' 6-max Seat #5 is the button
Seat 1: jamesHRoss (15611 in chips, €0.05 bounty)
Seat 2: jeannono24 (25715 in chips, €0.09 bounty)
Seat 5: jeje_sat (28261 in chips, €0.07 bounty)
Seat 6: RIZCHOU (18743 in chips, €0.05 bounty)
jamesHRoss: posts the ante 65
jeannono24: posts the ante 65
jeje_sat: posts the ante 65
RIZCHOU: posts the ante 65
RIZCHOU: posts small blind 250
jamesHRoss: posts big blind 500
*** HOLE CARDS ***
Dealt to jeje_sat [8h Jd]
jeannono24: folds
jeje_sat: raises 1000 to 1500
RIZCHOU: folds
jamesHRoss: folds
Uncalled bet (1000) returned to jeje_sat
jeje_sat collected 1510 from pot
jeje_sat: doesn't show hand
*** SUMMARY ***
Total pot 1510 | Rake 0
Seat 1: jamesHRoss (big blind) folded before Flop
Seat 2: jeannono24 folded before Flop (didn't bet)
Seat 5: jeje_sat (button) collected (1510)
Seat 6: RIZCHOU (small blind) folded before Flop


PokerStars Home Game Hand #235262134557: {Club #4837790} Tournament #3391322540, €0.13+€0.05+€0.02 EUR Hold'em No Limit - Level X (250/500) - 2022/04/04 18:18:59 CET [2022/04/04 12:18:59 ET]
Table '3391322540 4' 6-max Seat #6 is the button
Seat 1: jamesHRoss (15046 in chips, €0.05 bounty)
Seat 2: jeannono24 (25650 in chips, €0.09 bounty)
Seat 5: jeje_sat (29206 in chips, €0.07 bounty)
Seat 6: RIZCHOU (18428 in chips, €0.05 bounty)
jamesHRoss: posts the ante 65
jeannono24: posts the ante 65
jeje_sat: posts the ante 65
RIZCHOU: posts the ante 65
jamesHRoss: posts small blind 250
jeannono24: posts big blind 500
*** HOLE CARDS ***
Dealt to jeje_sat [Qd Tc]
jeje_sat: raises 1000 to 1500
RIZCHOU: folds
jamesHRoss: raises 13481 to 14981 and is all-in
jeannono24: folds
jeje_sat: folds
Uncalled bet (13481) returned to jamesHRoss
jamesHRoss collected 3760 from pot
jamesHRoss: doesn't show hand
*** SUMMARY ***
Total pot 3760 | Rake 0
Seat 1: jamesHRoss (small blind) collected (3760)
Seat 2: jeannono24 (big blind) folded before Flop
Seat 5: jeje_sat folded before Flop
Seat 6: RIZCHOU (button) folded before Flop (didn't bet)


PokerStars Home Game Hand #235262144088: {Club #4837790} Tournament #3391322540, €0.13+€0.05+€0.02 EUR Hold'em No Limit - Level X (250/500) - 2022/04/04 18:19:28 CET [2022/04/04 12:19:28 ET]
Table '3391322540 4' 6-max Seat #1 is the button
Seat 1: jamesHRoss (17241 in chips, €0.05 bounty)
Seat 2: jeannono24 (25085 in chips, €0.09 bounty)
Seat 5: jeje_sat (27641 in chips, €0.07 bounty)
Seat 6: RIZCHOU (18363 in chips, €0.05 bounty)
jamesHRoss: posts the ante 65
jeannono24: posts the ante 65
jeje_sat: posts the ante 65
RIZCHOU: posts the ante 65
jeannono24: posts small blind 250
jeje_sat: posts big blind 500
*** HOLE CARDS ***
Dealt to jeje_sat [6h Kd]
RIZCHOU: folds
jamesHRoss: raises 500 to 1000
jeannono24: folds
jeje_sat: folds
Uncalled bet (500) returned to jamesHRoss
jamesHRoss collected 1510 from pot
jamesHRoss: doesn't show hand
*** SUMMARY ***
Total pot 1510 | Rake 0
Seat 1: jamesHRoss (button) collected (1510)
Seat 2: jeannono24 (small blind) folded before Flop
Seat 5: jeje_sat (big blind) folded before Flop
Seat 6: RIZCHOU folded before Flop (didn't bet)


PokerStars Home Game Hand #235262150402: {Club #4837790} Tournament #3391322540, €0.13+€0.05+€0.02 EUR Hold'em No Limit - Level X (250/500) - 2022/04/04 18:19:47 CET [2022/04/04 12:19:47 ET]
Table '3391322540 4' 6-max Seat #2 is the button
Seat 1: jamesHRoss (18186 in chips, €0.05 bounty)
Seat 2: jeannono24 (24770 in chips, €0.09 bounty)
Seat 5: jeje_sat (27076 in chips, €0.07 bounty)
Seat 6: RIZCHOU (18298 in chips, €0.05 bounty)
jamesHRoss: posts the ante 65
jeannono24: posts the ante 65
jeje_sat: posts the ante 65
RIZCHOU: posts the ante 65
jeje_sat: posts small blind 250
RIZCHOU: posts big blind 500
*** HOLE CARDS ***
Dealt to jeje_sat [Ks 3h]
jamesHRoss: folds
jeannono24: raises 750 to 1250
jeje_sat: folds
RIZCHOU: folds
Uncalled bet (750) returned to jeannono24
jeannono24 collected 1510 from pot
jeannono24: doesn't show hand
*** SUMMARY ***
Total pot 1510 | Rake 0
Seat 1: jamesHRoss folded before Flop (didn't bet)
Seat 2: jeannono24 (button) collected (1510)
Seat 5: jeje_sat (small blind) folded before Flop
Seat 6: RIZCHOU (big blind) folded before Flop


PokerStars Home Game Hand #235262155053: {Club #4837790} Tournament #3391322540, €0.13+€0.05+€0.02 EUR Hold'em No Limit - Level X (250/500) - 2022/04/04 18:20:01 CET [2022/04/04 12:20:01 ET]
Table '3391322540 4' 6-max Seat #5 is the button
Seat 1: jamesHRoss (18121 in chips, €0.05 bounty)
Seat 2: jeannono24 (25715 in chips, €0.09 bounty)
Seat 5: jeje_sat (26761 in chips, €0.07 bounty)
Seat 6: RIZCHOU (17733 in chips, €0.05 bounty)
jamesHRoss: posts the ante 65
jeannono24: posts the ante 65
jeje_sat: posts the ante 65
RIZCHOU: posts the ante 65
RIZCHOU: posts small blind 250
jamesHRoss: posts big blind 500
*** HOLE CARDS ***
Dealt to jeje_sat [Kc 3s]
jeannono24: folds
jeje_sat: folds
RIZCHOU: raises 1000 to 1500
jamesHRoss: folds
Uncalled bet (1000) returned to RIZCHOU
RIZCHOU collected 1260 from pot
RIZCHOU: doesn't show hand
*** SUMMARY ***
Total pot 1260 | Rake 0
Seat 1: jamesHRoss (big blind) folded before Flop
Seat 2: jeannono24 folded before Flop (didn't bet)
Seat 5: jeje_sat (button) folded before Flop (didn't bet)
Seat 6: RIZCHOU (small blind) collected (1260)


PokerStars Home Game Hand #235262161989: {Club #4837790} Tournament #3391322540, €0.13+€0.05+€0.02 EUR Hold'em No Limit - Level XI (300/600) - 2022/04/04 18:20:22 CET [2022/04/04 12:20:22 ET]
Table '3391322540 4' 6-max Seat #6 is the button
Seat 1: jamesHRoss (17556 in chips, €0.05 bounty)
Seat 2: jeannono24 (25650 in chips, €0.09 bounty)
Seat 5: jeje_sat (26696 in chips, €0.07 bounty)
Seat 6: RIZCHOU (18428 in chips, €0.05 bounty)
jamesHRoss: posts the ante 75
jeannono24: posts the ante 75
jeje_sat: posts the ante 75
RIZCHOU: posts the ante 75
jamesHRoss: posts small blind 300
jeannono24: posts big blind 600
*** HOLE CARDS ***
Dealt to jeje_sat [6d 8c]
jeje_sat: raises 1200 to 1800
RIZCHOU: folds
jamesHRoss: raises 3300 to 5100
jeannono24: folds
jeje_sat: calls 3300
*** FLOP *** [Qc 7h 8h]
jamesHRoss: checks
jeje_sat: bets 5550
jamesHRoss: raises 6831 to 12381 and is all-in
jeje_sat has timed out
jeje_sat: folds
jeje_sat is sitting out
Uncalled bet (6831) returned to jamesHRoss
jamesHRoss collected 22200 from pot
jamesHRoss: doesn't show hand
jeje_sat has returned
*** SUMMARY ***
Total pot 22200 | Rake 0
Board [Qc 7h 8h]
Seat 1: jamesHRoss (small blind) collected (22200)
Seat 2: jeannono24 (big blind) folded before Flop
Seat 5: jeje_sat folded on the Flop
Seat 6: RIZCHOU (button) folded before Flop (didn't bet)


PokerStars Home Game Hand #235262187461: {Club #4837790} Tournament #3391322540, €0.13+€0.05+€0.02 EUR Hold'em No Limit - Level XI (300/600) - 2022/04/04 18:21:38 CET [2022/04/04 12:21:38 ET]
Table '3391322540 4' 6-max Seat #1 is the button
Seat 1: jamesHRoss (29031 in chips, €0.05 bounty)
Seat 2: jeannono24 (24975 in chips, €0.09 bounty)
Seat 5: jeje_sat (15971 in chips, €0.07 bounty)
Seat 6: RIZCHOU (18353 in chips, €0.05 bounty)
jamesHRoss: posts the ante 75
jeannono24: posts the ante 75
jeje_sat: posts the ante 75
RIZCHOU: posts the ante 75
jeannono24: posts small blind 300
jeje_sat: posts big blind 600
*** HOLE CARDS ***
Dealt to jeje_sat [Qh 9s]
RIZCHOU: folds
jamesHRoss: folds
jeannono24: raises 1200 to 1800
jeje_sat: calls 1200
*** FLOP *** [Kd Tc 9c]
jeannono24: checks
jeje_sat: checks
*** TURN *** [Kd Tc 9c] [8c]
jeannono24: bets 1287
jeje_sat: calls 1287
*** RIVER *** [Kd Tc 9c 8c] [6h]
jeannono24: bets 2136
jeje_sat: raises 10673 to 12809 and is all-in
jeannono24: folds
Uncalled bet (10673) returned to jeje_sat
jeje_sat collected 10746 from pot
jeje_sat: doesn't show hand
*** SUMMARY ***
Total pot 10746 | Rake 0
Board [Kd Tc 9c 8c 6h]
Seat 1: jamesHRoss (button) folded before Flop (didn't bet)
Seat 2: jeannono24 (small blind) folded on the River
Seat 5: jeje_sat (big blind) collected (10746)
Seat 6: RIZCHOU folded before Flop (didn't bet)


PokerStars Home Game Hand #235262212631: {Club #4837790} Tournament #3391322540, €0.13+€0.05+€0.02 EUR Hold'em No Limit - Level XI (300/600) - 2022/04/04 18:22:54 CET [2022/04/04 12:22:54 ET]
Table '3391322540 4' 6-max Seat #2 is the button
Seat 1: jamesHRoss (28956 in chips, €0.05 bounty)
Seat 2: jeannono24 (19677 in chips, €0.09 bounty)
Seat 5: jeje_sat (21419 in chips, €0.07 bounty)
Seat 6: RIZCHOU (18278 in chips, €0.05 bounty)
jamesHRoss: posts the ante 75
jeannono24: posts the ante 75
jeje_sat: posts the ante 75
RIZCHOU: posts the ante 75
jeje_sat: posts small blind 300
RIZCHOU: posts big blind 600
*** HOLE CARDS ***
Dealt to jeje_sat [Jd As]
jamesHRoss: folds
jeannono24: folds
jeje_sat: raises 1200 to 1800
RIZCHOU: folds
Uncalled bet (1200) returned to jeje_sat
jeje_sat collected 1500 from pot
jeje_sat: doesn't show hand
*** SUMMARY ***
Total pot 1500 | Rake 0
Seat 1: jamesHRoss folded before Flop (didn't bet)
Seat 2: jeannono24 (button) folded before Flop (didn't bet)
Seat 5: jeje_sat (small blind) collected (1500)
Seat 6: RIZCHOU (big blind) folded before Flop


PokerStars Home Game Hand #235262219792: {Club #4837790} Tournament #3391322540, €0.13+€0.05+€0.02 EUR Hold'em No Limit - Level XI (300/600) - 2022/04/04 18:23:16 CET [2022/04/04 12:23:16 ET]
Table '3391322540 4' 6-max Seat #5 is the button
Seat 1: jamesHRoss (28881 in chips, €0.05 bounty)
Seat 2: jeannono24 (19602 in chips, €0.09 bounty)
Seat 5: jeje_sat (22244 in chips, €0.07 bounty)
Seat 6: RIZCHOU (17603 in chips, €0.05 bounty)
jamesHRoss: posts the ante 75
jeannono24: posts the ante 75
jeje_sat: posts the ante 75
RIZCHOU: posts the ante 75
RIZCHOU: posts small blind 300
jamesHRoss: posts big blind 600
*** HOLE CARDS ***
Dealt to jeje_sat [6h Jh]
jeannono24: folds
jeje_sat: raises 1200 to 1800
RIZCHOU: folds
jamesHRoss: folds
Uncalled bet (1200) returned to jeje_sat
jeje_sat collected 1800 from pot
jeje_sat: doesn't show hand
*** SUMMARY ***
Total pot 1800 | Rake 0
Seat 1: jamesHRoss (big blind) folded before Flop
Seat 2: jeannono24 folded before Flop (didn't bet)
Seat 5: jeje_sat (button) collected (1800)
Seat 6: RIZCHOU (small blind) folded before Flop


PokerStars Home Game Hand #235262232221: {Club #4837790} Tournament #3391322540, €0.13+€0.05+€0.02 EUR Hold'em No Limit - Level XI (300/600) - 2022/04/04 18:23:53 CET [2022/04/04 12:23:53 ET]
Table '3391322540 4' 6-max Seat #6 is the button
Seat 1: jamesHRoss (28206 in chips, €0.05 bounty)
Seat 2: jeannono24 (19527 in chips, €0.09 bounty)
Seat 5: jeje_sat (23369 in chips, €0.07 bounty)
Seat 6: RIZCHOU (17228 in chips, €0.05 bounty)
jamesHRoss: posts the ante 75
jeannono24: posts the ante 75
jeje_sat: posts the ante 75
RIZCHOU: posts the ante 75
jamesHRoss: posts small blind 300
jeannono24: posts big blind 600
*** HOLE CARDS ***
Dealt to jeje_sat [Jd 4d]
jeje_sat: folds
RIZCHOU: folds
jamesHRoss: calls 300
jeannono24: checks
*** FLOP *** [3s 8h 4s]
jamesHRoss: bets 600
jeannono24: folds
Uncalled bet (600) returned to jamesHRoss
jamesHRoss collected 1500 from pot
jamesHRoss: doesn't show hand
*** SUMMARY ***
Total pot 1500 | Rake 0
Board [3s 8h 4s]
Seat 1: jamesHRoss (small blind) collected (1500)
Seat 2: jeannono24 (big blind) folded on the Flop
Seat 5: jeje_sat folded before Flop (didn't bet)
Seat 6: RIZCHOU (button) folded before Flop (didn't bet)


PokerStars Home Game Hand #235262247949: {Club #4837790} Tournament #3391322540, €0.13+€0.05+€0.02 EUR Hold'em No Limit - Level XI (300/600) - 2022/04/04 18:24:40 CET [2022/04/04 12:24:40 ET]
Table '3391322540 4' 6-max Seat #1 is the button
Seat 1: jamesHRoss (29031 in chips, €0.05 bounty)
Seat 2: jeannono24 (18852 in chips, €0.09 bounty)
Seat 5: jeje_sat (23294 in chips, €0.07 bounty)
Seat 6: RIZCHOU (17153 in chips, €0.05 bounty)
jamesHRoss: posts the ante 75
jeannono24: posts the ante 75
jeje_sat: posts the ante 75
RIZCHOU: posts the ante 75
jeannono24: posts small blind 300
jeje_sat: posts big blind 600
*** HOLE CARDS ***
Dealt to jeje_sat [7d Kc]
RIZCHOU: folds
jamesHRoss: folds
jeannono24: raises 1200 to 1800
jeje_sat: folds
Uncalled bet (1200) returned to jeannono24
jeannono24 collected 1500 from pot
jeannono24: doesn't show hand
*** SUMMARY ***
Total pot 1500 | Rake 0
Seat 1: jamesHRoss (button) folded before Flop (didn't bet)
Seat 2: jeannono24 (small blind) collected (1500)
Seat 5: jeje_sat (big blind) folded before Flop
Seat 6: RIZCHOU folded before Flop (didn't bet)


PokerStars Home Game Hand #235262253559: {Club #4837790} Tournament #3391322540, €0.13+€0.05+€0.02 EUR Hold'em No Limit - Level XI (300/600) - 2022/04/04 18:24:57 CET [2022/04/04 12:24:57 ET]
Table '3391322540 4' 6-max Seat #2 is the button
Seat 1: jamesHRoss (28956 in chips, €0.05 bounty)
Seat 2: jeannono24 (19677 in chips, €0.09 bounty)
Seat 5: jeje_sat (22619 in chips, €0.07 bounty)
Seat 6: RIZCHOU (17078 in chips, €0.05 bounty)
jamesHRoss: posts the ante 75
jeannono24: posts the ante 75
jeje_sat: posts the ante 75
RIZCHOU: posts the ante 75
jeje_sat: posts small blind 300
RIZCHOU: posts big blind 600
*** HOLE CARDS ***
Dealt to jeje_sat [Jc 9s]
jamesHRoss: folds
jeannono24: folds
jeje_sat: raises 1200 to 1800
RIZCHOU: folds
Uncalled bet (1200) returned to jeje_sat
jeje_sat collected 1500 from pot
jeje_sat: doesn't show hand
*** SUMMARY ***
Total pot 1500 | Rake 0
Seat 1: jamesHRoss folded before Flop (didn't bet)
Seat 2: jeannono24 (button) folded before Flop (didn't bet)
Seat 5: jeje_sat (small blind) collected (1500)
Seat 6: RIZCHOU (big blind) folded before Flop


PokerStars Home Game Hand #235262259290: {Club #4837790} Tournament #3391322540, €0.13+€0.05+€0.02 EUR Hold'em No Limit - Level XII (350/700) - 2022/04/04 18:25:13 CET [2022/04/04 12:25:13 ET]
Table '3391322540 4' 6-max Seat #5 is the button
Seat 1: jamesHRoss (28881 in chips, €0.05 bounty)
Seat 2: jeannono24 (19602 in chips, €0.09 bounty)
Seat 5: jeje_sat (23444 in chips, €0.07 bounty)
Seat 6: RIZCHOU (16403 in chips, €0.05 bounty)
jamesHRoss: posts the ante 90
jeannono24: posts the ante 90
jeje_sat: posts the ante 90
RIZCHOU: posts the ante 90
RIZCHOU: posts small blind 350
jamesHRoss: posts big blind 700
*** HOLE CARDS ***
Dealt to jeje_sat [Kc 4h]
jeannono24: folds
jeje_sat: folds
RIZCHOU: folds
Uncalled bet (350) returned to jamesHRoss
jamesHRoss collected 1060 from pot
jamesHRoss: doesn't show hand
*** SUMMARY ***
Total pot 1060 | Rake 0
Seat 1: jamesHRoss (big blind) collected (1060)
Seat 2: jeannono24 folded before Flop (didn't bet)
Seat 5: jeje_sat (button) folded before Flop (didn't bet)
Seat 6: RIZCHOU (small blind) folded before Flop


PokerStars Home Game Hand #235262264893: {Club #4837790} Tournament #3391322540, €0.13+€0.05+€0.02 EUR Hold'em No Limit - Level XII (350/700) - 2022/04/04 18:25:30 CET [2022/04/04 12:25:30 ET]
Table '3391322540 4' 6-max Seat #6 is the button
Seat 1: jamesHRoss (29501 in chips, €0.05 bounty)
Seat 2: jeannono24 (19512 in chips, €0.09 bounty)
Seat 5: jeje_sat (23354 in chips, €0.07 bounty)
Seat 6: RIZCHOU (15963 in chips, €0.05 bounty)
jamesHRoss: posts the ante 90
jeannono24: posts the ante 90
jeje_sat: posts the ante 90
RIZCHOU: posts the ante 90
jamesHRoss: posts small blind 350
jeannono24: posts big blind 700
*** HOLE CARDS ***
Dealt to jeje_sat [Js 8s]
jeje_sat: raises 1400 to 2100
RIZCHOU: folds
jamesHRoss: folds
jeannono24: raises 17322 to 19422 and is all-in
jeje_sat: folds
Uncalled bet (17322) returned to jeannono24
jeannono24 collected 4910 from pot
jeannono24: doesn't show hand
*** SUMMARY ***
Total pot 4910 | Rake 0
Seat 1: jamesHRoss (small blind) folded before Flop
Seat 2: jeannono24 (big blind) collected (4910)
Seat 5: jeje_sat folded before Flop
Seat 6: RIZCHOU (button) folded before Flop (didn't bet)


PokerStars Home Game Hand #235262271389: {Club #4837790} Tournament #3391322540, €0.13+€0.05+€0.02 EUR Hold'em No Limit - Level XII (350/700) - 2022/04/04 18:25:48 CET [2022/04/04 12:25:48 ET]
Table '3391322540 4' 6-max Seat #1 is the button
Seat 1: jamesHRoss (29061 in chips, €0.05 bounty)
Seat 2: jeannono24 (22232 in chips, €0.09 bounty)
Seat 5: jeje_sat (21164 in chips, €0.07 bounty)
Seat 6: RIZCHOU (15873 in chips, €0.05 bounty)
jamesHRoss: posts the ante 90
jeannono24: posts the ante 90
jeje_sat: posts the ante 90
RIZCHOU: posts the ante 90
jeannono24: posts small blind 350
jeje_sat: posts big blind 700
*** HOLE CARDS ***
Dealt to jeje_sat [Kh 4s]
RIZCHOU: raises 700 to 1400
jamesHRoss: folds
jeannono24: folds
jeje_sat: folds
Uncalled bet (700) returned to RIZCHOU
RIZCHOU collected 2110 from pot
RIZCHOU: doesn't show hand
*** SUMMARY ***
Total pot 2110 | Rake 0
Seat 1: jamesHRoss (button) folded before Flop (didn't bet)
Seat 2: jeannono24 (small blind) folded before Flop
Seat 5: jeje_sat (big blind) folded before Flop
Seat 6: RIZCHOU collected (2110)


PokerStars Home Game Hand #235262276123: {Club #4837790} Tournament #3391322540, €0.13+€0.05+€0.02 EUR Hold'em No Limit - Level XII (350/700) - 2022/04/04 18:26:02 CET [2022/04/04 12:26:02 ET]
Table '3391322540 4' 6-max Seat #2 is the button
Seat 1: jamesHRoss (28971 in chips, €0.05 bounty)
Seat 2: jeannono24 (21792 in chips, €0.09 bounty)
Seat 5: jeje_sat (20374 in chips, €0.07 bounty)
Seat 6: RIZCHOU (17193 in chips, €0.05 bounty)
jamesHRoss: posts the ante 90
jeannono24: posts the ante 90
jeje_sat: posts the ante 90
RIZCHOU: posts the ante 90
jeje_sat: posts small blind 350
RIZCHOU: posts big blind 700
*** HOLE CARDS ***
Dealt to jeje_sat [Th 5h]
jamesHRoss: folds
jeannono24: folds
jeje_sat has timed out
jeje_sat: folds
jeje_sat is sitting out
Uncalled bet (350) returned to RIZCHOU
RIZCHOU collected 1060 from pot
RIZCHOU: doesn't show hand
*** SUMMARY ***
Total pot 1060 | Rake 0
Seat 1: jamesHRoss folded before Flop (didn't bet)
Seat 2: jeannono24 (button) folded before Flop (didn't bet)
Seat 5: jeje_sat (small blind) folded before Flop
Seat 6: RIZCHOU (big blind) collected (1060)


PokerStars Home Game Hand #235262287400: {Club #4837790} Tournament #3391322540, €0.13+€0.05+€0.02 EUR Hold'em No Limit - Level XII (350/700) - 2022/04/04 18:26:34 CET [2022/04/04 12:26:34 ET]
Table '3391322540 4' 6-max Seat #5 is the button
Seat 1: jamesHRoss (28881 in chips, €0.05 bounty)
Seat 2: jeannono24 (21702 in chips, €0.09 bounty)
Seat 5: jeje_sat (19934 in chips, €0.07 bounty) is sitting out
Seat 6: RIZCHOU (17813 in chips, €0.05 bounty)
jamesHRoss: posts the ante 90
jeannono24: posts the ante 90
jeje_sat: posts the ante 90
RIZCHOU: posts the ante 90
RIZCHOU: posts small blind 350
jamesHRoss: posts big blind 700
*** HOLE CARDS ***
Dealt to jeje_sat [Js As]
jeannono24: raises 1050 to 1750
jeje_sat: folds
RIZCHOU: folds
jamesHRoss: folds
Uncalled bet (1050) returned to jeannono24
jeannono24 collected 2110 from pot
jeannono24: doesn't show hand
*** SUMMARY ***
Total pot 2110 | Rake 0
Seat 1: jamesHRoss (big blind) folded before Flop
Seat 2: jeannono24 collected (2110)
Seat 5: jeje_sat (button) folded before Flop (didn't bet)
Seat 6: RIZCHOU (small blind) folded before Flop


PokerStars Home Game Hand #235262292964: {Club #4837790} Tournament #3391322540, €0.13+€0.05+€0.02 EUR Hold'em No Limit - Level XII (350/700) - 2022/04/04 18:26:50 CET [2022/04/04 12:26:50 ET]
Table '3391322540 4' 6-max Seat #6 is the button
Seat 1: jamesHRoss (28091 in chips, €0.05 bounty)
Seat 2: jeannono24 (23022 in chips, €0.09 bounty)
Seat 5: jeje_sat (19844 in chips, €0.07 bounty) is sitting out
Seat 6: RIZCHOU (17373 in chips, €0.05 bounty)
jamesHRoss: posts the ante 90
jeannono24: posts the ante 90
jeje_sat: posts the ante 90
RIZCHOU: posts the ante 90
jamesHRoss: posts small blind 350
jeannono24: posts big blind 700
*** HOLE CARDS ***
Dealt to jeje_sat [2h Jd]
jeje_sat: folds
RIZCHOU: raises 700 to 1400
jamesHRoss: folds
jeannono24: calls 700
*** FLOP *** [Kh Jc Th]
jeannono24: checks
RIZCHOU: bets 878
jeannono24: calls 878
*** TURN *** [Kh Jc Th] [4s]
jeje_sat has returned
jeannono24: checks
RIZCHOU: checks
*** RIVER *** [Kh Jc Th 4s] [Qs]
jeannono24: bets 4055
RIZCHOU: raises 10950 to 15005 and is all-in
jeannono24: calls 10950
*** SHOW DOWN ***
RIZCHOU: shows [9h Ad] (a straight, Ten to Ace)
jeannono24: shows [4d Ah] (a straight, Ten to Ace)
jeannono24 collected 17638 from pot
RIZCHOU collected 17638 from pot
*** SUMMARY ***
Total pot 35276 | Rake 0
Board [Kh Jc Th 4s Qs]
Seat 1: jamesHRoss (small blind) folded before Flop
Seat 2: jeannono24 (big blind) showed [4d Ah] and won (17638) with a straight, Ten to Ace
Seat 5: jeje_sat folded before Flop (didn't bet)
Seat 6: RIZCHOU (button) showed [9h Ad] and won (17638) with a straight, Ten to Ace


PokerStars Home Game Hand #235262305699: {Club #4837790} Tournament #3391322540, €0.13+€0.05+€0.02 EUR Hold'em No Limit - Level XII (350/700) - 2022/04/04 18:27:27 CET [2022/04/04 12:27:27 ET]
Table '3391322540 4' 6-max Seat #1 is the button
Seat 1: jamesHRoss (27651 in chips, €0.05 bounty)
Seat 2: jeannono24 (23287 in chips, €0.09 bounty)
Seat 5: jeje_sat (19754 in chips, €0.07 bounty)
Seat 6: RIZCHOU (17638 in chips, €0.05 bounty)
jamesHRoss: posts the ante 90
jeannono24: posts the ante 90
jeje_sat: posts the ante 90
RIZCHOU: posts the ante 90
jeannono24: posts small blind 350
jeje_sat: posts big blind 700
*** HOLE CARDS ***
Dealt to jeje_sat [Ts Kc]
RIZCHOU: raises 700 to 1400
jamesHRoss: folds
jeannono24: folds
jeje_sat: calls 700
*** FLOP *** [3d 7d Qd]
jeje_sat: checks
RIZCHOU: bets 878
jeje_sat: folds
Uncalled bet (878) returned to RIZCHOU
RIZCHOU collected 3510 from pot
RIZCHOU: doesn't show hand
*** SUMMARY ***
Total pot 3510 | Rake 0
Board [3d 7d Qd]
Seat 1: jamesHRoss (button) folded before Flop (didn't bet)
Seat 2: jeannono24 (small blind) folded before Flop
Seat 5: jeje_sat (big blind) folded on the Flop
Seat 6: RIZCHOU collected (3510)


PokerStars Home Game Hand #235262314722: {Club #4837790} Tournament #3391322540, €0.13+€0.05+€0.02 EUR Hold'em No Limit - Level XII (350/700) - 2022/04/04 18:27:53 CET [2022/04/04 12:27:53 ET]
Table '3391322540 4' 6-max Seat #2 is the button
Seat 1: jamesHRoss (27561 in chips, €0.05 bounty)
Seat 2: jeannono24 (22847 in chips, €0.09 bounty)
Seat 5: jeje_sat (18264 in chips, €0.07 bounty)
Seat 6: RIZCHOU (19658 in chips, €0.05 bounty)
jamesHRoss: posts the ante 90
jeannono24: posts the ante 90
jeje_sat: posts the ante 90
RIZCHOU: posts the ante 90
jeje_sat: posts small blind 350
RIZCHOU: posts big blind 700
*** HOLE CARDS ***
Dealt to jeje_sat [Ts 6s]
jamesHRoss: folds
jeannono24: folds
jeje_sat: raises 1400 to 2100
RIZCHOU: folds
Uncalled bet (1400) returned to jeje_sat
jeje_sat collected 1760 from pot
jeje_sat: doesn't show hand
*** SUMMARY ***
Total pot 1760 | Rake 0
Seat 1: jamesHRoss folded before Flop (didn't bet)
Seat 2: jeannono24 (button) folded before Flop (didn't bet)
Seat 5: jeje_sat (small blind) collected (1760)
Seat 6: RIZCHOU (big blind) folded before Flop


PokerStars Home Game Hand #235262320236: {Club #4837790} Tournament #3391322540, €0.13+€0.05+€0.02 EUR Hold'em No Limit - Level XII (350/700) - 2022/04/04 18:28:09 CET [2022/04/04 12:28:09 ET]
Table '3391322540 4' 6-max Seat #5 is the button
Seat 1: jamesHRoss (27471 in chips, €0.05 bounty)
Seat 2: jeannono24 (22757 in chips, €0.09 bounty)
Seat 5: jeje_sat (19234 in chips, €0.07 bounty)
Seat 6: RIZCHOU (18868 in chips, €0.05 bounty)
jamesHRoss: posts the ante 90
jeannono24: posts the ante 90
jeje_sat: posts the ante 90
RIZCHOU: posts the ante 90
RIZCHOU: posts small blind 350
jamesHRoss: posts big blind 700
*** HOLE CARDS ***
Dealt to jeje_sat [6h Jc]
jeannono24: folds
jeje_sat: folds
RIZCHOU: raises 1050 to 1750
jamesHRoss: folds
Uncalled bet (1050) returned to RIZCHOU
RIZCHOU collected 1760 from pot
RIZCHOU: doesn't show hand
*** SUMMARY ***
Total pot 1760 | Rake 0
Seat 1: jamesHRoss (big blind) folded before Flop
Seat 2: jeannono24 folded before Flop (didn't bet)
Seat 5: jeje_sat (button) folded before Flop (didn't bet)
Seat 6: RIZCHOU (small blind) collected (1760)


PokerStars Home Game Hand #235262328801: {Club #4837790} Tournament #3391322540, €0.13+€0.05+€0.02 EUR Hold'em No Limit - Level XII (350/700) - 2022/04/04 18:28:33 CET [2022/04/04 12:28:33 ET]
Table '3391322540 4' 6-max Seat #6 is the button
Seat 1: jamesHRoss (26681 in chips, €0.05 bounty)
Seat 2: jeannono24 (22667 in chips, €0.09 bounty)
Seat 5: jeje_sat (19144 in chips, €0.07 bounty)
Seat 6: RIZCHOU (19838 in chips, €0.05 bounty)
jamesHRoss: posts the ante 90
jeannono24: posts the ante 90
jeje_sat: posts the ante 90
RIZCHOU: posts the ante 90
jamesHRoss: posts small blind 350
jeannono24: posts big blind 700
*** HOLE CARDS ***
Dealt to jeje_sat [2h 7c]
jeje_sat: raises 1400 to 2100
RIZCHOU: folds
jamesHRoss: folds
jeannono24: folds
Uncalled bet (1400) returned to jeje_sat
jeje_sat collected 2110 from pot
jeje_sat: doesn't show hand
*** SUMMARY ***
Total pot 2110 | Rake 0
Seat 1: jamesHRoss (small blind) folded before Flop
Seat 2: jeannono24 (big blind) folded before Flop
Seat 5: jeje_sat collected (2110)
Seat 6: RIZCHOU (button) folded before Flop (didn't bet)


PokerStars Home Game Hand #235262336247: {Club #4837790} Tournament #3391322540, €0.13+€0.05+€0.02 EUR Hold'em No Limit - Level XII (350/700) - 2022/04/04 18:28:55 CET [2022/04/04 12:28:55 ET]
Table '3391322540 4' 6-max Seat #1 is the button
Seat 1: jamesHRoss (26241 in chips, €0.05 bounty)
Seat 2: jeannono24 (21877 in chips, €0.09 bounty)
Seat 5: jeje_sat (20464 in chips, €0.07 bounty)
Seat 6: RIZCHOU (19748 in chips, €0.05 bounty)
jamesHRoss: posts the ante 90
jeannono24: posts the ante 90
jeje_sat: posts the ante 90
RIZCHOU: posts the ante 90
jeannono24: posts small blind 350
jeje_sat: posts big blind 700
*** HOLE CARDS ***
Dealt to jeje_sat [9c Qc]
RIZCHOU: folds
jamesHRoss: raises 700 to 1400
jeannono24: folds
jeje_sat: raises 3510 to 4910
jamesHRoss: calls 3510
*** FLOP *** [Jh Th 7c]
jeje_sat: bets 15464 and is all-in
jamesHRoss: folds
Uncalled bet (15464) returned to jeje_sat
jeje_sat collected 10530 from pot
jeje_sat: doesn't show hand
*** SUMMARY ***
Total pot 10530 | Rake 0
Board [Jh Th 7c]
Seat 1: jamesHRoss (button) folded on the Flop
Seat 2: jeannono24 (small blind) folded before Flop
Seat 5: jeje_sat (big blind) collected (10530)
Seat 6: RIZCHOU folded before Flop (didn't bet)


PokerStars Home Game Hand #235262366313: {Club #4837790} Tournament #3391322540, €0.13+€0.05+€0.02 EUR Hold'em No Limit - Level XIII (400/800) - 2022/04/04 18:30:12 CET [2022/04/04 12:30:12 ET]
Table '3391322540 4' 6-max Seat #2 is the button
Seat 1: jamesHRoss (21241 in chips, €0.05 bounty)
Seat 2: jeannono24 (21437 in chips, €0.09 bounty)
Seat 5: jeje_sat (25994 in chips, €0.07 bounty)
Seat 6: RIZCHOU (19658 in chips, €0.05 bounty)
jamesHRoss: posts the ante 100
jeannono24: posts the ante 100
jeje_sat: posts the ante 100
RIZCHOU: posts the ante 100
jeje_sat: posts small blind 400
RIZCHOU: posts big blind 800
*** HOLE CARDS ***
Dealt to jeje_sat [6d 9h]
jamesHRoss: folds
jeannono24: folds
jeje_sat: folds
Uncalled bet (400) returned to RIZCHOU
RIZCHOU collected 1200 from pot
RIZCHOU: doesn't show hand
*** SUMMARY ***
Total pot 1200 | Rake 0
Seat 1: jamesHRoss folded before Flop (didn't bet)
Seat 2: jeannono24 (button) folded before Flop (didn't bet)
Seat 5: jeje_sat (small blind) folded before Flop
Seat 6: RIZCHOU (big blind) collected (1200)


PokerStars Home Game Hand #235262370179: {Club #4837790} Tournament #3391322540, €0.13+€0.05+€0.02 EUR Hold'em No Limit - Level XIII (400/800) - 2022/04/04 18:30:22 CET [2022/04/04 12:30:22 ET]
Table '3391322540 4' 6-max Seat #5 is the button
Seat 1: jamesHRoss (21141 in chips, €0.05 bounty)
Seat 2: jeannono24 (21337 in chips, €0.09 bounty)
Seat 5: jeje_sat (25494 in chips, €0.07 bounty)
Seat 6: RIZCHOU (20358 in chips, €0.05 bounty)
jamesHRoss: posts the ante 100
jeannono24: posts the ante 100
jeje_sat: posts the ante 100
RIZCHOU: posts the ante 100
RIZCHOU: posts small blind 400
jamesHRoss: posts big blind 800
*** HOLE CARDS ***
Dealt to jeje_sat [Ac Qh]
jeannono24: folds
jeje_sat: raises 1600 to 2400
RIZCHOU: folds
jamesHRoss: folds
Uncalled bet (1600) returned to jeje_sat
jeje_sat collected 2400 from pot
jeje_sat: doesn't show hand
*** SUMMARY ***
Total pot 2400 | Rake 0
Seat 1: jamesHRoss (big blind) folded before Flop
Seat 2: jeannono24 folded before Flop (didn't bet)
Seat 5: jeje_sat (button) collected (2400)
Seat 6: RIZCHOU (small blind) folded before Flop


PokerStars Home Game Hand #235262381133: {Club #4837790} Tournament #3391322540, €0.13+€0.05+€0.02 EUR Hold'em No Limit - Level XIII (400/800) - 2022/04/04 18:30:53 CET [2022/04/04 12:30:53 ET]
Table '3391322540 4' 6-max Seat #6 is the button
Seat 1: jamesHRoss (20241 in chips, €0.05 bounty)
Seat 2: jeannono24 (21237 in chips, €0.09 bounty)
Seat 5: jeje_sat (26994 in chips, €0.07 bounty)
Seat 6: RIZCHOU (19858 in chips, €0.05 bounty)
jamesHRoss: posts the ante 100
jeannono24: posts the ante 100
jeje_sat: posts the ante 100
RIZCHOU: posts the ante 100
jamesHRoss: posts small blind 400
jeannono24: posts big blind 800
*** HOLE CARDS ***
Dealt to jeje_sat [8c 3c]
jeje_sat: folds
RIZCHOU: raises 800 to 1600
jamesHRoss: folds
jeannono24: folds
Uncalled bet (800) returned to RIZCHOU
RIZCHOU collected 2400 from pot
RIZCHOU: doesn't show hand
*** SUMMARY ***
Total pot 2400 | Rake 0
Seat 1: jamesHRoss (small blind) folded before Flop
Seat 2: jeannono24 (big blind) folded before Flop
Seat 5: jeje_sat folded before Flop (didn't bet)
Seat 6: RIZCHOU (button) collected (2400)


PokerStars Home Game Hand #235262391950: {Club #4837790} Tournament #3391322540, €0.13+€0.05+€0.02 EUR Hold'em No Limit - Level XIII (400/800) - 2022/04/04 18:31:24 CET [2022/04/04 12:31:24 ET]
Table '3391322540 4' 6-max Seat #1 is the button
Seat 1: jamesHRoss (19741 in chips, €0.05 bounty)
Seat 2: jeannono24 (20337 in chips, €0.09 bounty)
Seat 5: jeje_sat (26894 in chips, €0.07 bounty)
Seat 6: RIZCHOU (21358 in chips, €0.05 bounty)
jamesHRoss: posts the ante 100
jeannono24: posts the ante 100
jeje_sat: posts the ante 100
RIZCHOU: posts the ante 100
jeannono24: posts small blind 400
jeje_sat: posts big blind 800
*** HOLE CARDS ***
Dealt to jeje_sat [Kc Jc]
RIZCHOU: folds
jamesHRoss: raises 800 to 1600
jeannono24: folds
jeje_sat: raises 4000 to 5600
jamesHRoss: raises 14041 to 19641 and is all-in
jeje_sat: calls 14041
*** FLOP *** [6h 5d Qh]
*** TURN *** [6h 5d Qh] [4h]
*** RIVER *** [6h 5d Qh 4h] [9s]
*** SHOW DOWN ***
jeje_sat: shows [Kc Jc] (high card King)
jamesHRoss: shows [7s 7h] (a pair of Sevens)
jamesHRoss collected 40082 from pot
*** SUMMARY ***
Total pot 40082 | Rake 0
Board [6h 5d Qh 4h 9s]
Seat 1: jamesHRoss (button) showed [7s 7h] and won (40082) with a pair of Sevens
Seat 2: jeannono24 (small blind) folded before Flop
Seat 5: jeje_sat (big blind) showed [Kc Jc] and lost with high card King
Seat 6: RIZCHOU folded before Flop (didn't bet)


PokerStars Home Game Hand #235262406313: {Club #4837790} Tournament #3391322540, €0.13+€0.05+€0.02 EUR Hold'em No Limit - Level XIII (400/800) - 2022/04/04 18:32:03 CET [2022/04/04 12:32:03 ET]
Table '3391322540 4' 6-max Seat #2 is the button
Seat 1: jamesHRoss (40082 in chips, €0.05 bounty)
Seat 2: jeannono24 (19837 in chips, €0.09 bounty)
Seat 5: jeje_sat (7153 in chips, €0.07 bounty)
Seat 6: RIZCHOU (21258 in chips, €0.05 bounty)
jamesHRoss: posts the ante 100
jeannono24: posts the ante 100
jeje_sat: posts the ante 100
RIZCHOU: posts the ante 100
jeje_sat: posts small blind 400
RIZCHOU: posts big blind 800
*** HOLE CARDS ***
Dealt to jeje_sat [9s 7c]
jamesHRoss: folds
jeannono24: folds
jeje_sat: raises 6253 to 7053 and is all-in
RIZCHOU: folds
Uncalled bet (6253) returned to jeje_sat
jeje_sat collected 2000 from pot
jeje_sat: doesn't show hand
*** SUMMARY ***
Total pot 2000 | Rake 0
Seat 1: jamesHRoss folded before Flop (didn't bet)
Seat 2: jeannono24 (button) folded before Flop (didn't bet)
Seat 5: jeje_sat (small blind) collected (2000)
Seat 6: RIZCHOU (big blind) folded before Flop


PokerStars Home Game Hand #235262417508: {Club #4837790} Tournament #3391322540, €0.13+€0.05+€0.02 EUR Hold'em No Limit - Level XIII (400/800) - 2022/04/04 18:32:35 CET [2022/04/04 12:32:35 ET]
Table '3391322540 4' 6-max Seat #5 is the button
Seat 1: jamesHRoss (39982 in chips, €0.05 bounty)
Seat 2: jeannono24 (19737 in chips, €0.09 bounty)
Seat 5: jeje_sat (8253 in chips, €0.07 bounty)
Seat 6: RIZCHOU (20358 in chips, €0.05 bounty)
jamesHRoss: posts the ante 100
jeannono24: posts the ante 100
jeje_sat: posts the ante 100
RIZCHOU: posts the ante 100
RIZCHOU: posts small blind 400
jamesHRoss: posts big blind 800
*** HOLE CARDS ***
Dealt to jeje_sat [8d Ac]
jeannono24: folds
jeje_sat: raises 7353 to 8153 and is all-in
RIZCHOU: raises 12105 to 20258 and is all-in
jamesHRoss: folds
Uncalled bet (12105) returned to RIZCHOU
*** FLOP *** [Td 6h 5c]
*** TURN *** [Td 6h 5c] [9d]
*** RIVER *** [Td 6h 5c 9d] [4d]
*** SHOW DOWN ***
RIZCHOU: shows [Ad Qd] (a flush, Ace high)
jeje_sat: shows [8d Ac] (high card Ace)
RIZCHOU collected 17506 from pot
RIZCHOU wins €0.04 for eliminating jeje_sat and their own bounty increases by €0.03 to €0.08
jeje_sat finished the tournament in 8th place
*** SUMMARY ***
Total pot 17506 | Rake 0
Board [Td 6h 5c 9d 4d]
Seat 1: jamesHRoss (big blind) folded before Flop
Seat 2: jeannono24 folded before Flop (didn't bet)
Seat 5: jeje_sat (button) showed [8d Ac] and lost with high card Ace
Seat 6: RIZCHOU (small blind) showed [Ad Qd] and won (17506) with a flush, Ace high


