PokerStars Home Game Hand #235419575340: {Club #4837790} Tournament #3394929594, €0.13+€0.05+€0.02 EUR Omaha Pot Limit - Level I (15/30) - 2022/04/11 17:30:01 CET [2022/04/11 11:30:01 ET]
Table '3394929594 1' 6-max Seat #1 is the button
Seat 1: jeje_sat (5000 in chips, €0.05 bounty)
Seat 5: RIZCHOU (5000 in chips, €0.05 bounty)
Seat 6: Mariusjacob84 (5000 in chips, €0.05 bounty)
RIZCHOU: posts small blind 15
Mariusjacob84: posts big blind 30
*** HOLE CARDS ***
Dealt to jeje_sat [4d 7d Js 8h]
jeje_sat has timed out
jeje_sat: folds
jeje_sat is sitting out
RIZCHOU: folds
Uncalled bet (15) returned to Mariusjacob84
Mariusjacob84 collected 30 from pot
Mariusjacob84: doesn't show hand
*** SUMMARY ***
Total pot 30 | Rake 0
Seat 1: jeje_sat (button) folded before Flop (didn't bet)
Seat 5: RIZCHOU (small blind) folded before Flop
Seat 6: Mariusjacob84 (big blind) collected (30)


PokerStars Home Game Hand #235419583402: {Club #4837790} Tournament #3394929594, €0.13+€0.05+€0.02 EUR Omaha Pot Limit - Level I (15/30) - 2022/04/11 17:30:27 CET [2022/04/11 11:30:27 ET]
Table '3394929594 1' 6-max Seat #5 is the button
Seat 1: jeje_sat (5000 in chips, €0.05 bounty) is sitting out
Seat 5: RIZCHOU (4985 in chips, €0.05 bounty)
Seat 6: Mariusjacob84 (5015 in chips, €0.05 bounty)
Mariusjacob84: posts small blind 15
jeje_sat: posts big blind 30
*** HOLE CARDS ***
Dealt to jeje_sat [7s 7d 9c 7c]
RIZCHOU: raises 60 to 90
Mariusjacob84: folds
jeje_sat: folds
Uncalled bet (60) returned to RIZCHOU
jeje_sat has returned
RIZCHOU collected 75 from pot
RIZCHOU: doesn't show hand
*** SUMMARY ***
Total pot 75 | Rake 0
Seat 1: jeje_sat (big blind) folded before Flop
Seat 5: RIZCHOU (button) collected (75)
Seat 6: Mariusjacob84 (small blind) folded before Flop


PokerStars Home Game Hand #235419586058: {Club #4837790} Tournament #3394929594, €0.13+€0.05+€0.02 EUR Omaha Pot Limit - Level I (15/30) - 2022/04/11 17:30:36 CET [2022/04/11 11:30:36 ET]
Table '3394929594 1' 6-max Seat #6 is the button
Seat 1: jeje_sat (4970 in chips, €0.05 bounty)
Seat 5: RIZCHOU (5030 in chips, €0.05 bounty)
Seat 6: Mariusjacob84 (5000 in chips, €0.05 bounty)
jeje_sat: posts small blind 15
RIZCHOU: posts big blind 30
*** HOLE CARDS ***
Dealt to jeje_sat [5d 9c 8c Th]
Mariusjacob84: calls 30
jeje_sat: folds
RIZCHOU: checks
*** FLOP *** [Ks Jh Jd]
RIZCHOU: checks
Mariusjacob84: bets 30
RIZCHOU: folds
Uncalled bet (30) returned to Mariusjacob84
Mariusjacob84 collected 75 from pot
Mariusjacob84: doesn't show hand
*** SUMMARY ***
Total pot 75 | Rake 0
Board [Ks Jh Jd]
Seat 1: jeje_sat (small blind) folded before Flop
Seat 5: RIZCHOU (big blind) folded on the Flop
Seat 6: Mariusjacob84 (button) collected (75)


PokerStars Home Game Hand #235419603847: {Club #4837790} Tournament #3394929594, €0.13+€0.05+€0.02 EUR Omaha Pot Limit - Level I (15/30) - 2022/04/11 17:31:16 CET [2022/04/11 11:31:16 ET]
Table '3394929594 1' 6-max Seat #1 is the button
Seat 1: jeje_sat (4955 in chips, €0.05 bounty)
Seat 5: RIZCHOU (5000 in chips, €0.05 bounty)
Seat 6: Mariusjacob84 (5045 in chips, €0.05 bounty)
RIZCHOU: posts small blind 15
Mariusjacob84: posts big blind 30
*** HOLE CARDS ***
Dealt to jeje_sat [7s 4d 8h Qh]
jeje_sat: folds
RIZCHOU: raises 60 to 90
Mariusjacob84: calls 60
*** FLOP *** [5h 4s Qd]
RIZCHOU: checks
Mariusjacob84: bets 60
RIZCHOU: folds
Uncalled bet (60) returned to Mariusjacob84
Mariusjacob84 collected 180 from pot
Mariusjacob84: doesn't show hand
*** SUMMARY ***
Total pot 180 | Rake 0
Board [5h 4s Qd]
Seat 1: jeje_sat (button) folded before Flop (didn't bet)
Seat 5: RIZCHOU (small blind) folded on the Flop
Seat 6: Mariusjacob84 (big blind) collected (180)


PokerStars Home Game Hand #235419617851: {Club #4837790} Tournament #3394929594, €0.13+€0.05+€0.02 EUR Omaha Pot Limit - Level I (15/30) - 2022/04/11 17:32:03 CET [2022/04/11 11:32:03 ET]
Table '3394929594 1' 6-max Seat #5 is the button
Seat 1: jeje_sat (4955 in chips, €0.05 bounty)
Seat 2: Eyvan972 (5000 in chips, €0.05 bounty)
Seat 5: RIZCHOU (4910 in chips, €0.05 bounty)
Seat 6: Mariusjacob84 (5135 in chips, €0.05 bounty)
Mariusjacob84: posts small blind 15
jeje_sat: posts big blind 30
*** HOLE CARDS ***
Dealt to jeje_sat [2d 6h 6d Ad]
Eyvan972: folds
RIZCHOU: raises 60 to 90
Mariusjacob84: folds
jeje_sat: calls 60
*** FLOP *** [Th 9h Jc]
jeje_sat: checks
RIZCHOU: bets 146
jeje_sat: folds
Uncalled bet (146) returned to RIZCHOU
RIZCHOU collected 195 from pot
RIZCHOU: doesn't show hand
*** SUMMARY ***
Total pot 195 | Rake 0
Board [Th 9h Jc]
Seat 1: jeje_sat (big blind) folded on the Flop
Seat 2: Eyvan972 folded before Flop (didn't bet)
Seat 5: RIZCHOU (button) collected (195)
Seat 6: Mariusjacob84 (small blind) folded before Flop


PokerStars Home Game Hand #235419625071: {Club #4837790} Tournament #3394929594, €0.13+€0.05+€0.02 EUR Omaha Pot Limit - Level I (15/30) - 2022/04/11 17:32:27 CET [2022/04/11 11:32:27 ET]
Table '3394929594 1' 6-max Seat #6 is the button
Seat 1: jeje_sat (4865 in chips, €0.05 bounty)
Seat 2: Eyvan972 (5000 in chips, €0.05 bounty)
Seat 5: RIZCHOU (5015 in chips, €0.05 bounty)
Seat 6: Mariusjacob84 (5120 in chips, €0.05 bounty)
jeje_sat: posts small blind 15
Eyvan972: posts big blind 30
*** HOLE CARDS ***
Dealt to jeje_sat [5h 8d Ac 2h]
RIZCHOU: raises 60 to 90
Mariusjacob84: folds
jeje_sat: folds
Eyvan972: folds
Uncalled bet (60) returned to RIZCHOU
RIZCHOU collected 75 from pot
RIZCHOU: doesn't show hand
*** SUMMARY ***
Total pot 75 | Rake 0
Seat 1: jeje_sat (small blind) folded before Flop
Seat 2: Eyvan972 (big blind) folded before Flop
Seat 5: RIZCHOU collected (75)
Seat 6: Mariusjacob84 (button) folded before Flop (didn't bet)


PokerStars Home Game Hand #235419631889: {Club #4837790} Tournament #3394929594, €0.13+€0.05+€0.02 EUR Omaha Pot Limit - Level I (15/30) - 2022/04/11 17:32:49 CET [2022/04/11 11:32:49 ET]
Table '3394929594 1' 6-max Seat #1 is the button
Seat 1: jeje_sat (4850 in chips, €0.05 bounty)
Seat 2: Eyvan972 (4970 in chips, €0.05 bounty)
Seat 5: RIZCHOU (5060 in chips, €0.05 bounty)
Seat 6: Mariusjacob84 (5120 in chips, €0.05 bounty)
Eyvan972: posts small blind 15
RIZCHOU: posts big blind 30
*** HOLE CARDS ***
Dealt to jeje_sat [8d 2c 9d Th]
Mariusjacob84: raises 30 to 60
jeje_sat: folds
Eyvan972: folds
RIZCHOU: folds
Uncalled bet (30) returned to Mariusjacob84
Mariusjacob84 collected 75 from pot
Mariusjacob84: doesn't show hand
*** SUMMARY ***
Total pot 75 | Rake 0
Seat 1: jeje_sat (button) folded before Flop (didn't bet)
Seat 2: Eyvan972 (small blind) folded before Flop
Seat 5: RIZCHOU (big blind) folded before Flop
Seat 6: Mariusjacob84 collected (75)


PokerStars Home Game Hand #235419639415: {Club #4837790} Tournament #3394929594, €0.13+€0.05+€0.02 EUR Omaha Pot Limit - Level I (15/30) - 2022/04/11 17:33:14 CET [2022/04/11 11:33:14 ET]
Table '3394929594 1' 6-max Seat #2 is the button
Seat 1: jeje_sat (4850 in chips, €0.05 bounty)
Seat 2: Eyvan972 (4955 in chips, €0.05 bounty)
Seat 3: Reyzous (5000 in chips) out of hand (moved from another table into small blind)
Seat 5: RIZCHOU (5030 in chips, €0.05 bounty)
Seat 6: Mariusjacob84 (5165 in chips, €0.05 bounty)
Reyzous will be allowed to play after the button
RIZCHOU: posts small blind 15
Mariusjacob84: posts big blind 30
*** HOLE CARDS ***
Dealt to jeje_sat [Jd 6d 4h Qd]
jeje_sat: folds
Eyvan972: folds
RIZCHOU: folds
Uncalled bet (15) returned to Mariusjacob84
Mariusjacob84 collected 30 from pot
Mariusjacob84: doesn't show hand
*** SUMMARY ***
Total pot 30 | Rake 0
Seat 1: jeje_sat folded before Flop (didn't bet)
Seat 2: Eyvan972 (button) folded before Flop (didn't bet)
Seat 5: RIZCHOU (small blind) folded before Flop
Seat 6: Mariusjacob84 (big blind) collected (30)


PokerStars Home Game Hand #235419642397: {Club #4837790} Tournament #3394929594, €0.13+€0.05+€0.02 EUR Omaha Pot Limit - Level I (15/30) - 2022/04/11 17:33:24 CET [2022/04/11 11:33:24 ET]
Table '3394929594 1' 6-max Seat #5 is the button
Seat 1: jeje_sat (4850 in chips, €0.05 bounty)
Seat 2: Eyvan972 (4955 in chips, €0.05 bounty)
Seat 3: Reyzous (5000 in chips, €0.05 bounty)
Seat 5: RIZCHOU (5015 in chips, €0.05 bounty)
Seat 6: Mariusjacob84 (5180 in chips, €0.05 bounty)
Mariusjacob84: posts small blind 15
jeje_sat: posts big blind 30
*** HOLE CARDS ***
Dealt to jeje_sat [Tc Ac 7h Ts]
Eyvan972: folds
Reyzous: folds
RIZCHOU: folds
Mariusjacob84: calls 15
jeje_sat: raises 60 to 90
Mariusjacob84: calls 60
*** FLOP *** [Kc 9c Kh]
Mariusjacob84: checks
jeje_sat: checks
*** TURN *** [Kc 9c Kh] [Js]
Mariusjacob84: checks
jeje_sat: bets 90
Mariusjacob84: folds
Uncalled bet (90) returned to jeje_sat
jeje_sat collected 180 from pot
jeje_sat: doesn't show hand
*** SUMMARY ***
Total pot 180 | Rake 0
Board [Kc 9c Kh Js]
Seat 1: jeje_sat (big blind) collected (180)
Seat 2: Eyvan972 folded before Flop (didn't bet)
Seat 3: Reyzous folded before Flop (didn't bet)
Seat 5: RIZCHOU (button) folded before Flop (didn't bet)
Seat 6: Mariusjacob84 (small blind) folded on the Turn


PokerStars Home Game Hand #235419651878: {Club #4837790} Tournament #3394929594, €0.13+€0.05+€0.02 EUR Omaha Pot Limit - Level I (15/30) - 2022/04/11 17:33:55 CET [2022/04/11 11:33:55 ET]
Table '3394929594 1' 6-max Seat #6 is the button
Seat 1: jeje_sat (4940 in chips, €0.05 bounty)
Seat 2: Eyvan972 (4955 in chips, €0.05 bounty)
Seat 3: Reyzous (5000 in chips, €0.05 bounty)
Seat 5: RIZCHOU (5015 in chips, €0.05 bounty)
Seat 6: Mariusjacob84 (5090 in chips, €0.05 bounty)
jeje_sat: posts small blind 15
Eyvan972: posts big blind 30
*** HOLE CARDS ***
Dealt to jeje_sat [Kd 2c 4d Ac]
Reyzous: folds
RIZCHOU: raises 60 to 90
Mariusjacob84: calls 90
jeje_sat: raises 300 to 390
Eyvan972: folds
RIZCHOU: folds
Mariusjacob84: folds
Uncalled bet (300) returned to jeje_sat
jeje_sat collected 300 from pot
jeje_sat: doesn't show hand
*** SUMMARY ***
Total pot 300 | Rake 0
Seat 1: jeje_sat (small blind) collected (300)
Seat 2: Eyvan972 (big blind) folded before Flop
Seat 3: Reyzous folded before Flop (didn't bet)
Seat 5: RIZCHOU folded before Flop
Seat 6: Mariusjacob84 (button) folded before Flop


PokerStars Home Game Hand #235419663085: {Club #4837790} Tournament #3394929594, €0.13+€0.05+€0.02 EUR Omaha Pot Limit - Level I (15/30) - 2022/04/11 17:34:16 CET [2022/04/11 11:34:16 ET]
Table '3394929594 1' 6-max Seat #1 is the button
Seat 1: jeje_sat (5150 in chips, €0.05 bounty)
Seat 2: Eyvan972 (4925 in chips, €0.05 bounty)
Seat 3: Reyzous (5000 in chips, €0.05 bounty)
Seat 5: RIZCHOU (4925 in chips, €0.05 bounty)
Seat 6: Mariusjacob84 (5000 in chips, €0.05 bounty)
Eyvan972: posts small blind 15
Reyzous: posts big blind 30
*** HOLE CARDS ***
Dealt to jeje_sat [As 6c 8h Ks]
RIZCHOU: folds
Mariusjacob84: raises 30 to 60
jeje_sat: calls 60
Eyvan972: raises 210 to 270
Reyzous: folds
Mariusjacob84: calls 210
jeje_sat: calls 210
*** FLOP *** [2h Kd 2d]
Eyvan972: checks
Mariusjacob84: checks
jeje_sat: checks
*** TURN *** [2h Kd 2d] [8s]
Eyvan972: checks
Mariusjacob84: checks
jeje_sat: bets 420
Eyvan972: folds
Mariusjacob84: folds
Uncalled bet (420) returned to jeje_sat
jeje_sat collected 840 from pot
jeje_sat: doesn't show hand
*** SUMMARY ***
Total pot 840 | Rake 0
Board [2h Kd 2d 8s]
Seat 1: jeje_sat (button) collected (840)
Seat 2: Eyvan972 (small blind) folded on the Turn
Seat 3: Reyzous (big blind) folded before Flop
Seat 5: RIZCHOU folded before Flop (didn't bet)
Seat 6: Mariusjacob84 folded on the Turn


PokerStars Home Game Hand #235419681653: {Club #4837790} Tournament #3394929594, €0.13+€0.05+€0.02 EUR Omaha Pot Limit - Level II (25/50) - 2022/04/11 17:35:17 CET [2022/04/11 11:35:17 ET]
Table '3394929594 1' 6-max Seat #2 is the button
Seat 1: jeje_sat (5720 in chips, €0.05 bounty)
Seat 2: Eyvan972 (4655 in chips, €0.05 bounty)
Seat 3: Reyzous (4970 in chips, €0.05 bounty)
Seat 5: RIZCHOU (4925 in chips, €0.05 bounty)
Seat 6: Mariusjacob84 (4730 in chips, €0.05 bounty)
Reyzous: posts small blind 25
RIZCHOU: posts big blind 50
*** HOLE CARDS ***
Dealt to jeje_sat [Ad 3c 9c 6d]
Mariusjacob84: calls 50
jeje_sat: folds
Eyvan972: raises 175 to 225
Reyzous: folds
RIZCHOU: folds
Mariusjacob84: folds
Uncalled bet (175) returned to Eyvan972
Eyvan972 collected 175 from pot
Eyvan972: doesn't show hand
*** SUMMARY ***
Total pot 175 | Rake 0
Seat 1: jeje_sat folded before Flop (didn't bet)
Seat 2: Eyvan972 (button) collected (175)
Seat 3: Reyzous (small blind) folded before Flop
Seat 5: RIZCHOU (big blind) folded before Flop
Seat 6: Mariusjacob84 folded before Flop


PokerStars Home Game Hand #235419689887: {Club #4837790} Tournament #3394929594, €0.13+€0.05+€0.02 EUR Omaha Pot Limit - Level II (25/50) - 2022/04/11 17:35:44 CET [2022/04/11 11:35:44 ET]
Table '3394929594 1' 6-max Seat #3 is the button
Seat 1: jeje_sat (5720 in chips, €0.05 bounty)
Seat 2: Eyvan972 (4780 in chips, €0.05 bounty)
Seat 3: Reyzous (4945 in chips, €0.05 bounty)
Seat 5: RIZCHOU (4875 in chips, €0.05 bounty)
Seat 6: Mariusjacob84 (4680 in chips, €0.05 bounty)
RIZCHOU: posts small blind 25
Mariusjacob84: posts big blind 50
*** HOLE CARDS ***
Dealt to jeje_sat [9s Ah 6c 5h]
jeje_sat: folds
Eyvan972: folds
Reyzous: raises 60 to 110
RIZCHOU: folds
Mariusjacob84: folds
Uncalled bet (60) returned to Reyzous
Reyzous collected 125 from pot
Reyzous: doesn't show hand
*** SUMMARY ***
Total pot 125 | Rake 0
Seat 1: jeje_sat folded before Flop (didn't bet)
Seat 2: Eyvan972 folded before Flop (didn't bet)
Seat 3: Reyzous (button) collected (125)
Seat 5: RIZCHOU (small blind) folded before Flop
Seat 6: Mariusjacob84 (big blind) folded before Flop


PokerStars Home Game Hand #235419697301: {Club #4837790} Tournament #3394929594, €0.13+€0.05+€0.02 EUR Omaha Pot Limit - Level II (25/50) - 2022/04/11 17:36:09 CET [2022/04/11 11:36:09 ET]
Table '3394929594 1' 6-max Seat #5 is the button
Seat 1: jeje_sat (5720 in chips, €0.05 bounty)
Seat 2: Eyvan972 (4780 in chips, €0.05 bounty)
Seat 3: Reyzous (5020 in chips, €0.05 bounty)
Seat 5: RIZCHOU (4850 in chips, €0.05 bounty)
Seat 6: Mariusjacob84 (4630 in chips, €0.05 bounty)
Mariusjacob84: posts small blind 25
jeje_sat: posts big blind 50
*** HOLE CARDS ***
Dealt to jeje_sat [3h 5s Qc Ks]
Eyvan972: raises 100 to 150
Reyzous: folds
RIZCHOU: folds
Mariusjacob84: folds
jeje_sat: folds
Uncalled bet (100) returned to Eyvan972
Eyvan972 collected 125 from pot
Eyvan972: doesn't show hand
*** SUMMARY ***
Total pot 125 | Rake 0
Seat 1: jeje_sat (big blind) folded before Flop
Seat 2: Eyvan972 collected (125)
Seat 3: Reyzous folded before Flop (didn't bet)
Seat 5: RIZCHOU (button) folded before Flop (didn't bet)
Seat 6: Mariusjacob84 (small blind) folded before Flop


PokerStars Home Game Hand #235419701161: {Club #4837790} Tournament #3394929594, €0.13+€0.05+€0.02 EUR Omaha Pot Limit - Level II (25/50) - 2022/04/11 17:36:21 CET [2022/04/11 11:36:21 ET]
Table '3394929594 1' 6-max Seat #6 is the button
Seat 1: jeje_sat (5670 in chips, €0.05 bounty)
Seat 2: Eyvan972 (4855 in chips, €0.05 bounty)
Seat 3: Reyzous (5020 in chips, €0.05 bounty)
Seat 5: RIZCHOU (4850 in chips, €0.05 bounty)
Seat 6: Mariusjacob84 (4605 in chips, €0.05 bounty)
jeje_sat: posts small blind 25
Eyvan972: posts big blind 50
*** HOLE CARDS ***
Dealt to jeje_sat [4s 2h 3s 9s]
Reyzous: folds
RIZCHOU: folds
Mariusjacob84: raises 100 to 150
jeje_sat: folds
Eyvan972: folds
Uncalled bet (100) returned to Mariusjacob84
Mariusjacob84 collected 125 from pot
Mariusjacob84: doesn't show hand
*** SUMMARY ***
Total pot 125 | Rake 0
Seat 1: jeje_sat (small blind) folded before Flop
Seat 2: Eyvan972 (big blind) folded before Flop
Seat 3: Reyzous folded before Flop (didn't bet)
Seat 5: RIZCHOU folded before Flop (didn't bet)
Seat 6: Mariusjacob84 (button) collected (125)


PokerStars Home Game Hand #235419706441: {Club #4837790} Tournament #3394929594, €0.13+€0.05+€0.02 EUR Omaha Pot Limit - Level II (25/50) - 2022/04/11 17:36:39 CET [2022/04/11 11:36:39 ET]
Table '3394929594 1' 6-max Seat #1 is the button
Seat 1: jeje_sat (5645 in chips, €0.05 bounty)
Seat 2: Eyvan972 (4805 in chips, €0.05 bounty)
Seat 3: Reyzous (5020 in chips, €0.05 bounty)
Seat 5: RIZCHOU (4850 in chips, €0.05 bounty)
Seat 6: Mariusjacob84 (4680 in chips, €0.05 bounty)
Eyvan972: posts small blind 25
Reyzous: posts big blind 50
*** HOLE CARDS ***
Dealt to jeje_sat [As 7s 4h 6s]
RIZCHOU: folds
Mariusjacob84: raises 100 to 150
jeje_sat: calls 150
Eyvan972: calls 125
Reyzous: calls 100
*** FLOP *** [4d 2h 9s]
Eyvan972: checks
Reyzous: checks
Mariusjacob84: checks
jeje_sat: checks
*** TURN *** [4d 2h 9s] [Qc]
Eyvan972: checks
Reyzous: checks
Mariusjacob84: checks
jeje_sat: checks
*** RIVER *** [4d 2h 9s Qc] [9d]
Eyvan972: checks
Reyzous: bets 162
Mariusjacob84: folds
jeje_sat: folds
Eyvan972: folds
Uncalled bet (162) returned to Reyzous
Reyzous collected 600 from pot
Reyzous: doesn't show hand
*** SUMMARY ***
Total pot 600 | Rake 0
Board [4d 2h 9s Qc 9d]
Seat 1: jeje_sat (button) folded on the River
Seat 2: Eyvan972 (small blind) folded on the River
Seat 3: Reyzous (big blind) collected (600)
Seat 5: RIZCHOU folded before Flop (didn't bet)
Seat 6: Mariusjacob84 folded on the River


PokerStars Home Game Hand #235419723724: {Club #4837790} Tournament #3394929594, €0.13+€0.05+€0.02 EUR Omaha Pot Limit - Level II (25/50) - 2022/04/11 17:37:36 CET [2022/04/11 11:37:36 ET]
Table '3394929594 1' 6-max Seat #2 is the button
Seat 1: jeje_sat (5495 in chips, €0.05 bounty)
Seat 2: Eyvan972 (4655 in chips, €0.05 bounty)
Seat 3: Reyzous (5470 in chips, €0.05 bounty)
Seat 5: RIZCHOU (4850 in chips, €0.05 bounty)
Reyzous: posts small blind 25
RIZCHOU: posts big blind 50
*** HOLE CARDS ***
Dealt to jeje_sat [8s 8h 2c 6d]
jeje_sat: folds
Eyvan972: raises 50 to 100
Reyzous: calls 75
RIZCHOU: calls 50
*** FLOP *** [7c Kh 9c]
Reyzous: checks
RIZCHOU: checks
Eyvan972: bets 100
Reyzous: folds
RIZCHOU: folds
Uncalled bet (100) returned to Eyvan972
Eyvan972 collected 300 from pot
Eyvan972: doesn't show hand
*** SUMMARY ***
Total pot 300 | Rake 0
Board [7c Kh 9c]
Seat 1: jeje_sat folded before Flop (didn't bet)
Seat 2: Eyvan972 (button) collected (300)
Seat 3: Reyzous (small blind) folded on the Flop
Seat 5: RIZCHOU (big blind) folded on the Flop


PokerStars Home Game Hand #235419738344: {Club #4837790} Tournament #3394929594, €0.13+€0.05+€0.02 EUR Omaha Pot Limit - Level II (25/50) - 2022/04/11 17:38:25 CET [2022/04/11 11:38:25 ET]
Table '3394929594 1' 6-max Seat #3 is the button
Seat 1: jeje_sat (5495 in chips, €0.05 bounty)
Seat 2: Eyvan972 (4855 in chips, €0.05 bounty)
Seat 3: Reyzous (5370 in chips, €0.05 bounty)
Seat 5: RIZCHOU (4750 in chips, €0.05 bounty)
RIZCHOU: posts small blind 25
jeje_sat: posts big blind 50
*** HOLE CARDS ***
Dealt to jeje_sat [2s Kh Ac 4c]
Eyvan972: folds
Reyzous: folds
RIZCHOU: raises 100 to 150
jeje_sat: calls 100
*** FLOP *** [Qc 6h Qs]
RIZCHOU: checks
jeje_sat: checks
*** TURN *** [Qc 6h Qs] [5c]
RIZCHOU: checks
jeje_sat: checks
*** RIVER *** [Qc 6h Qs 5c] [5d]
RIZCHOU: bets 150
jeje_sat: folds
Uncalled bet (150) returned to RIZCHOU
RIZCHOU collected 300 from pot
RIZCHOU: doesn't show hand
*** SUMMARY ***
Total pot 300 | Rake 0
Board [Qc 6h Qs 5c 5d]
Seat 1: jeje_sat (big blind) folded on the River
Seat 2: Eyvan972 folded before Flop (didn't bet)
Seat 3: Reyzous (button) folded before Flop (didn't bet)
Seat 5: RIZCHOU (small blind) collected (300)


PokerStars Home Game Hand #235419748760: {Club #4837790} Tournament #3394929594, €0.13+€0.05+€0.02 EUR Omaha Pot Limit - Level II (25/50) - 2022/04/11 17:38:59 CET [2022/04/11 11:38:59 ET]
Table '3394929594 1' 6-max Seat #5 is the button
Seat 1: jeje_sat (5345 in chips, €0.05 bounty)
Seat 2: Eyvan972 (4855 in chips, €0.05 bounty)
Seat 3: Reyzous (5370 in chips, €0.05 bounty)
Seat 5: RIZCHOU (4900 in chips, €0.05 bounty)
jeje_sat: posts small blind 25
Eyvan972: posts big blind 50
*** HOLE CARDS ***
Dealt to jeje_sat [8h Js 6h 9s]
Reyzous: raises 60 to 110
RIZCHOU: folds
jeje_sat: calls 85
Eyvan972: folds
*** FLOP *** [8d 6s 8c]
jeje_sat: checks
Reyzous: bets 73
jeje_sat: calls 73
*** TURN *** [8d 6s 8c] [6d]
jeje_sat: checks
Reyzous: bets 270
jeje_sat: calls 270
*** RIVER *** [8d 6s 8c 6d] [As]
jeje_sat: bets 956
Reyzous: folds
Uncalled bet (956) returned to jeje_sat
jeje_sat collected 956 from pot
jeje_sat: doesn't show hand
*** SUMMARY ***
Total pot 956 | Rake 0
Board [8d 6s 8c 6d As]
Seat 1: jeje_sat (small blind) collected (956)
Seat 2: Eyvan972 (big blind) folded before Flop
Seat 3: Reyzous folded on the River
Seat 5: RIZCHOU (button) folded before Flop (didn't bet)


PokerStars Home Game Hand #235419760399: {Club #4837790} Tournament #3394929594, €0.13+€0.05+€0.02 EUR Omaha Pot Limit - Level II (25/50) - 2022/04/11 17:39:38 CET [2022/04/11 11:39:38 ET]
Table '3394929594 1' 6-max Seat #1 is the button
Seat 1: jeje_sat (5848 in chips, €0.05 bounty)
Seat 2: Eyvan972 (4805 in chips, €0.05 bounty)
Seat 3: Reyzous (4917 in chips, €0.05 bounty)
Seat 5: RIZCHOU (4900 in chips, €0.05 bounty)
Eyvan972: posts small blind 25
Reyzous: posts big blind 50
*** HOLE CARDS ***
Dealt to jeje_sat [6c 5s Kc Jd]
RIZCHOU: folds
jeje_sat: folds
Eyvan972: folds
Uncalled bet (25) returned to Reyzous
Reyzous collected 50 from pot
Reyzous: doesn't show hand
*** SUMMARY ***
Total pot 50 | Rake 0
Seat 1: jeje_sat (button) folded before Flop (didn't bet)
Seat 2: Eyvan972 (small blind) folded before Flop
Seat 3: Reyzous (big blind) collected (50)
Seat 5: RIZCHOU folded before Flop (didn't bet)


PokerStars Home Game Hand #235419763954: {Club #4837790} Tournament #3394929594, €0.13+€0.05+€0.02 EUR Omaha Pot Limit - Level II (25/50) - 2022/04/11 17:39:50 CET [2022/04/11 11:39:50 ET]
Table '3394929594 1' 6-max Seat #2 is the button
Seat 1: jeje_sat (5848 in chips, €0.05 bounty)
Seat 2: Eyvan972 (4780 in chips, €0.05 bounty)
Seat 3: Reyzous (4942 in chips, €0.05 bounty)
Seat 5: RIZCHOU (4900 in chips, €0.05 bounty)
Reyzous: posts small blind 25
RIZCHOU: posts big blind 50
*** HOLE CARDS ***
Dealt to jeje_sat [9c Qd 9d 7s]
jeje_sat: folds
Eyvan972: folds
Reyzous: calls 25
RIZCHOU: checks
*** FLOP *** [As Ac 8h]
Reyzous: checks
RIZCHOU: checks
*** TURN *** [As Ac 8h] [4c]
Reyzous: checks
RIZCHOU: checks
*** RIVER *** [As Ac 8h 4c] [8d]
Reyzous: checks
RIZCHOU: checks
*** SHOW DOWN ***
Reyzous: shows [9s 7h 3h Ts] (a pair of Aces)
RIZCHOU: shows [Qc Qh 3d Js] (two pair, Aces and Queens)
RIZCHOU collected 100 from pot
*** SUMMARY ***
Total pot 100 | Rake 0
Board [As Ac 8h 4c 8d]
Seat 1: jeje_sat folded before Flop (didn't bet)
Seat 2: Eyvan972 (button) folded before Flop (didn't bet)
Seat 3: Reyzous (small blind) showed [9s 7h 3h Ts] and lost with a pair of Aces
Seat 5: RIZCHOU (big blind) showed [Qc Qh 3d Js] and won (100) with two pair, Aces and Queens


PokerStars Home Game Hand #235419774444: {Club #4837790} Tournament #3394929594, €0.13+€0.05+€0.02 EUR Omaha Pot Limit - Level III (35/70) - 2022/04/11 17:40:25 CET [2022/04/11 11:40:25 ET]
Table '3394929594 1' 6-max Seat #3 is the button
Seat 1: jeje_sat (5848 in chips, €0.05 bounty)
Seat 2: Eyvan972 (4780 in chips, €0.05 bounty)
Seat 3: Reyzous (4892 in chips, €0.05 bounty)
Seat 5: RIZCHOU (4950 in chips, €0.05 bounty)
RIZCHOU: posts small blind 35
jeje_sat: posts big blind 70
*** HOLE CARDS ***
Dealt to jeje_sat [Qc 6d Kh Qd]
Eyvan972: folds
Reyzous: raises 84 to 154
RIZCHOU: folds
jeje_sat: calls 84
*** FLOP *** [9d 3h 2s]
jeje_sat: checks
Reyzous: bets 154
jeje_sat: calls 154
*** TURN *** [9d 3h 2s] [Kd]
jeje_sat: checks
Reyzous: checks
*** RIVER *** [9d 3h 2s Kd] [Ah]
jeje_sat: checks
Reyzous: bets 423
jeje_sat: folds
Uncalled bet (423) returned to Reyzous
Reyzous collected 651 from pot
Reyzous: doesn't show hand
*** SUMMARY ***
Total pot 651 | Rake 0
Board [9d 3h 2s Kd Ah]
Seat 1: jeje_sat (big blind) folded on the River
Seat 2: Eyvan972 folded before Flop (didn't bet)
Seat 3: Reyzous (button) collected (651)
Seat 5: RIZCHOU (small blind) folded before Flop


PokerStars Home Game Hand #235419786054: {Club #4837790} Tournament #3394929594, €0.13+€0.05+€0.02 EUR Omaha Pot Limit - Level III (35/70) - 2022/04/11 17:41:04 CET [2022/04/11 11:41:04 ET]
Table '3394929594 1' 6-max Seat #5 is the button
Seat 1: jeje_sat (5540 in chips, €0.05 bounty)
Seat 2: Eyvan972 (4780 in chips, €0.05 bounty)
Seat 3: Reyzous (5235 in chips, €0.05 bounty)
Seat 5: RIZCHOU (4915 in chips, €0.05 bounty)
jeje_sat: posts small blind 35
Eyvan972: posts big blind 70
*** HOLE CARDS ***
Dealt to jeje_sat [9d 6h Kh 3h]
Reyzous: folds
RIZCHOU: folds
jeje_sat: folds
Uncalled bet (35) returned to Eyvan972
Eyvan972 collected 70 from pot
Eyvan972: doesn't show hand
*** SUMMARY ***
Total pot 70 | Rake 0
Seat 1: jeje_sat (small blind) folded before Flop
Seat 2: Eyvan972 (big blind) collected (70)
Seat 3: Reyzous folded before Flop (didn't bet)
Seat 5: RIZCHOU (button) folded before Flop (didn't bet)


PokerStars Home Game Hand #235419792715: {Club #4837790} Tournament #3394929594, €0.13+€0.05+€0.02 EUR Omaha Pot Limit - Level III (35/70) - 2022/04/11 17:41:26 CET [2022/04/11 11:41:26 ET]
Table '3394929594 1' 6-max Seat #1 is the button
Seat 1: jeje_sat (5505 in chips, €0.05 bounty)
Seat 2: Eyvan972 (4815 in chips, €0.05 bounty)
Seat 3: Reyzous (5235 in chips, €0.05 bounty)
Seat 5: RIZCHOU (4915 in chips, €0.05 bounty)
Eyvan972: posts small blind 35
Reyzous: posts big blind 70
*** HOLE CARDS ***
Dealt to jeje_sat [Kh 6d 7c 3h]
RIZCHOU: folds
jeje_sat: folds
Eyvan972: calls 35
Reyzous: checks
*** FLOP *** [4d Jd 7d]
Eyvan972: checks
Reyzous: bets 91
Eyvan972: folds
Uncalled bet (91) returned to Reyzous
Reyzous collected 140 from pot
Reyzous: doesn't show hand
*** SUMMARY ***
Total pot 140 | Rake 0
Board [4d Jd 7d]
Seat 1: jeje_sat (button) folded before Flop (didn't bet)
Seat 2: Eyvan972 (small blind) folded on the Flop
Seat 3: Reyzous (big blind) collected (140)
Seat 5: RIZCHOU folded before Flop (didn't bet)


PokerStars Home Game Hand #235419800052: {Club #4837790} Tournament #3394929594, €0.13+€0.05+€0.02 EUR Omaha Pot Limit - Level III (35/70) - 2022/04/11 17:41:51 CET [2022/04/11 11:41:51 ET]
Table '3394929594 1' 6-max Seat #2 is the button
Seat 1: jeje_sat (5505 in chips, €0.05 bounty)
Seat 2: Eyvan972 (4745 in chips, €0.05 bounty)
Seat 3: Reyzous (5305 in chips, €0.05 bounty)
Seat 5: RIZCHOU (4915 in chips, €0.05 bounty)
Reyzous: posts small blind 35
RIZCHOU: posts big blind 70
*** HOLE CARDS ***
Dealt to jeje_sat [3s Ah 4h 7d]
jeje_sat: raises 175 to 245
Eyvan972: folds
Reyzous: folds
RIZCHOU: folds
Uncalled bet (175) returned to jeje_sat
jeje_sat collected 175 from pot
jeje_sat: doesn't show hand
*** SUMMARY ***
Total pot 175 | Rake 0
Seat 1: jeje_sat collected (175)
Seat 2: Eyvan972 (button) folded before Flop (didn't bet)
Seat 3: Reyzous (small blind) folded before Flop
Seat 5: RIZCHOU (big blind) folded before Flop


PokerStars Home Game Hand #235419803654: {Club #4837790} Tournament #3394929594, €0.13+€0.05+€0.02 EUR Omaha Pot Limit - Level III (35/70) - 2022/04/11 17:42:03 CET [2022/04/11 11:42:03 ET]
Table '3394929594 1' 6-max Seat #3 is the button
Seat 1: jeje_sat (5610 in chips, €0.05 bounty)
Seat 2: Eyvan972 (4745 in chips, €0.05 bounty)
Seat 3: Reyzous (5270 in chips, €0.05 bounty)
Seat 5: RIZCHOU (4845 in chips, €0.05 bounty)
RIZCHOU: posts small blind 35
jeje_sat: posts big blind 70
*** HOLE CARDS ***
Dealt to jeje_sat [9d Ah Qd 8d]
Eyvan972: folds
Reyzous: folds
RIZCHOU: calls 35
jeje_sat: checks
*** FLOP *** [6d 7h 5d]
RIZCHOU: checks
jeje_sat: bets 70
RIZCHOU: folds
Uncalled bet (70) returned to jeje_sat
jeje_sat collected 140 from pot
jeje_sat: doesn't show hand
*** SUMMARY ***
Total pot 140 | Rake 0
Board [6d 7h 5d]
Seat 1: jeje_sat (big blind) collected (140)
Seat 2: Eyvan972 folded before Flop (didn't bet)
Seat 3: Reyzous (button) folded before Flop (didn't bet)
Seat 5: RIZCHOU (small blind) folded on the Flop


PokerStars Home Game Hand #235419809997: {Club #4837790} Tournament #3394929594, €0.13+€0.05+€0.02 EUR Omaha Pot Limit - Level III (35/70) - 2022/04/11 17:42:23 CET [2022/04/11 11:42:23 ET]
Table '3394929594 1' 6-max Seat #5 is the button
Seat 1: jeje_sat (5680 in chips, €0.05 bounty)
Seat 2: Eyvan972 (4745 in chips, €0.05 bounty)
Seat 3: Reyzous (5270 in chips, €0.05 bounty)
Seat 5: RIZCHOU (4775 in chips, €0.05 bounty)
jeje_sat: posts small blind 35
Eyvan972: posts big blind 70
*** HOLE CARDS ***
Dealt to jeje_sat [6c 9c 7d Jc]
Reyzous: folds
RIZCHOU: raises 140 to 210
jeje_sat: calls 175
Eyvan972: calls 140
*** FLOP *** [6s Kc Kd]
jeje_sat: checks
Eyvan972: checks
RIZCHOU: bets 158
jeje_sat: folds
Eyvan972: folds
Uncalled bet (158) returned to RIZCHOU
RIZCHOU collected 630 from pot
RIZCHOU: doesn't show hand
*** SUMMARY ***
Total pot 630 | Rake 0
Board [6s Kc Kd]
Seat 1: jeje_sat (small blind) folded on the Flop
Seat 2: Eyvan972 (big blind) folded on the Flop
Seat 3: Reyzous folded before Flop (didn't bet)
Seat 5: RIZCHOU (button) collected (630)


PokerStars Home Game Hand #235419824087: {Club #4837790} Tournament #3394929594, €0.13+€0.05+€0.02 EUR Omaha Pot Limit - Level III (35/70) - 2022/04/11 17:43:10 CET [2022/04/11 11:43:10 ET]
Table '3394929594 1' 6-max Seat #1 is the button
Seat 1: jeje_sat (5470 in chips, €0.05 bounty)
Seat 2: Eyvan972 (4535 in chips, €0.05 bounty)
Seat 3: Reyzous (5270 in chips, €0.05 bounty)
Seat 5: RIZCHOU (5195 in chips, €0.05 bounty)
Eyvan972: posts small blind 35
Reyzous: posts big blind 70
*** HOLE CARDS ***
Dealt to jeje_sat [6c Kd 3c 2h]
RIZCHOU: folds
jeje_sat: folds
Eyvan972: raises 140 to 210
Reyzous: folds
Uncalled bet (140) returned to Eyvan972
Eyvan972 collected 140 from pot
Eyvan972: doesn't show hand
*** SUMMARY ***
Total pot 140 | Rake 0
Seat 1: jeje_sat (button) folded before Flop (didn't bet)
Seat 2: Eyvan972 (small blind) collected (140)
Seat 3: Reyzous (big blind) folded before Flop
Seat 5: RIZCHOU folded before Flop (didn't bet)


PokerStars Home Game Hand #235419829455: {Club #4837790} Tournament #3394929594, €0.13+€0.05+€0.02 EUR Omaha Pot Limit - Level III (35/70) - 2022/04/11 17:43:28 CET [2022/04/11 11:43:28 ET]
Table '3394929594 1' 6-max Seat #2 is the button
Seat 1: jeje_sat (5470 in chips, €0.05 bounty)
Seat 2: Eyvan972 (4605 in chips, €0.05 bounty)
Seat 3: Reyzous (5200 in chips, €0.05 bounty)
Seat 5: RIZCHOU (5195 in chips, €0.05 bounty)
Reyzous: posts small blind 35
RIZCHOU: posts big blind 70
*** HOLE CARDS ***
Dealt to jeje_sat [2h 6d Ad 8d]
jeje_sat: raises 175 to 245
Eyvan972: folds
Reyzous: folds
RIZCHOU: folds
Uncalled bet (175) returned to jeje_sat
jeje_sat collected 175 from pot
jeje_sat: doesn't show hand
*** SUMMARY ***
Total pot 175 | Rake 0
Seat 1: jeje_sat collected (175)
Seat 2: Eyvan972 (button) folded before Flop (didn't bet)
Seat 3: Reyzous (small blind) folded before Flop
Seat 5: RIZCHOU (big blind) folded before Flop


PokerStars Home Game Hand #235419833810: {Club #4837790} Tournament #3394929594, €0.13+€0.05+€0.02 EUR Omaha Pot Limit - Level III (35/70) - 2022/04/11 17:43:42 CET [2022/04/11 11:43:42 ET]
Table '3394929594 1' 6-max Seat #3 is the button
Seat 1: jeje_sat (5575 in chips, €0.05 bounty)
Seat 2: Eyvan972 (4605 in chips, €0.05 bounty)
Seat 3: Reyzous (5165 in chips, €0.05 bounty)
Seat 5: RIZCHOU (5125 in chips, €0.05 bounty)
RIZCHOU: posts small blind 35
jeje_sat: posts big blind 70
*** HOLE CARDS ***
Dealt to jeje_sat [Th Qh 6c Qc]
Eyvan972: folds
Reyzous: folds
RIZCHOU: folds
Uncalled bet (35) returned to jeje_sat
jeje_sat collected 70 from pot
jeje_sat: doesn't show hand
*** SUMMARY ***
Total pot 70 | Rake 0
Seat 1: jeje_sat (big blind) collected (70)
Seat 2: Eyvan972 folded before Flop (didn't bet)
Seat 3: Reyzous (button) folded before Flop (didn't bet)
Seat 5: RIZCHOU (small blind) folded before Flop


PokerStars Home Game Hand #235419838732: {Club #4837790} Tournament #3394929594, €0.13+€0.05+€0.02 EUR Omaha Pot Limit - Level III (35/70) - 2022/04/11 17:43:59 CET [2022/04/11 11:43:59 ET]
Table '3394929594 1' 6-max Seat #5 is the button
Seat 1: jeje_sat (5610 in chips, €0.05 bounty)
Seat 2: Eyvan972 (4605 in chips, €0.05 bounty)
Seat 3: Reyzous (5165 in chips, €0.05 bounty)
Seat 5: RIZCHOU (5090 in chips, €0.05 bounty)
jeje_sat: posts small blind 35
Eyvan972: posts big blind 70
*** HOLE CARDS ***
Dealt to jeje_sat [6s 4h Kd 7c]
Reyzous: folds
RIZCHOU: folds
jeje_sat: folds
Uncalled bet (35) returned to Eyvan972
Eyvan972 collected 70 from pot
Eyvan972: doesn't show hand
*** SUMMARY ***
Total pot 70 | Rake 0
Seat 1: jeje_sat (small blind) folded before Flop
Seat 2: Eyvan972 (big blind) collected (70)
Seat 3: Reyzous folded before Flop (didn't bet)
Seat 5: RIZCHOU (button) folded before Flop (didn't bet)


PokerStars Home Game Hand #235419844067: {Club #4837790} Tournament #3394929594, €0.13+€0.05+€0.02 EUR Omaha Pot Limit - Level III (35/70) - 2022/04/11 17:44:16 CET [2022/04/11 11:44:16 ET]
Table '3394929594 1' 6-max Seat #1 is the button
Seat 1: jeje_sat (5575 in chips, €0.05 bounty)
Seat 2: Eyvan972 (4640 in chips, €0.05 bounty)
Seat 3: Reyzous (5165 in chips, €0.05 bounty)
Seat 5: RIZCHOU (5090 in chips, €0.05 bounty)
Eyvan972: posts small blind 35
Reyzous: posts big blind 70
*** HOLE CARDS ***
Dealt to jeje_sat [Qs Ad 9d 9c]
RIZCHOU: folds
jeje_sat: raises 175 to 245
Eyvan972: folds
Reyzous: folds
Uncalled bet (175) returned to jeje_sat
jeje_sat collected 175 from pot
jeje_sat: doesn't show hand
*** SUMMARY ***
Total pot 175 | Rake 0
Seat 1: jeje_sat (button) collected (175)
Seat 2: Eyvan972 (small blind) folded before Flop
Seat 3: Reyzous (big blind) folded before Flop
Seat 5: RIZCHOU folded before Flop (didn't bet)


PokerStars Home Game Hand #235419851674: {Club #4837790} Tournament #3394929594, €0.13+€0.05+€0.02 EUR Omaha Pot Limit - Level III (35/70) - 2022/04/11 17:44:42 CET [2022/04/11 11:44:42 ET]
Table '3394929594 1' 6-max Seat #2 is the button
Seat 1: jeje_sat (5680 in chips, €0.05 bounty)
Seat 2: Eyvan972 (4605 in chips, €0.05 bounty)
Seat 3: Reyzous (5095 in chips, €0.05 bounty)
Seat 5: RIZCHOU (5090 in chips, €0.05 bounty)
Reyzous: posts small blind 35
RIZCHOU: posts big blind 70
*** HOLE CARDS ***
Dealt to jeje_sat [Ks Jd Kd 3d]
jeje_sat: raises 175 to 245
Eyvan972: raises 595 to 840
Reyzous: folds
RIZCHOU: folds
jeje_sat: calls 595
*** FLOP *** [Ac 6s 8h]
jeje_sat: checks
Eyvan972: bets 643
jeje_sat: raises 3071 to 3714
Eyvan972: folds
Uncalled bet (3071) returned to jeje_sat
jeje_sat collected 3071 from pot
jeje_sat: doesn't show hand
*** SUMMARY ***
Total pot 3071 | Rake 0
Board [Ac 6s 8h]
Seat 1: jeje_sat collected (3071)
Seat 2: Eyvan972 (button) folded on the Flop
Seat 3: Reyzous (small blind) folded before Flop
Seat 5: RIZCHOU (big blind) folded before Flop


PokerStars Home Game Hand #235419864578: {Club #4837790} Tournament #3394929594, €0.13+€0.05+€0.02 EUR Omaha Pot Limit - Level IV (50/100) - 2022/04/11 17:45:25 CET [2022/04/11 11:45:25 ET]
Table '3394929594 1' 6-max Seat #3 is the button
Seat 1: jeje_sat (7268 in chips, €0.05 bounty)
Seat 2: Eyvan972 (3122 in chips, €0.05 bounty)
Seat 3: Reyzous (5060 in chips, €0.05 bounty)
Seat 5: RIZCHOU (5020 in chips, €0.05 bounty)
RIZCHOU: posts small blind 50
jeje_sat: posts big blind 100
*** HOLE CARDS ***
Dealt to jeje_sat [Jc 6d 7c Qh]
Eyvan972: raises 200 to 300
Reyzous: folds
RIZCHOU: folds
jeje_sat: calls 200
*** FLOP *** [6c 5d 9d]
jeje_sat: checks
Eyvan972: checks
*** TURN *** [6c 5d 9d] [3d]
jeje_sat: checks
Eyvan972: checks
*** RIVER *** [6c 5d 9d 3d] [3s]
jeje_sat: checks
Eyvan972: bets 200
jeje_sat: folds
Uncalled bet (200) returned to Eyvan972
Eyvan972 collected 650 from pot
Eyvan972: doesn't show hand
*** SUMMARY ***
Total pot 650 | Rake 0
Board [6c 5d 9d 3d 3s]
Seat 1: jeje_sat (big blind) folded on the River
Seat 2: Eyvan972 collected (650)
Seat 3: Reyzous (button) folded before Flop (didn't bet)
Seat 5: RIZCHOU (small blind) folded before Flop


PokerStars Home Game Hand #235419881931: {Club #4837790} Tournament #3394929594, €0.13+€0.05+€0.02 EUR Omaha Pot Limit - Level IV (50/100) - 2022/04/11 17:46:22 CET [2022/04/11 11:46:22 ET]
Table '3394929594 1' 6-max Seat #5 is the button
Seat 1: jeje_sat (6968 in chips, €0.05 bounty)
Seat 2: Eyvan972 (3472 in chips, €0.05 bounty)
Seat 3: Reyzous (5060 in chips, €0.05 bounty)
Seat 5: RIZCHOU (4970 in chips, €0.05 bounty)
jeje_sat: posts small blind 50
Eyvan972: posts big blind 100
*** HOLE CARDS ***
Dealt to jeje_sat [Js 2c 3d 5c]
Reyzous: raises 120 to 220
RIZCHOU: folds
jeje_sat: folds
Eyvan972: calls 120
*** FLOP *** [5h Th 9s]
Eyvan972: checks
Reyzous: checks
*** TURN *** [5h Th 9s] [9d]
Eyvan972: checks
Reyzous: checks
*** RIVER *** [5h Th 9s 9d] [Ac]
Eyvan972: checks
Reyzous: checks
*** SHOW DOWN ***
Eyvan972: shows [Kc 6c Jh Qc] (a pair of Nines)
Reyzous: shows [2d 4d Ad 4h] (two pair, Aces and Nines)
Reyzous collected 490 from pot
*** SUMMARY ***
Total pot 490 | Rake 0
Board [5h Th 9s 9d Ac]
Seat 1: jeje_sat (small blind) folded before Flop
Seat 2: Eyvan972 (big blind) showed [Kc 6c Jh Qc] and lost with a pair of Nines
Seat 3: Reyzous showed [2d 4d Ad 4h] and won (490) with two pair, Aces and Nines
Seat 5: RIZCHOU (button) folded before Flop (didn't bet)


PokerStars Home Game Hand #235419889539: {Club #4837790} Tournament #3394929594, €0.13+€0.05+€0.02 EUR Omaha Pot Limit - Level IV (50/100) - 2022/04/11 17:46:48 CET [2022/04/11 11:46:48 ET]
Table '3394929594 1' 6-max Seat #1 is the button
Seat 1: jeje_sat (6918 in chips, €0.05 bounty)
Seat 2: Eyvan972 (3252 in chips, €0.05 bounty)
Seat 3: Reyzous (5330 in chips, €0.05 bounty)
Seat 5: RIZCHOU (4970 in chips, €0.05 bounty)
Eyvan972: posts small blind 50
Reyzous: posts big blind 100
*** HOLE CARDS ***
Dealt to jeje_sat [5d Kc 9h 5h]
RIZCHOU: folds
jeje_sat: folds
Eyvan972: raises 200 to 300
Reyzous: calls 200
*** FLOP *** [Jh 4c 6s]
Eyvan972: checks
Reyzous: checks
*** TURN *** [Jh 4c 6s] [Jd]
Eyvan972: checks
Reyzous: checks
*** RIVER *** [Jh 4c 6s Jd] [As]
Eyvan972: checks
Reyzous: bets 270
Eyvan972: folds
Uncalled bet (270) returned to Reyzous
Reyzous collected 600 from pot
Reyzous: doesn't show hand
*** SUMMARY ***
Total pot 600 | Rake 0
Board [Jh 4c 6s Jd As]
Seat 1: jeje_sat (button) folded before Flop (didn't bet)
Seat 2: Eyvan972 (small blind) folded on the River
Seat 3: Reyzous (big blind) collected (600)
Seat 5: RIZCHOU folded before Flop (didn't bet)


PokerStars Home Game Hand #235419899371: {Club #4837790} Tournament #3394929594, €0.13+€0.05+€0.02 EUR Omaha Pot Limit - Level IV (50/100) - 2022/04/11 17:47:21 CET [2022/04/11 11:47:21 ET]
Table '3394929594 1' 6-max Seat #2 is the button
Seat 1: jeje_sat (6918 in chips, €0.05 bounty)
Seat 2: Eyvan972 (2952 in chips, €0.05 bounty)
Seat 3: Reyzous (5630 in chips, €0.05 bounty)
Seat 5: RIZCHOU (4970 in chips, €0.05 bounty)
Reyzous: posts small blind 50
RIZCHOU: posts big blind 100
*** HOLE CARDS ***
Dealt to jeje_sat [Jc Ah 5d Jh]
jeje_sat: raises 250 to 350
Eyvan972: calls 350
Reyzous: folds
RIZCHOU: folds
*** FLOP *** [3c Js Kc]
jeje_sat: bets 600
Eyvan972: folds
Uncalled bet (600) returned to jeje_sat
jeje_sat collected 850 from pot
jeje_sat: doesn't show hand
*** SUMMARY ***
Total pot 850 | Rake 0
Board [3c Js Kc]
Seat 1: jeje_sat collected (850)
Seat 2: Eyvan972 (button) folded on the Flop
Seat 3: Reyzous (small blind) folded before Flop
Seat 5: RIZCHOU (big blind) folded before Flop


PokerStars Home Game Hand #235419910735: {Club #4837790} Tournament #3394929594, €0.13+€0.05+€0.02 EUR Omaha Pot Limit - Level IV (50/100) - 2022/04/11 17:47:58 CET [2022/04/11 11:47:58 ET]
Table '3394929594 1' 6-max Seat #3 is the button
Seat 1: jeje_sat (7418 in chips, €0.05 bounty)
Seat 2: Eyvan972 (2602 in chips, €0.05 bounty)
Seat 3: Reyzous (5580 in chips, €0.05 bounty)
Seat 5: RIZCHOU (4870 in chips, €0.05 bounty)
RIZCHOU: posts small blind 50
jeje_sat: posts big blind 100
*** HOLE CARDS ***
Dealt to jeje_sat [6s 7c 6h 3s]
Eyvan972: raises 150 to 250
Reyzous: raises 450 to 700
RIZCHOU: folds
jeje_sat: folds
Eyvan972: raises 1550 to 2250
Reyzous: folds
Uncalled bet (1550) returned to Eyvan972
Eyvan972 collected 1550 from pot
Eyvan972: doesn't show hand
*** SUMMARY ***
Total pot 1550 | Rake 0
Seat 1: jeje_sat (big blind) folded before Flop
Seat 2: Eyvan972 collected (1550)
Seat 3: Reyzous (button) folded before Flop
Seat 5: RIZCHOU (small blind) folded before Flop


PokerStars Home Game Hand #235419919432: {Club #4837790} Tournament #3394929594, €0.13+€0.05+€0.02 EUR Omaha Pot Limit - Level IV (50/100) - 2022/04/11 17:48:27 CET [2022/04/11 11:48:27 ET]
Table '3394929594 1' 6-max Seat #5 is the button
Seat 1: jeje_sat (7318 in chips, €0.05 bounty)
Seat 2: Eyvan972 (3452 in chips, €0.05 bounty)
Seat 3: Reyzous (4880 in chips, €0.05 bounty)
Seat 5: RIZCHOU (4820 in chips, €0.05 bounty)
jeje_sat: posts small blind 50
Eyvan972: posts big blind 100
*** HOLE CARDS ***
Dealt to jeje_sat [7h 5c 4c Th]
Reyzous: folds
RIZCHOU: folds
jeje_sat: folds
Uncalled bet (50) returned to Eyvan972
Eyvan972 collected 100 from pot
Eyvan972: doesn't show hand
*** SUMMARY ***
Total pot 100 | Rake 0
Seat 1: jeje_sat (small blind) folded before Flop
Seat 2: Eyvan972 (big blind) collected (100)
Seat 3: Reyzous folded before Flop (didn't bet)
Seat 5: RIZCHOU (button) folded before Flop (didn't bet)


PokerStars Home Game Hand #235419923565: {Club #4837790} Tournament #3394929594, €0.13+€0.05+€0.02 EUR Omaha Pot Limit - Level IV (50/100) - 2022/04/11 17:48:40 CET [2022/04/11 11:48:40 ET]
Table '3394929594 1' 6-max Seat #1 is the button
Seat 1: jeje_sat (7268 in chips, €0.05 bounty)
Seat 2: Eyvan972 (3502 in chips, €0.05 bounty)
Seat 3: Reyzous (4880 in chips, €0.05 bounty)
Seat 5: RIZCHOU (4820 in chips, €0.05 bounty)
Eyvan972: posts small blind 50
Reyzous: posts big blind 100
*** HOLE CARDS ***
Dealt to jeje_sat [5s Ac 5h 3c]
RIZCHOU: folds
jeje_sat: raises 250 to 350
Eyvan972: calls 300
Reyzous: folds
*** FLOP *** [2h Td Qc]
Eyvan972: checks
jeje_sat: checks
*** TURN *** [2h Td Qc] [7h]
Eyvan972: checks
jeje_sat: checks
*** RIVER *** [2h Td Qc 7h] [8s]
Eyvan972: checks
jeje_sat: checks
*** SHOW DOWN ***
Eyvan972: shows [3s 8d 4c 9s] (a pair of Eights)
jeje_sat: mucks hand
Eyvan972 collected 800 from pot
*** SUMMARY ***
Total pot 800 | Rake 0
Board [2h Td Qc 7h 8s]
Seat 1: jeje_sat (button) mucked [5s Ac 5h 3c]
Seat 2: Eyvan972 (small blind) showed [3s 8d 4c 9s] and won (800) with a pair of Eights
Seat 3: Reyzous (big blind) folded before Flop
Seat 5: RIZCHOU folded before Flop (didn't bet)


PokerStars Home Game Hand #235419932090: {Club #4837790} Tournament #3394929594, €0.13+€0.05+€0.02 EUR Omaha Pot Limit - Level IV (50/100) - 2022/04/11 17:49:08 CET [2022/04/11 11:49:08 ET]
Table '3394929594 1' 6-max Seat #2 is the button
Seat 1: jeje_sat (6918 in chips, €0.05 bounty)
Seat 2: Eyvan972 (3952 in chips, €0.05 bounty)
Seat 3: Reyzous (4780 in chips, €0.05 bounty)
Seat 5: RIZCHOU (4820 in chips, €0.05 bounty)
Reyzous: posts small blind 50
RIZCHOU: posts big blind 100
*** HOLE CARDS ***
Dealt to jeje_sat [6s 5h Td 6h]
jeje_sat: folds
Eyvan972: folds
Reyzous: calls 50
RIZCHOU: checks
*** FLOP *** [2s Jc Ts]
Reyzous: bets 130
RIZCHOU: calls 130
*** TURN *** [2s Jc Ts] [2h]
Reyzous: bets 391
RIZCHOU: folds
Uncalled bet (391) returned to Reyzous
Reyzous collected 460 from pot
Reyzous: doesn't show hand
*** SUMMARY ***
Total pot 460 | Rake 0
Board [2s Jc Ts 2h]
Seat 1: jeje_sat folded before Flop (didn't bet)
Seat 2: Eyvan972 (button) folded before Flop (didn't bet)
Seat 3: Reyzous (small blind) collected (460)
Seat 5: RIZCHOU (big blind) folded on the Turn


PokerStars Home Game Hand #235419942611: {Club #4837790} Tournament #3394929594, €0.13+€0.05+€0.02 EUR Omaha Pot Limit - Level IV (50/100) - 2022/04/11 17:49:42 CET [2022/04/11 11:49:42 ET]
Table '3394929594 1' 6-max Seat #3 is the button
Seat 1: jeje_sat (6918 in chips, €0.05 bounty)
Seat 2: Eyvan972 (3952 in chips, €0.05 bounty)
Seat 3: Reyzous (5010 in chips, €0.05 bounty)
Seat 5: RIZCHOU (4590 in chips, €0.05 bounty)
RIZCHOU: posts small blind 50
jeje_sat: posts big blind 100
*** HOLE CARDS ***
Dealt to jeje_sat [7c 7d As 2c]
Eyvan972: folds
Reyzous: raises 120 to 220
RIZCHOU: folds
jeje_sat: folds
Uncalled bet (120) returned to Reyzous
Reyzous collected 250 from pot
Reyzous: doesn't show hand
*** SUMMARY ***
Total pot 250 | Rake 0
Seat 1: jeje_sat (big blind) folded before Flop
Seat 2: Eyvan972 folded before Flop (didn't bet)
Seat 3: Reyzous (button) collected (250)
Seat 5: RIZCHOU (small blind) folded before Flop


PokerStars Home Game Hand #235419950643: {Club #4837790} Tournament #3394929594, €0.13+€0.05+€0.02 EUR Omaha Pot Limit - Level V (75/150) - 2022/04/11 17:50:08 CET [2022/04/11 11:50:08 ET]
Table '3394929594 1' 6-max Seat #5 is the button
Seat 1: jeje_sat (6818 in chips, €0.05 bounty)
Seat 2: Eyvan972 (3952 in chips, €0.05 bounty)
Seat 3: Reyzous (5160 in chips, €0.05 bounty)
Seat 5: RIZCHOU (4540 in chips, €0.05 bounty)
jeje_sat: posts small blind 75
Eyvan972: posts big blind 150
*** HOLE CARDS ***
Dealt to jeje_sat [3d Qd Td 3s]
Reyzous: folds
RIZCHOU: raises 300 to 450
jeje_sat: folds
Eyvan972: raises 975 to 1425
RIZCHOU: folds
Uncalled bet (975) returned to Eyvan972
Eyvan972 collected 975 from pot
Eyvan972: doesn't show hand
*** SUMMARY ***
Total pot 975 | Rake 0
Seat 1: jeje_sat (small blind) folded before Flop
Seat 2: Eyvan972 (big blind) collected (975)
Seat 3: Reyzous folded before Flop (didn't bet)
Seat 5: RIZCHOU (button) folded before Flop


PokerStars Home Game Hand #235419958674: {Club #4837790} Tournament #3394929594, €0.13+€0.05+€0.02 EUR Omaha Pot Limit - Level V (75/150) - 2022/04/11 17:50:35 CET [2022/04/11 11:50:35 ET]
Table '3394929594 1' 6-max Seat #1 is the button
Seat 1: jeje_sat (6743 in chips, €0.05 bounty)
Seat 2: Eyvan972 (4477 in chips, €0.05 bounty)
Seat 3: Reyzous (5160 in chips, €0.05 bounty)
Seat 5: RIZCHOU (4090 in chips, €0.05 bounty)
Eyvan972: posts small blind 75
Reyzous: posts big blind 150
*** HOLE CARDS ***
Dealt to jeje_sat [Qd 2d 5c 9s]
RIZCHOU: folds
jeje_sat: folds
Eyvan972: folds
Uncalled bet (75) returned to Reyzous
Reyzous collected 150 from pot
Reyzous: doesn't show hand
*** SUMMARY ***
Total pot 150 | Rake 0
Seat 1: jeje_sat (button) folded before Flop (didn't bet)
Seat 2: Eyvan972 (small blind) folded before Flop
Seat 3: Reyzous (big blind) collected (150)
Seat 5: RIZCHOU folded before Flop (didn't bet)


PokerStars Home Game Hand #235419962372: {Club #4837790} Tournament #3394929594, €0.13+€0.05+€0.02 EUR Omaha Pot Limit - Level V (75/150) - 2022/04/11 17:50:47 CET [2022/04/11 11:50:47 ET]
Table '3394929594 1' 6-max Seat #2 is the button
Seat 1: jeje_sat (6743 in chips, €0.05 bounty)
Seat 2: Eyvan972 (4402 in chips, €0.05 bounty)
Seat 3: Reyzous (5235 in chips, €0.05 bounty)
Seat 5: RIZCHOU (4090 in chips, €0.05 bounty)
Reyzous: posts small blind 75
RIZCHOU: posts big blind 150
*** HOLE CARDS ***
Dealt to jeje_sat [Qc Qs Jc Jh]
jeje_sat: raises 375 to 525
Eyvan972: raises 1275 to 1800
Reyzous: folds
RIZCHOU: folds
jeje_sat: calls 1275
*** FLOP *** [2c 8s Td]
jeje_sat: bets 3825
Eyvan972: calls 2602 and is all-in
Uncalled bet (1223) returned to jeje_sat
*** TURN *** [2c 8s Td] [4d]
*** RIVER *** [2c 8s Td 4d] [Kh]
*** SHOW DOWN ***
jeje_sat: shows [Qc Qs Jc Jh] (a pair of Queens)
Eyvan972: shows [7s 2h Ah Ts] (two pair, Tens and Deuces)
Eyvan972 collected 9029 from pot
*** SUMMARY ***
Total pot 9029 | Rake 0
Board [2c 8s Td 4d Kh]
Seat 1: jeje_sat showed [Qc Qs Jc Jh] and lost with a pair of Queens
Seat 2: Eyvan972 (button) showed [7s 2h Ah Ts] and won (9029) with two pair, Tens and Deuces
Seat 3: Reyzous (small blind) folded before Flop
Seat 5: RIZCHOU (big blind) folded before Flop


PokerStars Home Game Hand #235419972032: {Club #4837790} Tournament #3394929594, €0.13+€0.05+€0.02 EUR Omaha Pot Limit - Level V (75/150) - 2022/04/11 17:51:19 CET [2022/04/11 11:51:19 ET]
Table '3394929594 1' 6-max Seat #3 is the button
Seat 1: jeje_sat (2341 in chips, €0.05 bounty)
Seat 2: Eyvan972 (9029 in chips, €0.05 bounty)
Seat 3: Reyzous (5160 in chips, €0.05 bounty)
Seat 5: RIZCHOU (3940 in chips, €0.05 bounty)
RIZCHOU: posts small blind 75
jeje_sat: posts big blind 150
*** HOLE CARDS ***
Dealt to jeje_sat [As 5d 3h Qd]
Eyvan972: calls 150
Reyzous: folds
RIZCHOU: folds
jeje_sat: raises 375 to 525
Eyvan972: calls 375
*** FLOP *** [Ah 2d Jc]
jeje_sat: bets 1125
Eyvan972: folds
Uncalled bet (1125) returned to jeje_sat
jeje_sat collected 1125 from pot
jeje_sat: doesn't show hand
*** SUMMARY ***
Total pot 1125 | Rake 0
Board [Ah 2d Jc]
Seat 1: jeje_sat (big blind) collected (1125)
Seat 2: Eyvan972 folded on the Flop
Seat 3: Reyzous (button) folded before Flop (didn't bet)
Seat 5: RIZCHOU (small blind) folded before Flop


PokerStars Home Game Hand #235419978269: {Club #4837790} Tournament #3394929594, €0.13+€0.05+€0.02 EUR Omaha Pot Limit - Level V (75/150) - 2022/04/11 17:51:39 CET [2022/04/11 11:51:39 ET]
Table '3394929594 1' 6-max Seat #5 is the button
Seat 1: jeje_sat (2941 in chips, €0.05 bounty)
Seat 2: Eyvan972 (8504 in chips, €0.05 bounty)
Seat 3: Reyzous (5160 in chips, €0.05 bounty)
Seat 5: RIZCHOU (3865 in chips, €0.05 bounty)
jeje_sat: posts small blind 75
Eyvan972: posts big blind 150
*** HOLE CARDS ***
Dealt to jeje_sat [5h Ks Td Kh]
Reyzous: folds
RIZCHOU: folds
jeje_sat: raises 300 to 450
Eyvan972: folds
Uncalled bet (300) returned to jeje_sat
jeje_sat collected 300 from pot
jeje_sat: doesn't show hand
*** SUMMARY ***
Total pot 300 | Rake 0
Seat 1: jeje_sat (small blind) collected (300)
Seat 2: Eyvan972 (big blind) folded before Flop
Seat 3: Reyzous folded before Flop (didn't bet)
Seat 5: RIZCHOU (button) folded before Flop (didn't bet)


PokerStars Home Game Hand #235419981904: {Club #4837790} Tournament #3394929594, €0.13+€0.05+€0.02 EUR Omaha Pot Limit - Level V (75/150) - 2022/04/11 17:51:51 CET [2022/04/11 11:51:51 ET]
Table '3394929594 1' 6-max Seat #1 is the button
Seat 1: jeje_sat (3091 in chips, €0.05 bounty)
Seat 2: Eyvan972 (8354 in chips, €0.05 bounty)
Seat 3: Reyzous (5160 in chips, €0.05 bounty)
Seat 5: RIZCHOU (3865 in chips, €0.05 bounty)
Eyvan972: posts small blind 75
Reyzous: posts big blind 150
*** HOLE CARDS ***
Dealt to jeje_sat [9c 6c Qs Kc]
RIZCHOU: folds
jeje_sat: raises 375 to 525
Eyvan972: raises 1200 to 1725
Reyzous: folds
jeje_sat: raises 1366 to 3091 and is all-in
Eyvan972: calls 1366
*** FLOP *** [4c 8h Qc]
*** TURN *** [4c 8h Qc] [9h]
*** RIVER *** [4c 8h Qc 9h] [Ts]
*** SHOW DOWN ***
Eyvan972: shows [5d Kd 5h Qh] (a pair of Queens)
jeje_sat: shows [9c 6c Qs Kc] (two pair, Queens and Nines)
jeje_sat collected 6332 from pot
*** SUMMARY ***
Total pot 6332 | Rake 0
Board [4c 8h Qc 9h Ts]
Seat 1: jeje_sat (button) showed [9c 6c Qs Kc] and won (6332) with two pair, Queens and Nines
Seat 2: Eyvan972 (small blind) showed [5d Kd 5h Qh] and lost with a pair of Queens
Seat 3: Reyzous (big blind) folded before Flop
Seat 5: RIZCHOU folded before Flop (didn't bet)


PokerStars Home Game Hand #235419990604: {Club #4837790} Tournament #3394929594, €0.13+€0.05+€0.02 EUR Omaha Pot Limit - Level V (75/150) - 2022/04/11 17:52:20 CET [2022/04/11 11:52:20 ET]
Table '3394929594 1' 6-max Seat #2 is the button
Seat 1: jeje_sat (6332 in chips, €0.05 bounty)
Seat 2: Eyvan972 (5263 in chips, €0.05 bounty)
Seat 3: Reyzous (5010 in chips, €0.05 bounty)
Seat 5: RIZCHOU (3865 in chips, €0.05 bounty)
Reyzous: posts small blind 75
RIZCHOU: posts big blind 150
*** HOLE CARDS ***
Dealt to jeje_sat [7s Kd 4d Ks]
jeje_sat: raises 375 to 525
Eyvan972: raises 1275 to 1800
Reyzous: folds
RIZCHOU: folds
jeje_sat: raises 3825 to 5625
Eyvan972: calls 3463 and is all-in
Uncalled bet (362) returned to jeje_sat
*** FLOP *** [Qd 8c 6c]
*** TURN *** [Qd 8c 6c] [Tc]
*** RIVER *** [Qd 8c 6c Tc] [8d]
*** SHOW DOWN ***
jeje_sat: shows [7s Kd 4d Ks] (two pair, Kings and Eights)
Eyvan972: shows [4c Td 9s 2c] (a flush, Ten high)
Eyvan972 collected 10751 from pot
*** SUMMARY ***
Total pot 10751 | Rake 0
Board [Qd 8c 6c Tc 8d]
Seat 1: jeje_sat showed [7s Kd 4d Ks] and lost with two pair, Kings and Eights
Seat 2: Eyvan972 (button) showed [4c Td 9s 2c] and won (10751) with a flush, Ten high
Seat 3: Reyzous (small blind) folded before Flop
Seat 5: RIZCHOU (big blind) folded before Flop


PokerStars Home Game Hand #235419998683: {Club #4837790} Tournament #3394929594, €0.13+€0.05+€0.02 EUR Omaha Pot Limit - Level V (75/150) - 2022/04/11 17:52:47 CET [2022/04/11 11:52:47 ET]
Table '3394929594 1' 6-max Seat #3 is the button
Seat 1: jeje_sat (1069 in chips, €0.05 bounty)
Seat 2: Eyvan972 (10751 in chips, €0.05 bounty)
Seat 3: Reyzous (4935 in chips, €0.05 bounty)
Seat 5: RIZCHOU (3715 in chips, €0.05 bounty)
RIZCHOU: posts small blind 75
jeje_sat: posts big blind 150
*** HOLE CARDS ***
Dealt to jeje_sat [Td 8s 3h 9c]
Eyvan972: raises 375 to 525
Reyzous: folds
RIZCHOU: folds
jeje_sat: raises 544 to 1069 and is all-in
Eyvan972: calls 544
*** FLOP *** [5c 6d Ks]
*** TURN *** [5c 6d Ks] [Ts]
*** RIVER *** [5c 6d Ks Ts] [3d]
*** SHOW DOWN ***
jeje_sat: shows [Td 8s 3h 9c] (two pair, Tens and Threes)
Eyvan972: shows [5s 7d Jd 9s] (a pair of Fives)
jeje_sat collected 2213 from pot
*** SUMMARY ***
Total pot 2213 | Rake 0
Board [5c 6d Ks Ts 3d]
Seat 1: jeje_sat (big blind) showed [Td 8s 3h 9c] and won (2213) with two pair, Tens and Threes
Seat 2: Eyvan972 showed [5s 7d Jd 9s] and lost with a pair of Fives
Seat 3: Reyzous (button) folded before Flop (didn't bet)
Seat 5: RIZCHOU (small blind) folded before Flop


PokerStars Home Game Hand #235420004508: {Club #4837790} Tournament #3394929594, €0.13+€0.05+€0.02 EUR Omaha Pot Limit - Level V (75/150) - 2022/04/11 17:53:06 CET [2022/04/11 11:53:06 ET]
Table '3394929594 1' 6-max Seat #5 is the button
Seat 1: jeje_sat (2213 in chips, €0.05 bounty)
Seat 2: Eyvan972 (9682 in chips, €0.05 bounty)
Seat 3: Reyzous (4935 in chips, €0.05 bounty)
Seat 5: RIZCHOU (3640 in chips, €0.05 bounty)
jeje_sat: posts small blind 75
Eyvan972: posts big blind 150
*** HOLE CARDS ***
Dealt to jeje_sat [2d 6d Ks Ah]
Reyzous: folds
RIZCHOU: raises 375 to 525
jeje_sat: raises 1200 to 1725
Eyvan972: raises 3975 to 5700
RIZCHOU: folds
jeje_sat: calls 488 and is all-in
Uncalled bet (3487) returned to Eyvan972
*** FLOP *** [Qd 7c Td]
*** TURN *** [Qd 7c Td] [5d]
*** RIVER *** [Qd 7c Td 5d] [8s]
*** SHOW DOWN ***
jeje_sat: shows [2d 6d Ks Ah] (a flush, Queen high)
Eyvan972: shows [9h Qh 8d Kc] (two pair, Queens and Eights)
jeje_sat collected 4951 from pot
*** SUMMARY ***
Total pot 4951 | Rake 0
Board [Qd 7c Td 5d 8s]
Seat 1: jeje_sat (small blind) showed [2d 6d Ks Ah] and won (4951) with a flush, Queen high
Seat 2: Eyvan972 (big blind) showed [9h Qh 8d Kc] and lost with two pair, Queens and Eights
Seat 3: Reyzous folded before Flop (didn't bet)
Seat 5: RIZCHOU (button) folded before Flop


PokerStars Home Game Hand #235420012455: {Club #4837790} Tournament #3394929594, €0.13+€0.05+€0.02 EUR Omaha Pot Limit - Level V (75/150) - 2022/04/11 17:53:32 CET [2022/04/11 11:53:32 ET]
Table '3394929594 1' 6-max Seat #1 is the button
Seat 1: jeje_sat (4951 in chips, €0.05 bounty)
Seat 2: Eyvan972 (7469 in chips, €0.05 bounty)
Seat 3: Reyzous (4935 in chips, €0.05 bounty)
Seat 5: RIZCHOU (3115 in chips, €0.05 bounty)
Eyvan972: posts small blind 75
Reyzous: posts big blind 150
*** HOLE CARDS ***
Dealt to jeje_sat [5c Tc 2d 8s]
RIZCHOU: folds
jeje_sat: folds
Eyvan972: calls 75
Reyzous: raises 300 to 450
Eyvan972: calls 300
*** FLOP *** [5d Ac 2h]
Eyvan972: checks
Reyzous: bets 585
Eyvan972: folds
Uncalled bet (585) returned to Reyzous
Reyzous collected 900 from pot
Reyzous: doesn't show hand
*** SUMMARY ***
Total pot 900 | Rake 0
Board [5d Ac 2h]
Seat 1: jeje_sat (button) folded before Flop (didn't bet)
Seat 2: Eyvan972 (small blind) folded on the Flop
Seat 3: Reyzous (big blind) collected (900)
Seat 5: RIZCHOU folded before Flop (didn't bet)


PokerStars Home Game Hand #235420020770: {Club #4837790} Tournament #3394929594, €0.13+€0.05+€0.02 EUR Omaha Pot Limit - Level V (75/150) - 2022/04/11 17:53:59 CET [2022/04/11 11:53:59 ET]
Table '3394929594 1' 6-max Seat #2 is the button
Seat 1: jeje_sat (4951 in chips, €0.05 bounty)
Seat 2: Eyvan972 (7019 in chips, €0.05 bounty)
Seat 3: Reyzous (5385 in chips, €0.05 bounty)
Seat 5: RIZCHOU (3115 in chips, €0.05 bounty)
Reyzous: posts small blind 75
RIZCHOU: posts big blind 150
*** HOLE CARDS ***
Dealt to jeje_sat [7h Ks Jh 4s]
jeje_sat: raises 375 to 525
Eyvan972: folds
Reyzous: calls 450
RIZCHOU: folds
*** FLOP *** [Ac Kh 2s]
Reyzous: checks
jeje_sat: bets 600
Reyzous: calls 600
*** TURN *** [Ac Kh 2s] [Tc]
Reyzous: checks
jeje_sat: checks
*** RIVER *** [Ac Kh 2s Tc] [Qc]
Reyzous: bets 1080
jeje_sat: raises 2746 to 3826 and is all-in
Reyzous: folds
Uncalled bet (2746) returned to jeje_sat
jeje_sat collected 4560 from pot
jeje_sat: doesn't show hand
*** SUMMARY ***
Total pot 4560 | Rake 0
Board [Ac Kh 2s Tc Qc]
Seat 1: jeje_sat collected (4560)
Seat 2: Eyvan972 (button) folded before Flop (didn't bet)
Seat 3: Reyzous (small blind) folded on the River
Seat 5: RIZCHOU (big blind) folded before Flop


PokerStars Home Game Hand #235420149700: {Club #4837790} Tournament #3394929594, €0.13+€0.05+€0.02 EUR Omaha Pot Limit - Level VI (100/200) - 2022/04/11 18:01:44 CET [2022/04/11 12:01:44 ET]
Table '3394929594 1' 6-max Seat #3 is the button
Seat 1: jeje_sat (7306 in chips, €0.05 bounty)
Seat 2: Eyvan972 (7019 in chips, €0.05 bounty)
Seat 3: Reyzous (3180 in chips, €0.05 bounty)
Seat 5: RIZCHOU (2965 in chips, €0.05 bounty)
Seat 6: PistoPutin (5000 in chips, €0.05 bounty)
RIZCHOU: posts small blind 100
PistoPutin: posts big blind 200
*** HOLE CARDS ***
Dealt to jeje_sat [2d 2h Js 9s]
jeje_sat: folds
Eyvan972: folds
Reyzous: raises 500 to 700
RIZCHOU: folds
PistoPutin: folds
Uncalled bet (500) returned to Reyzous
Reyzous collected 500 from pot
Reyzous: doesn't show hand
*** SUMMARY ***
Total pot 500 | Rake 0
Seat 1: jeje_sat folded before Flop (didn't bet)
Seat 2: Eyvan972 folded before Flop (didn't bet)
Seat 3: Reyzous (button) collected (500)
Seat 5: RIZCHOU (small blind) folded before Flop
Seat 6: PistoPutin (big blind) folded before Flop


PokerStars Home Game Hand #235420159909: {Club #4837790} Tournament #3394929594, €0.13+€0.05+€0.02 EUR Omaha Pot Limit - Level VI (100/200) - 2022/04/11 18:02:18 CET [2022/04/11 12:02:18 ET]
Table '3394929594 1' 6-max Seat #5 is the button
Seat 1: jeje_sat (7306 in chips, €0.05 bounty)
Seat 2: Eyvan972 (7019 in chips, €0.05 bounty)
Seat 3: Reyzous (3480 in chips, €0.05 bounty)
Seat 5: RIZCHOU (2865 in chips, €0.05 bounty)
Seat 6: PistoPutin (4800 in chips, €0.05 bounty)
PistoPutin: posts small blind 100
jeje_sat: posts big blind 200
*** HOLE CARDS ***
Dealt to jeje_sat [3d 9h Kh 7c]
Eyvan972: folds
Reyzous: folds
RIZCHOU: raises 500 to 700
PistoPutin: raises 1600 to 2300
jeje_sat: folds
RIZCHOU: raises 565 to 2865 and is all-in
PistoPutin: calls 565
*** FLOP *** [8d Qd Kd]
*** TURN *** [8d Qd Kd] [Tc]
*** RIVER *** [8d Qd Kd Tc] [2c]
*** SHOW DOWN ***
PistoPutin: shows [2d 2s Ah Ad] (a flush, Ace high)
RIZCHOU: shows [Ks As Js Qc] (a straight, Ten to Ace)
PistoPutin collected 5930 from pot
PistoPutin wins €0.03 for eliminating RIZCHOU and their own bounty increases by €0.02 to €0.07
RIZCHOU finished the tournament in 10th place
*** SUMMARY ***
Total pot 5930 | Rake 0
Board [8d Qd Kd Tc 2c]
Seat 1: jeje_sat (big blind) folded before Flop
Seat 2: Eyvan972 folded before Flop (didn't bet)
Seat 3: Reyzous folded before Flop (didn't bet)
Seat 5: RIZCHOU (button) showed [Ks As Js Qc] and lost with a straight, Ten to Ace
Seat 6: PistoPutin (small blind) showed [2d 2s Ah Ad] and won (5930) with a flush, Ace high


PokerStars Home Game Hand #235420171496: {Club #4837790} Tournament #3394929594, €0.13+€0.05+€0.02 EUR Omaha Pot Limit - Level VI (100/200) - 2022/04/11 18:02:56 CET [2022/04/11 12:02:56 ET]
Table '3394929594 1' 6-max Seat #6 is the button
Seat 1: jeje_sat (7106 in chips, €0.05 bounty)
Seat 2: Eyvan972 (7019 in chips, €0.05 bounty)
Seat 3: Reyzous (3480 in chips, €0.05 bounty)
Seat 6: PistoPutin (7865 in chips, €0.07 bounty)
jeje_sat: posts small blind 100
Eyvan972: posts big blind 200
*** HOLE CARDS ***
Dealt to jeje_sat [9h 8s 4d Kc]
Reyzous: raises 200 to 400
PistoPutin: calls 400
jeje_sat is disconnected
jeje_sat has timed out while disconnected
jeje_sat: folds
jeje_sat is sitting out
jeje_sat has returned
Eyvan972: folds
*** FLOP *** [Qd 9s 3c]
Reyzous: checks
PistoPutin: checks
*** TURN *** [Qd 9s 3c] [4s]
Reyzous: bets 715
PistoPutin: folds
Uncalled bet (715) returned to Reyzous
Reyzous collected 1100 from pot
Reyzous: doesn't show hand
*** SUMMARY ***
Total pot 1100 | Rake 0
Board [Qd 9s 3c 4s]
Seat 1: jeje_sat (small blind) folded before Flop
Seat 2: Eyvan972 (big blind) folded before Flop
Seat 3: Reyzous collected (1100)
Seat 6: PistoPutin (button) folded on the Turn


PokerStars Home Game Hand #235420190312: {Club #4837790} Tournament #3394929594, €0.13+€0.05+€0.02 EUR Omaha Pot Limit - Level VI (100/200) - 2022/04/11 18:03:57 CET [2022/04/11 12:03:57 ET]
Table '3394929594 1' 6-max Seat #1 is the button
Seat 1: jeje_sat (7006 in chips, €0.05 bounty)
Seat 2: Eyvan972 (6819 in chips, €0.05 bounty)
Seat 3: Reyzous (4180 in chips, €0.05 bounty)
Seat 6: PistoPutin (7465 in chips, €0.07 bounty)
Eyvan972: posts small blind 100
Reyzous: posts big blind 200
*** HOLE CARDS ***
Dealt to jeje_sat [Qd Qs 9d Jd]
PistoPutin: folds
jeje_sat: raises 500 to 700
Eyvan972: folds
Reyzous: folds
Uncalled bet (500) returned to jeje_sat
jeje_sat collected 500 from pot
jeje_sat: doesn't show hand
*** SUMMARY ***
Total pot 500 | Rake 0
Seat 1: jeje_sat (button) collected (500)
Seat 2: Eyvan972 (small blind) folded before Flop
Seat 3: Reyzous (big blind) folded before Flop
Seat 6: PistoPutin folded before Flop (didn't bet)


PokerStars Home Game Hand #235420194735: {Club #4837790} Tournament #3394929594, €0.13+€0.05+€0.02 EUR Omaha Pot Limit - Level VI (100/200) - 2022/04/11 18:04:11 CET [2022/04/11 12:04:11 ET]
Table '3394929594 1' 6-max Seat #2 is the button
Seat 1: jeje_sat (7306 in chips, €0.05 bounty)
Seat 2: Eyvan972 (6719 in chips, €0.05 bounty)
Seat 3: Reyzous (3980 in chips, €0.05 bounty)
Seat 6: PistoPutin (7465 in chips, €0.07 bounty)
Reyzous: posts small blind 100
PistoPutin: posts big blind 200
*** HOLE CARDS ***
Dealt to jeje_sat [Ah Tc 3s 5s]
jeje_sat: folds
Eyvan972 has timed out
Eyvan972: folds
Eyvan972 is sitting out
Eyvan972 has returned
Reyzous: calls 100
PistoPutin: checks
*** FLOP *** [8d Qs 7c]
Reyzous: bets 340
PistoPutin: raises 1080 to 1420
Reyzous: calls 1080
*** TURN *** [8d Qs 7c] [Kc]
Reyzous: checks
PistoPutin: bets 2430
Reyzous: calls 2360 and is all-in
Uncalled bet (70) returned to PistoPutin
*** RIVER *** [8d Qs 7c Kc] [3c]
*** SHOW DOWN ***
Reyzous: shows [Qd Kd 6h 8c] (two pair, Kings and Queens)
PistoPutin: shows [Qh 6d 5c 8h] (two pair, Queens and Eights)
Reyzous collected 7960 from pot
*** SUMMARY ***
Total pot 7960 | Rake 0
Board [8d Qs 7c Kc 3c]
Seat 1: jeje_sat folded before Flop (didn't bet)
Seat 2: Eyvan972 (button) folded before Flop (didn't bet)
Seat 3: Reyzous (small blind) showed [Qd Kd 6h 8c] and won (7960) with two pair, Kings and Queens
Seat 6: PistoPutin (big blind) showed [Qh 6d 5c 8h] and lost with two pair, Queens and Eights


PokerStars Home Game Hand #235420222373: {Club #4837790} Tournament #3394929594, €0.13+€0.05+€0.02 EUR Omaha Pot Limit - Level VI (100/200) - 2022/04/11 18:05:39 CET [2022/04/11 12:05:39 ET]
Table '3394929594 1' 6-max Seat #3 is the button
Seat 1: jeje_sat (7306 in chips, €0.05 bounty)
Seat 2: Eyvan972 (6719 in chips, €0.05 bounty)
Seat 3: Reyzous (7960 in chips, €0.05 bounty)
Seat 6: PistoPutin (3485 in chips, €0.07 bounty)
PistoPutin: posts small blind 100
jeje_sat: posts big blind 200
*** HOLE CARDS ***
Dealt to jeje_sat [7c Ah Qh Ks]
Eyvan972: raises 400 to 600
Reyzous: folds
PistoPutin: folds
jeje_sat: calls 400
*** FLOP *** [4c 4s 7h]
jeje_sat: checks
Eyvan972: checks
*** TURN *** [4c 4s 7h] [Js]
jeje_sat: checks
Eyvan972: checks
*** RIVER *** [4c 4s 7h Js] [2s]
jeje_sat: checks
Eyvan972: checks
*** SHOW DOWN ***
jeje_sat: shows [7c Ah Qh Ks] (two pair, Sevens and Fours)
Eyvan972: mucks hand
jeje_sat collected 1300 from pot
*** SUMMARY ***
Total pot 1300 | Rake 0
Board [4c 4s 7h Js 2s]
Seat 1: jeje_sat (big blind) showed [7c Ah Qh Ks] and won (1300) with two pair, Sevens and Fours
Seat 2: Eyvan972 mucked [Ac 2h 5h Tc]
Seat 3: Reyzous (button) folded before Flop (didn't bet)
Seat 6: PistoPutin (small blind) folded before Flop


PokerStars Home Game Hand #235420233633: {Club #4837790} Tournament #3394929594, €0.13+€0.05+€0.02 EUR Omaha Pot Limit - Level VI (100/200) - 2022/04/11 18:06:15 CET [2022/04/11 12:06:15 ET]
Table '3394929594 1' 6-max Seat #6 is the button
Seat 1: jeje_sat (8006 in chips, €0.05 bounty)
Seat 2: Eyvan972 (6119 in chips, €0.05 bounty)
Seat 3: Reyzous (7960 in chips, €0.05 bounty)
Seat 6: PistoPutin (3385 in chips, €0.07 bounty)
jeje_sat: posts small blind 100
Eyvan972: posts big blind 200
*** HOLE CARDS ***
Dealt to jeje_sat [4s 7c Qc 9h]
Reyzous: folds
PistoPutin: calls 200
jeje_sat: folds
Eyvan972: checks
*** FLOP *** [6s Th Jd]
Eyvan972: checks
PistoPutin: checks
*** TURN *** [6s Th Jd] [2c]
Eyvan972: checks
PistoPutin: checks
*** RIVER *** [6s Th Jd 2c] [Qh]
Eyvan972: checks
PistoPutin: checks
*** SHOW DOWN ***
Eyvan972: shows [Qs 7s Td 2d] (two pair, Queens and Tens)
PistoPutin: mucks hand
Eyvan972 collected 500 from pot
*** SUMMARY ***
Total pot 500 | Rake 0
Board [6s Th Jd 2c Qh]
Seat 1: jeje_sat (small blind) folded before Flop
Seat 2: Eyvan972 (big blind) showed [Qs 7s Td 2d] and won (500) with two pair, Queens and Tens
Seat 3: Reyzous folded before Flop (didn't bet)
Seat 6: PistoPutin (button) mucked [3s 8d 8s 3h]


PokerStars Home Game Hand #235420259986: {Club #4837790} Tournament #3394929594, €0.13+€0.05+€0.02 EUR Omaha Pot Limit - Level VII (125/250) - 2022/04/11 18:07:38 CET [2022/04/11 12:07:38 ET]
Table '3394929594 1' 6-max Seat #1 is the button
Seat 1: jeje_sat (7906 in chips, €0.05 bounty)
Seat 2: Eyvan972 (6419 in chips, €0.05 bounty)
Seat 3: Reyzous (7960 in chips, €0.05 bounty)
Seat 6: PistoPutin (3185 in chips, €0.07 bounty)
Eyvan972: posts small blind 125
Reyzous: posts big blind 250
*** HOLE CARDS ***
Dealt to jeje_sat [4c Ts Js 8s]
PistoPutin: folds
jeje_sat: raises 625 to 875
Eyvan972: folds
Reyzous: calls 625
*** FLOP *** [Jh Td Tc]
Reyzous: checks
jeje_sat: bets 938
Reyzous: folds
Uncalled bet (938) returned to jeje_sat
jeje_sat collected 1875 from pot
jeje_sat: doesn't show hand
*** SUMMARY ***
Total pot 1875 | Rake 0
Board [Jh Td Tc]
Seat 1: jeje_sat (button) collected (1875)
Seat 2: Eyvan972 (small blind) folded before Flop
Seat 3: Reyzous (big blind) folded on the Flop
Seat 6: PistoPutin folded before Flop (didn't bet)


PokerStars Home Game Hand #235420267509: {Club #4837790} Tournament #3394929594, €0.13+€0.05+€0.02 EUR Omaha Pot Limit - Level VII (125/250) - 2022/04/11 18:08:02 CET [2022/04/11 12:08:02 ET]
Table '3394929594 1' 6-max Seat #2 is the button
Seat 1: jeje_sat (8906 in chips, €0.05 bounty)
Seat 2: Eyvan972 (6294 in chips, €0.05 bounty)
Seat 3: Reyzous (7085 in chips, €0.05 bounty)
Seat 6: PistoPutin (3185 in chips, €0.07 bounty)
Reyzous: posts small blind 125
PistoPutin: posts big blind 250
*** HOLE CARDS ***
Dealt to jeje_sat [7d 8c Jh 2s]
jeje_sat: folds
Eyvan972: folds
Reyzous: calls 125
PistoPutin: checks
*** FLOP *** [Ad 9s 4s]
Reyzous: bets 250
PistoPutin: folds
Uncalled bet (250) returned to Reyzous
Reyzous collected 500 from pot
Reyzous: doesn't show hand
*** SUMMARY ***
Total pot 500 | Rake 0
Board [Ad 9s 4s]
Seat 1: jeje_sat folded before Flop (didn't bet)
Seat 2: Eyvan972 (button) folded before Flop (didn't bet)
Seat 3: Reyzous (small blind) collected (500)
Seat 6: PistoPutin (big blind) folded on the Flop


PokerStars Home Game Hand #235420275789: {Club #4837790} Tournament #3394929594, €0.13+€0.05+€0.02 EUR Omaha Pot Limit - Level VII (125/250) - 2022/04/11 18:08:28 CET [2022/04/11 12:08:28 ET]
Table '3394929594 1' 6-max Seat #3 is the button
Seat 1: jeje_sat (8906 in chips, €0.05 bounty)
Seat 2: Eyvan972 (6294 in chips, €0.05 bounty)
Seat 3: Reyzous (7335 in chips, €0.05 bounty)
Seat 6: PistoPutin (2935 in chips, €0.07 bounty)
PistoPutin: posts small blind 125
jeje_sat: posts big blind 250
*** HOLE CARDS ***
Dealt to jeje_sat [3d Qs 7s 5c]
Eyvan972: folds
Reyzous: raises 300 to 550
PistoPutin: folds
jeje_sat: folds
Uncalled bet (300) returned to Reyzous
Reyzous collected 625 from pot
Reyzous: doesn't show hand
*** SUMMARY ***
Total pot 625 | Rake 0
Seat 1: jeje_sat (big blind) folded before Flop
Seat 2: Eyvan972 folded before Flop (didn't bet)
Seat 3: Reyzous (button) collected (625)
Seat 6: PistoPutin (small blind) folded before Flop


PokerStars Home Game Hand #235420282177: {Club #4837790} Tournament #3394929594, €0.13+€0.05+€0.02 EUR Omaha Pot Limit - Level VII (125/250) - 2022/04/11 18:08:48 CET [2022/04/11 12:08:48 ET]
Table '3394929594 1' 6-max Seat #6 is the button
Seat 1: jeje_sat (8656 in chips, €0.05 bounty)
Seat 2: Eyvan972 (6294 in chips, €0.05 bounty)
Seat 3: Reyzous (7710 in chips, €0.05 bounty)
Seat 6: PistoPutin (2810 in chips, €0.07 bounty)
jeje_sat: posts small blind 125
Eyvan972: posts big blind 250
*** HOLE CARDS ***
Dealt to jeje_sat [Ts 8c 6c 2h]
Reyzous: folds
PistoPutin: folds
jeje_sat: folds
Uncalled bet (125) returned to Eyvan972
Eyvan972 collected 250 from pot
Eyvan972: doesn't show hand
*** SUMMARY ***
Total pot 250 | Rake 0
Seat 1: jeje_sat (small blind) folded before Flop
Seat 2: Eyvan972 (big blind) collected (250)
Seat 3: Reyzous folded before Flop (didn't bet)
Seat 6: PistoPutin (button) folded before Flop (didn't bet)


PokerStars Home Game Hand #235420290495: {Club #4837790} Tournament #3394929594, €0.13+€0.05+€0.02 EUR Omaha Pot Limit - Level VII (125/250) - 2022/04/11 18:09:14 CET [2022/04/11 12:09:14 ET]
Table '3394929594 1' 6-max Seat #1 is the button
Seat 1: jeje_sat (8531 in chips, €0.05 bounty)
Seat 2: Eyvan972 (6419 in chips, €0.05 bounty)
Seat 3: Reyzous (7710 in chips, €0.05 bounty)
Seat 6: PistoPutin (2810 in chips, €0.07 bounty)
Eyvan972: posts small blind 125
Reyzous: posts big blind 250
*** HOLE CARDS ***
Dealt to jeje_sat [Jh 2s 3h Kh]
PistoPutin: folds
jeje_sat: raises 625 to 875
Eyvan972: raises 2000 to 2875
Reyzous: folds
jeje_sat: calls 2000
*** FLOP *** [5s 2c 4s]
Eyvan972: bets 3544 and is all-in
jeje_sat: calls 3544
*** TURN *** [5s 2c 4s] [9d]
*** RIVER *** [5s 2c 4s 9d] [9h]
*** SHOW DOWN ***
Eyvan972: shows [Ts 8h Qh 7s] (a pair of Nines)
jeje_sat: shows [Jh 2s 3h Kh] (two pair, Nines and Deuces)
jeje_sat collected 13088 from pot
jeje_sat wins €0.03 for eliminating Eyvan972 and their own bounty increases by €0.02 to €0.07
Eyvan972 finished the tournament in 9th place
*** SUMMARY ***
Total pot 13088 | Rake 0
Board [5s 2c 4s 9d 9h]
Seat 1: jeje_sat (button) showed [Jh 2s 3h Kh] and won (13088) with two pair, Nines and Deuces
Seat 2: Eyvan972 (small blind) showed [Ts 8h Qh 7s] and lost with a pair of Nines
Seat 3: Reyzous (big blind) folded before Flop
Seat 6: PistoPutin folded before Flop (didn't bet)


PokerStars Home Game Hand #235420301023: {Club #4837790} Tournament #3394929594, €0.13+€0.05+€0.02 EUR Omaha Pot Limit - Level VII (125/250) - 2022/04/11 18:09:47 CET [2022/04/11 12:09:47 ET]
Table '3394929594 1' 6-max Seat #3 is the button
Seat 1: jeje_sat (15200 in chips, €0.07 bounty)
Seat 3: Reyzous (7460 in chips, €0.05 bounty)
Seat 6: PistoPutin (2810 in chips, €0.07 bounty)
PistoPutin: posts small blind 125
jeje_sat: posts big blind 250
*** HOLE CARDS ***
Dealt to jeje_sat [4h 6h Jd Kc]
Reyzous: folds
PistoPutin: folds
Uncalled bet (125) returned to jeje_sat
jeje_sat collected 250 from pot
jeje_sat: doesn't show hand
*** SUMMARY ***
Total pot 250 | Rake 0
Seat 1: jeje_sat (big blind) collected (250)
Seat 3: Reyzous (button) folded before Flop (didn't bet)
Seat 6: PistoPutin (small blind) folded before Flop


PokerStars Home Game Hand #235420304455: {Club #4837790} Tournament #3394929594, €0.13+€0.05+€0.02 EUR Omaha Pot Limit - Level VII (125/250) - 2022/04/11 18:09:58 CET [2022/04/11 12:09:58 ET]
Table '3394929594 1' 6-max Seat #6 is the button
Seat 1: jeje_sat (15325 in chips, €0.07 bounty)
Seat 3: Reyzous (7460 in chips, €0.05 bounty)
Seat 6: PistoPutin (2685 in chips, €0.07 bounty)
jeje_sat: posts small blind 125
Reyzous: posts big blind 250
*** HOLE CARDS ***
Dealt to jeje_sat [4s 4c Td 4d]
PistoPutin: folds
jeje_sat: folds
Uncalled bet (125) returned to Reyzous
Reyzous collected 250 from pot
Reyzous: doesn't show hand
*** SUMMARY ***
Total pot 250 | Rake 0
Seat 1: jeje_sat (small blind) folded before Flop
Seat 3: Reyzous (big blind) collected (250)
Seat 6: PistoPutin (button) folded before Flop (didn't bet)


PokerStars Home Game Hand #235420306806: {Club #4837790} Tournament #3394929594, €0.13+€0.05+€0.02 EUR Omaha Pot Limit - Level VII (125/250) - 2022/04/11 18:10:05 CET [2022/04/11 12:10:05 ET]
Table '3394929594 1' 6-max Seat #1 is the button
Seat 1: jeje_sat (15200 in chips, €0.07 bounty)
Seat 3: Reyzous (7585 in chips, €0.05 bounty)
Seat 6: PistoPutin (2685 in chips, €0.07 bounty)
Reyzous: posts small blind 125
PistoPutin: posts big blind 250
*** HOLE CARDS ***
Dealt to jeje_sat [7s 5s 9c 3c]
jeje_sat: raises 625 to 875
Reyzous: folds
PistoPutin: folds
Uncalled bet (625) returned to jeje_sat
jeje_sat collected 625 from pot
jeje_sat: doesn't show hand
*** SUMMARY ***
Total pot 625 | Rake 0
Seat 1: jeje_sat (button) collected (625)
Seat 3: Reyzous (small blind) folded before Flop
Seat 6: PistoPutin (big blind) folded before Flop


PokerStars Home Game Hand #235420311459: {Club #4837790} Tournament #3394929594, €0.13+€0.05+€0.02 EUR Omaha Pot Limit - Level VII (125/250) - 2022/04/11 18:10:20 CET [2022/04/11 12:10:20 ET]
Table '3394929594 1' 6-max Seat #3 is the button
Seat 1: jeje_sat (15575 in chips, €0.07 bounty)
Seat 3: Reyzous (7460 in chips, €0.05 bounty)
Seat 4: NHBROOO (13411 in chips) out of hand (moved from another table into small blind)
Seat 6: PistoPutin (2435 in chips, €0.07 bounty)
NHBROOO will be allowed to play after the button
PistoPutin: posts small blind 125
jeje_sat: posts big blind 250
*** HOLE CARDS ***
Dealt to jeje_sat [4s Ts 9s Kd]
Reyzous: folds
PistoPutin: folds
Uncalled bet (125) returned to jeje_sat
jeje_sat collected 250 from pot
jeje_sat: doesn't show hand
*** SUMMARY ***
Total pot 250 | Rake 0
Seat 1: jeje_sat (big blind) collected (250)
Seat 3: Reyzous (button) folded before Flop (didn't bet)
Seat 6: PistoPutin (small blind) folded before Flop


PokerStars Home Game Hand #235420313984: {Club #4837790} Tournament #3394929594, €0.13+€0.05+€0.02 EUR Omaha Pot Limit - Level VII (125/250) - 2022/04/11 18:10:27 CET [2022/04/11 12:10:27 ET]
Table '3394929594 1' 6-max Seat #6 is the button
Seat 1: jeje_sat (15700 in chips, €0.07 bounty)
Seat 3: Reyzous (7460 in chips, €0.05 bounty)
Seat 4: NHBROOO (13411 in chips, €0.05 bounty)
Seat 6: PistoPutin (2310 in chips, €0.07 bounty)
jeje_sat: posts small blind 125
Reyzous: posts big blind 250
*** HOLE CARDS ***
Dealt to jeje_sat [Ah Qc Td 2h]
NHBROOO: folds
PistoPutin: folds
jeje_sat: raises 500 to 750
Reyzous: calls 500
*** FLOP *** [3h Ad Ks]
jeje_sat: bets 750
Reyzous: folds
Uncalled bet (750) returned to jeje_sat
jeje_sat collected 1500 from pot
jeje_sat: doesn't show hand
*** SUMMARY ***
Total pot 1500 | Rake 0
Board [3h Ad Ks]
Seat 1: jeje_sat (small blind) collected (1500)
Seat 3: Reyzous (big blind) folded on the Flop
Seat 4: NHBROOO folded before Flop (didn't bet)
Seat 6: PistoPutin (button) folded before Flop (didn't bet)


PokerStars Home Game Hand #235420324196: {Club #4837790} Tournament #3394929594, €0.13+€0.05+€0.02 EUR Omaha Pot Limit - Level VII (125/250) - 2022/04/11 18:11:00 CET [2022/04/11 12:11:00 ET]
Table '3394929594 1' 6-max Seat #1 is the button
Seat 1: jeje_sat (16450 in chips, €0.07 bounty)
Seat 3: Reyzous (6710 in chips, €0.05 bounty)
Seat 4: NHBROOO (13411 in chips, €0.05 bounty)
Seat 6: PistoPutin (2310 in chips, €0.07 bounty)
Reyzous: posts small blind 125
NHBROOO: posts big blind 250
*** HOLE CARDS ***
Dealt to jeje_sat [Tc Js 6d 4d]
PistoPutin: calls 250
jeje_sat: folds
Reyzous: calls 125
NHBROOO: checks
*** FLOP *** [3d Kc As]
Reyzous: checks
NHBROOO: checks
PistoPutin: checks
*** TURN *** [3d Kc As] [6c]
Reyzous: bets 488
NHBROOO: calls 488
PistoPutin: folds
*** RIVER *** [3d Kc As 6c] [8s]
Reyzous: checks
NHBROOO: bets 1726
Reyzous: folds
Uncalled bet (1726) returned to NHBROOO
NHBROOO collected 1726 from pot
NHBROOO: doesn't show hand
*** SUMMARY ***
Total pot 1726 | Rake 0
Board [3d Kc As 6c 8s]
Seat 1: jeje_sat (button) folded before Flop (didn't bet)
Seat 3: Reyzous (small blind) folded on the River
Seat 4: NHBROOO (big blind) collected (1726)
Seat 6: PistoPutin folded on the Turn


PokerStars Home Game Hand #235420350408: {Club #4837790} Tournament #3394929594, €0.13+€0.05+€0.02 EUR Omaha Pot Limit - Level VIII (150/300) - 2022/04/11 18:12:22 CET [2022/04/11 12:12:22 ET]
Table '3394929594 1' 6-max Seat #3 is the button
Seat 1: jeje_sat (16450 in chips, €0.07 bounty)
Seat 3: Reyzous (5972 in chips, €0.05 bounty)
Seat 4: NHBROOO (14399 in chips, €0.05 bounty)
Seat 6: PistoPutin (2060 in chips, €0.07 bounty)
NHBROOO: posts small blind 150
PistoPutin: posts big blind 300
*** HOLE CARDS ***
Dealt to jeje_sat [Ts 4s Js Jd]
Reyzous said, "mouai"
jeje_sat: raises 600 to 900
Reyzous: folds
NHBROOO: folds
NHBROOO said, "lol"
PistoPutin: folds
Uncalled bet (600) returned to jeje_sat
jeje_sat collected 750 from pot
jeje_sat: doesn't show hand
*** SUMMARY ***
Total pot 750 | Rake 0
Seat 1: jeje_sat collected (750)
Seat 3: Reyzous (button) folded before Flop (didn't bet)
Seat 4: NHBROOO (small blind) folded before Flop
Seat 6: PistoPutin (big blind) folded before Flop


PokerStars Home Game Hand #235420360966: {Club #4837790} Tournament #3394929594, €0.13+€0.05+€0.02 EUR Omaha Pot Limit - Level VIII (150/300) - 2022/04/11 18:12:55 CET [2022/04/11 12:12:55 ET]
Table '3394929594 1' 6-max Seat #4 is the button
Seat 1: jeje_sat (16900 in chips, €0.07 bounty)
Seat 3: Reyzous (5972 in chips, €0.05 bounty)
Seat 4: NHBROOO (14249 in chips, €0.05 bounty)
Seat 6: PistoPutin (1760 in chips, €0.07 bounty)
PistoPutin: posts small blind 150
jeje_sat: posts big blind 300
*** HOLE CARDS ***
Dealt to jeje_sat [Th Qd 8h 5d]
Reyzous: raises 300 to 600
NHBROOO: calls 600
PistoPutin: raises 1160 to 1760 and is all-in
jeje_sat: calls 1460
Reyzous: calls 1160
NHBROOO: calls 1160
*** FLOP *** [9s 5s 5h]
Tuche37300 is sitting out
Tuche37300 has returned
jeje_sat: bets 7040
Reyzous: calls 4212 and is all-in
NHBROOO: folds
Uncalled bet (2828) returned to jeje_sat
*** TURN *** [9s 5s 5h] [Jc]
*** RIVER *** [9s 5s 5h Jc] [4h]
*** SHOW DOWN ***
jeje_sat: shows [Th Qd 8h 5d] (three of a kind, Fives)
Reyzous: shows [7s 6c 7d As] (two pair, Sevens and Fives)
jeje_sat collected 8424 from side pot
PistoPutin: shows [7c 6d 8c Ad] (a pair of Fives)
jeje_sat collected 7040 from main pot
*** SUMMARY ***
Total pot 15464 Main pot 7040. Side pot 8424. | Rake 0
Board [9s 5s 5h Jc 4h]
Seat 1: jeje_sat (big blind) showed [Th Qd 8h 5d] and won (15464) with three of a kind, Fives
Seat 3: Reyzous showed [7s 6c 7d As] and lost with two pair, Sevens and Fives
Seat 4: NHBROOO (button) folded on the Flop
Seat 6: PistoPutin (small blind) showed [7c 6d 8c Ad] and lost with a pair of Fives


PokerStars Home Game Hand #235420380735: {Club #4837790} Tournament #3394929594, €0.13+€0.05+€0.02 EUR Omaha Pot Limit - Level VIII (150/300) - 2022/04/11 18:13:56 CET [2022/04/11 12:13:56 ET]
Table '3394929594 1' 6-max Seat #1 is the button
Seat 1: jeje_sat (26392 in chips, €0.12 bounty)
Seat 2: Mariusjacob84 (11934 in chips) out of hand (moved from another table into small blind)
Seat 4: NHBROOO (12489 in chips, €0.05 bounty)
Seat 5: Tuche37300 (9185 in chips, €0.09 bounty)
Mariusjacob84 will be allowed to play after the button
NHBROOO: posts small blind 150
Tuche37300: posts big blind 300
*** HOLE CARDS ***
Dealt to jeje_sat [5s 7h Jd 4d]
jeje_sat: folds
NHBROOO: calls 150
Tuche37300: checks
*** FLOP *** [Ts Th Kh]
NHBROOO: checks
Tuche37300: checks
*** TURN *** [Ts Th Kh] [7c]
NHBROOO: checks
Tuche37300: checks
*** RIVER *** [Ts Th Kh 7c] [5h]
NHBROOO: checks
Tuche37300: checks
*** SHOW DOWN ***
NHBROOO: shows [8s Ah 2c Js] (a pair of Tens)
Tuche37300: mucks hand
NHBROOO collected 600 from pot
*** SUMMARY ***
Total pot 600 | Rake 0
Board [Ts Th Kh 7c 5h]
Seat 1: jeje_sat (button) folded before Flop (didn't bet)
Seat 4: NHBROOO (small blind) showed [8s Ah 2c Js] and won (600) with a pair of Tens
Seat 5: Tuche37300 (big blind) mucked [Qc 6d 8d 3d]


PokerStars Home Game Hand #235420397326: {Club #4837790} Tournament #3394929594, €0.13+€0.05+€0.02 EUR Omaha Pot Limit - Level VIII (150/300) - 2022/04/11 18:14:28 CET [2022/04/11 12:14:28 ET]
Table '3394929594 1' 6-max Seat #4 is the button
Seat 1: jeje_sat (26392 in chips, €0.12 bounty)
Seat 2: Mariusjacob84 (11934 in chips, €0.09 bounty)
Seat 4: NHBROOO (12789 in chips, €0.05 bounty)
Seat 5: Tuche37300 (8885 in chips, €0.09 bounty)
Tuche37300: posts small blind 150
jeje_sat: posts big blind 300
*** HOLE CARDS ***
Dealt to jeje_sat [5h 8h Kc 8c]
Mariusjacob84: folds
NHBROOO: calls 300
Tuche37300: folds
jeje_sat: checks
*** FLOP *** [8s As Ad]
jeje_sat: bets 375
NHBROOO: calls 375
*** TURN *** [8s As Ad] [5s]
jeje_sat: checks
NHBROOO: bets 1050
jeje_sat: calls 1050
*** RIVER *** [8s As Ad 5s] [4s]
jeje_sat: checks
NHBROOO: checks
*** SHOW DOWN ***
jeje_sat: shows [5h 8h Kc 8c] (a full house, Eights full of Aces)
NHBROOO: mucks hand
jeje_sat collected 3600 from pot
*** SUMMARY ***
Total pot 3600 | Rake 0
Board [8s As Ad 5s 4s]
Seat 1: jeje_sat (big blind) showed [5h 8h Kc 8c] and won (3600) with a full house, Eights full of Aces
Seat 2: Mariusjacob84 folded before Flop (didn't bet)
Seat 4: NHBROOO (button) mucked [Ac 3c 2c Js]
Seat 5: Tuche37300 (small blind) folded before Flop


PokerStars Home Game Hand #235420413812: {Club #4837790} Tournament #3394929594, €0.13+€0.05+€0.02 EUR Omaha Pot Limit - Level VIII (150/300) - 2022/04/11 18:15:19 CET [2022/04/11 12:15:19 ET]
Table '3394929594 1' 6-max Seat #5 is the button
Seat 1: jeje_sat (28267 in chips, €0.12 bounty)
Seat 2: Mariusjacob84 (11934 in chips, €0.09 bounty)
Seat 4: NHBROOO (11064 in chips, €0.05 bounty)
Seat 5: Tuche37300 (8735 in chips, €0.09 bounty)
jeje_sat: posts small blind 150
Mariusjacob84: posts big blind 300
*** HOLE CARDS ***
Dealt to jeje_sat [Ah 2s 9c Js]
NHBROOO: folds
Tuche37300: calls 300
jeje_sat: folds
Mariusjacob84: checks
*** FLOP *** [Ad 6c 9h]
Mariusjacob84: checks
Tuche37300: checks
*** TURN *** [Ad 6c 9h] [Ac]
Mariusjacob84: checks
Tuche37300: checks
*** RIVER *** [Ad 6c 9h Ac] [7h]
Mariusjacob84: checks
Tuche37300: bets 750
Mariusjacob84: folds
Uncalled bet (750) returned to Tuche37300
Tuche37300 collected 750 from pot
Tuche37300: doesn't show hand
*** SUMMARY ***
Total pot 750 | Rake 0
Board [Ad 6c 9h Ac 7h]
Seat 1: jeje_sat (small blind) folded before Flop
Seat 2: Mariusjacob84 (big blind) folded on the River
Seat 4: NHBROOO folded before Flop (didn't bet)
Seat 5: Tuche37300 (button) collected (750)


PokerStars Home Game Hand #235420426874: {Club #4837790} Tournament #3394929594, €0.13+€0.05+€0.02 EUR Omaha Pot Limit - Level VIII (150/300) - 2022/04/11 18:16:00 CET [2022/04/11 12:16:00 ET]
Table '3394929594 1' 6-max Seat #1 is the button
Seat 1: jeje_sat (28117 in chips, €0.12 bounty)
Seat 2: Mariusjacob84 (11634 in chips, €0.09 bounty)
Seat 4: NHBROOO (11064 in chips, €0.05 bounty)
Seat 5: Tuche37300 (9185 in chips, €0.09 bounty)
Mariusjacob84: posts small blind 150
NHBROOO: posts big blind 300
*** HOLE CARDS ***
Dealt to jeje_sat [6h 4d 7h 8d]
Tuche37300: folds
jeje_sat: raises 750 to 1050
Mariusjacob84: calls 900
NHBROOO: calls 750
*** FLOP *** [3s Ad 2d]
Mariusjacob84: checks
NHBROOO: checks
jeje_sat: checks
*** TURN *** [3s Ad 2d] [Qd]
Mariusjacob84: checks
NHBROOO: checks
jeje_sat: checks
*** RIVER *** [3s Ad 2d Qd] [Ac]
Mariusjacob84: checks
NHBROOO: checks
jeje_sat: checks
*** SHOW DOWN ***
Mariusjacob84: shows [Th Kc 9c Qc] (two pair, Aces and Queens)
NHBROOO: mucks hand
jeje_sat: shows [6h 4d 7h 8d] (a flush, Ace high)
jeje_sat collected 3150 from pot
*** SUMMARY ***
Total pot 3150 | Rake 0
Board [3s Ad 2d Qd Ac]
Seat 1: jeje_sat (button) showed [6h 4d 7h 8d] and won (3150) with a flush, Ace high
Seat 2: Mariusjacob84 (small blind) showed [Th Kc 9c Qc] and lost with two pair, Aces and Queens
Seat 4: NHBROOO (big blind) mucked [Td 8h 6c 7c]
Seat 5: Tuche37300 folded before Flop (didn't bet)


PokerStars Home Game Hand #235420485532: {Club #4837790} Tournament #3394929594, €0.13+€0.05+€0.02 EUR Omaha Pot Limit - Level IX (200/400) - 2022/04/11 18:19:01 CET [2022/04/11 12:19:01 ET]
Table '3394929594 1' 6-max Seat #2 is the button
Seat 1: jeje_sat (30217 in chips, €0.12 bounty)
Seat 2: Mariusjacob84 (10584 in chips, €0.09 bounty)
Seat 4: NHBROOO (10014 in chips, €0.05 bounty)
Seat 5: Tuche37300 (9185 in chips, €0.09 bounty)
NHBROOO: posts small blind 200
Tuche37300: posts big blind 400
*** HOLE CARDS ***
Dealt to jeje_sat [Ac 6d 4h Ks]
jeje_sat: folds
Mariusjacob84: raises 400 to 800
NHBROOO: calls 600
Tuche37300: calls 400
*** FLOP *** [Jd 2c 2d]
NHBROOO: bets 2400
Tuche37300: raises 5985 to 8385 and is all-in
Mariusjacob84: folds
NHBROOO: folds
Uncalled bet (5985) returned to Tuche37300
Tuche37300 collected 7200 from pot
Tuche37300: doesn't show hand
*** SUMMARY ***
Total pot 7200 | Rake 0
Board [Jd 2c 2d]
Seat 1: jeje_sat folded before Flop (didn't bet)
Seat 2: Mariusjacob84 (button) folded on the Flop
Seat 4: NHBROOO (small blind) folded on the Flop
Seat 5: Tuche37300 (big blind) collected (7200)


PokerStars Home Game Hand #235420496202: {Club #4837790} Tournament #3394929594, €0.13+€0.05+€0.02 EUR Omaha Pot Limit - Level IX (200/400) - 2022/04/11 18:19:35 CET [2022/04/11 12:19:35 ET]
Table '3394929594 1' 6-max Seat #4 is the button
Seat 1: jeje_sat (30217 in chips, €0.12 bounty)
Seat 2: Mariusjacob84 (9784 in chips, €0.09 bounty)
Seat 4: NHBROOO (6814 in chips, €0.05 bounty)
Seat 5: Tuche37300 (13185 in chips, €0.09 bounty)
Tuche37300: posts small blind 200
jeje_sat: posts big blind 400
*** HOLE CARDS ***
Dealt to jeje_sat [Ks 5s Ad 5h]
Mariusjacob84: folds
NHBROOO: calls 400
Tuche37300: folds
jeje_sat: checks
*** FLOP *** [Ah 7d 9c]
jeje_sat: checks
Mariusjacob84 said, "donk bet fold bravo"
NHBROOO: bets 700
jeje_sat: calls 700
*** TURN *** [Ah 7d 9c] [8s]
jeje_sat: checks
NHBROOO: checks
*** RIVER *** [Ah 7d 9c 8s] [Kc]
jeje_sat: checks
NHBROOO: checks
*** SHOW DOWN ***
jeje_sat: shows [Ks 5s Ad 5h] (two pair, Aces and Kings)
NHBROOO: mucks hand
jeje_sat collected 2400 from pot
*** SUMMARY ***
Total pot 2400 | Rake 0
Board [Ah 7d 9c 8s Kc]
Seat 1: jeje_sat (big blind) showed [Ks 5s Ad 5h] and won (2400) with two pair, Aces and Kings
Seat 2: Mariusjacob84 folded before Flop (didn't bet)
Seat 4: NHBROOO (button) mucked [2h 6d 2d Kd]
Seat 5: Tuche37300 (small blind) folded before Flop


PokerStars Home Game Hand #235420514471: {Club #4837790} Tournament #3394929594, €0.13+€0.05+€0.02 EUR Omaha Pot Limit - Level IX (200/400) - 2022/04/11 18:20:32 CET [2022/04/11 12:20:32 ET]
Table '3394929594 1' 6-max Seat #5 is the button
Seat 1: jeje_sat (31517 in chips, €0.12 bounty)
Seat 2: Mariusjacob84 (9784 in chips, €0.09 bounty)
Seat 4: NHBROOO (5714 in chips, €0.05 bounty)
Seat 5: Tuche37300 (12985 in chips, €0.09 bounty)
jeje_sat: posts small blind 200
Mariusjacob84: posts big blind 400
*** HOLE CARDS ***
Dealt to jeje_sat [5d Qh 9d 3s]
NHBROOO: calls 400
Tuche37300: folds
jeje_sat: folds
Mariusjacob84: checks
*** FLOP *** [6d Jd Qc]
Mariusjacob84: bets 400
NHBROOO said, "dsl champion on a pas tous ton niveau extraodrinaire"
NHBROOO: raises 1800 to 2200
Mariusjacob84: raises 5400 to 7600
NHBROOO: calls 3114 and is all-in
Uncalled bet (2286) returned to Mariusjacob84
*** TURN *** [6d Jd Qc] [Kc]
*** RIVER *** [6d Jd Qc Kc] [9s]
*** SHOW DOWN ***
Mariusjacob84: shows [Ts 5s 6h 6s] (three of a kind, Sixes)
NHBROOO: shows [Qd 6c Td 7h] (a straight, Nine to King)
NHBROOO collected 11628 from pot
*** SUMMARY ***
Total pot 11628 | Rake 0
Board [6d Jd Qc Kc 9s]
Seat 1: jeje_sat (small blind) folded before Flop
Seat 2: Mariusjacob84 (big blind) showed [Ts 5s 6h 6s] and lost with three of a kind, Sixes
Seat 4: NHBROOO showed [Qd 6c Td 7h] and won (11628) with a straight, Nine to King
Seat 5: Tuche37300 (button) folded before Flop (didn't bet)


PokerStars Home Game Hand #235420529641: {Club #4837790} Tournament #3394929594, €0.13+€0.05+€0.02 EUR Omaha Pot Limit - Level IX (200/400) - 2022/04/11 18:21:18 CET [2022/04/11 12:21:18 ET]
Table '3394929594 1' 6-max Seat #1 is the button
Seat 1: jeje_sat (31317 in chips, €0.12 bounty)
Seat 2: Mariusjacob84 (4070 in chips, €0.09 bounty)
Seat 4: NHBROOO (11628 in chips, €0.05 bounty)
Seat 5: Tuche37300 (12985 in chips, €0.09 bounty)
Mariusjacob84: posts small blind 200
NHBROOO: posts big blind 400
*** HOLE CARDS ***
Dealt to jeje_sat [Kc 2c 4c Qh]
Tuche37300: folds
jeje_sat: folds
Mariusjacob84 said, "cete pas mechant t'exite pas"
Mariusjacob84: folds
Uncalled bet (200) returned to NHBROOO
NHBROOO collected 400 from pot
NHBROOO: doesn't show hand
*** SUMMARY ***
Total pot 400 | Rake 0
Seat 1: jeje_sat (button) folded before Flop (didn't bet)
Seat 2: Mariusjacob84 (small blind) folded before Flop
Seat 4: NHBROOO (big blind) collected (400)
Seat 5: Tuche37300 folded before Flop (didn't bet)


PokerStars Home Game Hand #235420536463: {Club #4837790} Tournament #3394929594, €0.13+€0.05+€0.02 EUR Omaha Pot Limit - Level IX (200/400) - 2022/04/11 18:21:40 CET [2022/04/11 12:21:40 ET]
Table '3394929594 1' 6-max Seat #2 is the button
Seat 1: jeje_sat (31317 in chips, €0.12 bounty)
Seat 2: Mariusjacob84 (3870 in chips, €0.09 bounty)
Seat 4: NHBROOO (11828 in chips, €0.05 bounty)
Seat 5: Tuche37300 (12985 in chips, €0.09 bounty)
NHBROOO: posts small blind 200
Tuche37300: posts big blind 400
*** HOLE CARDS ***
Dealt to jeje_sat [7d 2d Ah 6c]
jeje_sat: folds
Mariusjacob84: raises 1000 to 1400
NHBROOO said, "c etait pas tres sympas non plus..."
NHBROOO: calls 1200
Tuche37300: folds
*** FLOP *** [4s 8h 6d]
NHBROOO: checks
Mariusjacob84: bets 2470 and is all-in
NHBROOO: calls 2470
*** TURN *** [4s 8h 6d] [5c]
*** RIVER *** [4s 8h 6d 5c] [9c]
*** SHOW DOWN ***
NHBROOO: shows [Th As 2c 6s] (a pair of Sixes)
Mariusjacob84: shows [8c Ac Jd Jh] (a pair of Jacks)
Mariusjacob84 collected 8140 from pot
*** SUMMARY ***
Total pot 8140 | Rake 0
Board [4s 8h 6d 5c 9c]
Seat 1: jeje_sat folded before Flop (didn't bet)
Seat 2: Mariusjacob84 (button) showed [8c Ac Jd Jh] and won (8140) with a pair of Jacks
Seat 4: NHBROOO (small blind) showed [Th As 2c 6s] and lost with a pair of Sixes
Seat 5: Tuche37300 (big blind) folded before Flop


PokerStars Home Game Hand #235420553082: {Club #4837790} Tournament #3394929594, €0.13+€0.05+€0.02 EUR Omaha Pot Limit - Level X (250/500) - 2022/04/11 18:22:30 CET [2022/04/11 12:22:30 ET]
Table '3394929594 1' 6-max Seat #4 is the button
Seat 1: jeje_sat (31317 in chips, €0.12 bounty)
Seat 2: Mariusjacob84 (8140 in chips, €0.09 bounty)
Seat 4: NHBROOO (7958 in chips, €0.05 bounty)
Seat 5: Tuche37300 (12585 in chips, €0.09 bounty)
Tuche37300: posts small blind 250
jeje_sat: posts big blind 500
*** HOLE CARDS ***
Dealt to jeje_sat [Qc 9h Ks 4c]
Mariusjacob84: folds
NHBROOO: calls 500
Tuche37300: calls 250
jeje_sat: checks
*** FLOP *** [7h 9s 4d]
Tuche37300: checks
jeje_sat: checks
NHBROOO: checks
*** TURN *** [7h 9s 4d] [Jc]
Tuche37300: checks
jeje_sat: checks
NHBROOO: checks
*** RIVER *** [7h 9s 4d Jc] [Ah]
Tuche37300: bets 750
jeje_sat: folds
NHBROOO: calls 750
*** SHOW DOWN ***
Tuche37300: shows [7c 3s Ad Kh] (two pair, Aces and Sevens)
NHBROOO: mucks hand
Tuche37300 collected 3000 from pot
*** SUMMARY ***
Total pot 3000 | Rake 0
Board [7h 9s 4d Jc Ah]
Seat 1: jeje_sat (big blind) folded on the River
Seat 2: Mariusjacob84 folded before Flop (didn't bet)
Seat 4: NHBROOO (button) mucked [4s Ts 5d As]
Seat 5: Tuche37300 (small blind) showed [7c 3s Ad Kh] and won (3000) with two pair, Aces and Sevens


PokerStars Home Game Hand #235420574747: {Club #4837790} Tournament #3394929594, €0.13+€0.05+€0.02 EUR Omaha Pot Limit - Level X (250/500) - 2022/04/11 18:23:36 CET [2022/04/11 12:23:36 ET]
Table '3394929594 1' 6-max Seat #5 is the button
Seat 1: jeje_sat (30817 in chips, €0.12 bounty)
Seat 2: Mariusjacob84 (8140 in chips, €0.09 bounty)
Seat 4: NHBROOO (6708 in chips, €0.05 bounty)
Seat 5: Tuche37300 (14335 in chips, €0.09 bounty)
jeje_sat: posts small blind 250
Mariusjacob84: posts big blind 500
*** HOLE CARDS ***
Dealt to jeje_sat [4d Qc 4h Jc]
NHBROOO: calls 500
Tuche37300: folds
jeje_sat: folds
Mariusjacob84: checks
*** FLOP *** [Jd 9s 3c]
Mariusjacob84: checks
NHBROOO: checks
*** TURN *** [Jd 9s 3c] [4s]
Mariusjacob84: checks
NHBROOO: bets 1250
Mariusjacob84: calls 1250
*** RIVER *** [Jd 9s 3c 4s] [Ah]
Mariusjacob84: checks
NHBROOO: checks
*** SHOW DOWN ***
Mariusjacob84: shows [5d Js 8c 7c] (a pair of Jacks)
NHBROOO: shows [Ts As 3s 5s] (two pair, Aces and Threes)
NHBROOO collected 3750 from pot
*** SUMMARY ***
Total pot 3750 | Rake 0
Board [Jd 9s 3c 4s Ah]
Seat 1: jeje_sat (small blind) folded before Flop
Seat 2: Mariusjacob84 (big blind) showed [5d Js 8c 7c] and lost with a pair of Jacks
Seat 4: NHBROOO showed [Ts As 3s 5s] and won (3750) with two pair, Aces and Threes
Seat 5: Tuche37300 (button) folded before Flop (didn't bet)


PokerStars Home Game Hand #235420586863: {Club #4837790} Tournament #3394929594, €0.13+€0.05+€0.02 EUR Omaha Pot Limit - Level X (250/500) - 2022/04/11 18:24:14 CET [2022/04/11 12:24:14 ET]
Table '3394929594 1' 6-max Seat #1 is the button
Seat 1: jeje_sat (30567 in chips, €0.12 bounty)
Seat 2: Mariusjacob84 (6390 in chips, €0.09 bounty)
Seat 4: NHBROOO (8708 in chips, €0.05 bounty)
Seat 5: Tuche37300 (14335 in chips, €0.09 bounty)
Mariusjacob84: posts small blind 250
NHBROOO: posts big blind 500
*** HOLE CARDS ***
Dealt to jeje_sat [Qh Jh Td Qs]
Tuche37300: folds
jeje_sat: raises 1250 to 1750
Mariusjacob84: folds
NHBROOO: calls 1250
*** FLOP *** [Kd 2h Qc]
NHBROOO: checks
jeje_sat: bets 3750
NHBROOO: folds
Uncalled bet (3750) returned to jeje_sat
jeje_sat collected 3750 from pot
jeje_sat: doesn't show hand
*** SUMMARY ***
Total pot 3750 | Rake 0
Board [Kd 2h Qc]
Seat 1: jeje_sat (button) collected (3750)
Seat 2: Mariusjacob84 (small blind) folded before Flop
Seat 4: NHBROOO (big blind) folded on the Flop
Seat 5: Tuche37300 folded before Flop (didn't bet)


PokerStars Home Game Hand #235420602277: {Club #4837790} Tournament #3394929594, €0.13+€0.05+€0.02 EUR Omaha Pot Limit - Level X (250/500) - 2022/04/11 18:25:01 CET [2022/04/11 12:25:01 ET]
Table '3394929594 1' 6-max Seat #2 is the button
Seat 1: jeje_sat (32567 in chips, €0.12 bounty)
Seat 2: Mariusjacob84 (6140 in chips, €0.09 bounty)
Seat 4: NHBROOO (6958 in chips, €0.05 bounty)
Seat 5: Tuche37300 (14335 in chips, €0.09 bounty)
NHBROOO: posts small blind 250
Tuche37300: posts big blind 500
*** HOLE CARDS ***
Dealt to jeje_sat [Jd 8h Th 7d]
jeje_sat: raises 1250 to 1750
Mariusjacob84: folds
NHBROOO: folds
Tuche37300: folds
Uncalled bet (1250) returned to jeje_sat
jeje_sat collected 1250 from pot
jeje_sat: doesn't show hand
*** SUMMARY ***
Total pot 1250 | Rake 0
Seat 1: jeje_sat collected (1250)
Seat 2: Mariusjacob84 (button) folded before Flop (didn't bet)
Seat 4: NHBROOO (small blind) folded before Flop
Seat 5: Tuche37300 (big blind) folded before Flop


PokerStars Home Game Hand #235420611643: {Club #4837790} Tournament #3394929594, €0.13+€0.05+€0.02 EUR Omaha Pot Limit - Level X (250/500) - 2022/04/11 18:25:29 CET [2022/04/11 12:25:29 ET]
Table '3394929594 1' 6-max Seat #4 is the button
Seat 1: jeje_sat (33317 in chips, €0.12 bounty)
Seat 2: Mariusjacob84 (6140 in chips, €0.09 bounty)
Seat 4: NHBROOO (6708 in chips, €0.05 bounty)
Seat 5: Tuche37300 (13835 in chips, €0.09 bounty)
Tuche37300: posts small blind 250
jeje_sat: posts big blind 500
*** HOLE CARDS ***
Dealt to jeje_sat [7d As Jh 7s]
Mariusjacob84: folds
NHBROOO: folds
Tuche37300: calls 250
jeje_sat: checks
*** FLOP *** [Kh Ks Tc]
Tuche37300: checks
jeje_sat: checks
*** TURN *** [Kh Ks Tc] [4h]
Tuche37300: checks
jeje_sat: checks
*** RIVER *** [Kh Ks Tc 4h] [5d]
Tuche37300: checks
jeje_sat: checks
*** SHOW DOWN ***
Tuche37300: shows [7h Ad 6c Jd] (a pair of Kings)
jeje_sat: shows [7d As Jh 7s] (two pair, Kings and Sevens)
jeje_sat collected 1000 from pot
*** SUMMARY ***
Total pot 1000 | Rake 0
Board [Kh Ks Tc 4h 5d]
Seat 1: jeje_sat (big blind) showed [7d As Jh 7s] and won (1000) with two pair, Kings and Sevens
Seat 2: Mariusjacob84 folded before Flop (didn't bet)
Seat 4: NHBROOO (button) folded before Flop (didn't bet)
Seat 5: Tuche37300 (small blind) showed [7h Ad 6c Jd] and lost with a pair of Kings


PokerStars Home Game Hand #235420629514: {Club #4837790} Tournament #3394929594, €0.13+€0.05+€0.02 EUR Omaha Pot Limit - Level X (250/500) - 2022/04/11 18:26:23 CET [2022/04/11 12:26:23 ET]
Table '3394929594 1' 6-max Seat #5 is the button
Seat 1: jeje_sat (33817 in chips, €0.12 bounty)
Seat 2: Mariusjacob84 (6140 in chips, €0.09 bounty)
Seat 4: NHBROOO (6708 in chips, €0.05 bounty)
Seat 5: Tuche37300 (13335 in chips, €0.09 bounty)
jeje_sat: posts small blind 250
Mariusjacob84: posts big blind 500
*** HOLE CARDS ***
Dealt to jeje_sat [3s 6h Qc 9c]
NHBROOO: calls 500
Tuche37300: raises 1750 to 2250
jeje_sat: folds
Mariusjacob84: raises 3890 to 6140 and is all-in
NHBROOO: raises 568 to 6708 and is all-in
Tuche37300: calls 4458
*** FLOP *** [4c 3c 2d]
*** TURN *** [4c 3c 2d] [2c]
*** RIVER *** [4c 3c 2d 2c] [Kd]
*** SHOW DOWN ***
NHBROOO: shows [Td Jd 5c 5h] (two pair, Fives and Deuces)
Tuche37300: shows [Th 2s Kc Kh] (a full house, Kings full of Deuces)
Tuche37300 collected 1136 from side pot
Mariusjacob84: shows [Qs 7c Qd 6d] (two pair, Queens and Deuces)
Tuche37300 collected 18670 from main pot
Tuche37300 wins €0.05 for eliminating Mariusjacob84 and their own bounty increases by €0.04 to €0.13
Tuche37300 wins €0.03 for eliminating NHBROOO and their own bounty increases by €0.02 to €0.15
NHBROOO finished the tournament in 3rd place and received €0.31.
Mariusjacob84 finished the tournament in 4th place
*** SUMMARY ***
Total pot 19806 Main pot 18670. Side pot 1136. | Rake 0
Board [4c 3c 2d 2c Kd]
Seat 1: jeje_sat (small blind) folded before Flop
Seat 2: Mariusjacob84 (big blind) showed [Qs 7c Qd 6d] and lost with two pair, Queens and Deuces
Seat 4: NHBROOO showed [Td Jd 5c 5h] and lost with two pair, Fives and Deuces
Seat 5: Tuche37300 (button) showed [Th 2s Kc Kh] and won (19806) with a full house, Kings full of Deuces


PokerStars Home Game Hand #235420643475: {Club #4837790} Tournament #3394929594, €0.13+€0.05+€0.02 EUR Omaha Pot Limit - Level XI (300/600) - 2022/04/11 18:27:04 CET [2022/04/11 12:27:04 ET]
Table '3394929594 1' 6-max Seat #1 is the button
Seat 1: jeje_sat (33567 in chips, €0.12 bounty)
Seat 5: Tuche37300 (26433 in chips, €0.15 bounty)
jeje_sat: posts small blind 300
Tuche37300: posts big blind 600
*** HOLE CARDS ***
Dealt to jeje_sat [Ac 5d 9h 3d]
jeje_sat: folds
Uncalled bet (300) returned to Tuche37300
Tuche37300 collected 600 from pot
Tuche37300: doesn't show hand
*** SUMMARY ***
Total pot 600 | Rake 0
Seat 1: jeje_sat (button) (small blind) folded before Flop
Seat 5: Tuche37300 (big blind) collected (600)


PokerStars Home Game Hand #235420646472: {Club #4837790} Tournament #3394929594, €0.13+€0.05+€0.02 EUR Omaha Pot Limit - Level XI (300/600) - 2022/04/11 18:27:13 CET [2022/04/11 12:27:13 ET]
Table '3394929594 1' 6-max Seat #5 is the button
Seat 1: jeje_sat (33267 in chips, €0.12 bounty)
Seat 5: Tuche37300 (26733 in chips, €0.15 bounty)
Tuche37300: posts small blind 300
jeje_sat: posts big blind 600
*** HOLE CARDS ***
Dealt to jeje_sat [9s Td Qc 5c]
Tuche37300: raises 1200 to 1800
jeje_sat: calls 1200
*** FLOP *** [3s 7s 4c]
jeje_sat: checks
Tuche37300: bets 3600
jeje_sat: folds
Uncalled bet (3600) returned to Tuche37300
Tuche37300 collected 3600 from pot
Tuche37300: doesn't show hand
*** SUMMARY ***
Total pot 3600 | Rake 0
Board [3s 7s 4c]
Seat 1: jeje_sat (big blind) folded on the Flop
Seat 5: Tuche37300 (button) (small blind) collected (3600)


PokerStars Home Game Hand #235420652323: {Club #4837790} Tournament #3394929594, €0.13+€0.05+€0.02 EUR Omaha Pot Limit - Level XI (300/600) - 2022/04/11 18:27:30 CET [2022/04/11 12:27:30 ET]
Table '3394929594 1' 6-max Seat #1 is the button
Seat 1: jeje_sat (31467 in chips, €0.12 bounty)
Seat 5: Tuche37300 (28533 in chips, €0.15 bounty)
jeje_sat: posts small blind 300
Tuche37300: posts big blind 600
*** HOLE CARDS ***
Dealt to jeje_sat [Kd As Kc 8d]
jeje_sat: raises 1200 to 1800
Tuche37300: folds
Uncalled bet (1200) returned to jeje_sat
jeje_sat collected 1200 from pot
jeje_sat: doesn't show hand
*** SUMMARY ***
Total pot 1200 | Rake 0
Seat 1: jeje_sat (button) (small blind) collected (1200)
Seat 5: Tuche37300 (big blind) folded before Flop


PokerStars Home Game Hand #235420657167: {Club #4837790} Tournament #3394929594, €0.13+€0.05+€0.02 EUR Omaha Pot Limit - Level XI (300/600) - 2022/04/11 18:27:45 CET [2022/04/11 12:27:45 ET]
Table '3394929594 1' 6-max Seat #5 is the button
Seat 1: jeje_sat (32067 in chips, €0.12 bounty)
Seat 5: Tuche37300 (27933 in chips, €0.15 bounty)
Tuche37300: posts small blind 300
jeje_sat: posts big blind 600
*** HOLE CARDS ***
Dealt to jeje_sat [5s 5d Ac 8h]
Tuche37300: calls 300
jeje_sat: checks
*** FLOP *** [8d 4d 4s]
jeje_sat: checks
Tuche37300: bets 1200
jeje_sat: folds
Uncalled bet (1200) returned to Tuche37300
Tuche37300 collected 1200 from pot
Tuche37300: doesn't show hand
*** SUMMARY ***
Total pot 1200 | Rake 0
Board [8d 4d 4s]
Seat 1: jeje_sat (big blind) folded on the Flop
Seat 5: Tuche37300 (button) (small blind) collected (1200)


PokerStars Home Game Hand #235420667707: {Club #4837790} Tournament #3394929594, €0.13+€0.05+€0.02 EUR Omaha Pot Limit - Level XI (300/600) - 2022/04/11 18:28:16 CET [2022/04/11 12:28:16 ET]
Table '3394929594 1' 6-max Seat #1 is the button
Seat 1: jeje_sat (31467 in chips, €0.12 bounty)
Seat 5: Tuche37300 (28533 in chips, €0.15 bounty)
jeje_sat: posts small blind 300
Tuche37300: posts big blind 600
*** HOLE CARDS ***
Dealt to jeje_sat [2h 2s Qc 4c]
jeje_sat: folds
Uncalled bet (300) returned to Tuche37300
Tuche37300 collected 600 from pot
Tuche37300: doesn't show hand
*** SUMMARY ***
Total pot 600 | Rake 0
Seat 1: jeje_sat (button) (small blind) folded before Flop
Seat 5: Tuche37300 (big blind) collected (600)


PokerStars Home Game Hand #235420670461: {Club #4837790} Tournament #3394929594, €0.13+€0.05+€0.02 EUR Omaha Pot Limit - Level XI (300/600) - 2022/04/11 18:28:24 CET [2022/04/11 12:28:24 ET]
Table '3394929594 1' 6-max Seat #5 is the button
Seat 1: jeje_sat (31167 in chips, €0.12 bounty)
Seat 5: Tuche37300 (28833 in chips, €0.15 bounty)
Tuche37300: posts small blind 300
jeje_sat: posts big blind 600
*** HOLE CARDS ***
Dealt to jeje_sat [7c 8s 6d Kc]
Tuche37300: calls 300
jeje_sat: checks
*** FLOP *** [Jh 9c 3s]
jeje_sat: checks
Tuche37300 said, "GL"
Tuche37300: bets 600
jeje_sat: folds
Uncalled bet (600) returned to Tuche37300
Tuche37300 collected 1200 from pot
Tuche37300: doesn't show hand
*** SUMMARY ***
Total pot 1200 | Rake 0
Board [Jh 9c 3s]
Seat 1: jeje_sat (big blind) folded on the Flop
Seat 5: Tuche37300 (button) (small blind) collected (1200)


PokerStars Home Game Hand #235420680556: {Club #4837790} Tournament #3394929594, €0.13+€0.05+€0.02 EUR Omaha Pot Limit - Level XI (300/600) - 2022/04/11 18:28:54 CET [2022/04/11 12:28:54 ET]
Table '3394929594 1' 6-max Seat #1 is the button
Seat 1: jeje_sat (30567 in chips, €0.12 bounty)
Seat 5: Tuche37300 (29433 in chips, €0.15 bounty)
jeje_sat: posts small blind 300
Tuche37300: posts big blind 600
*** HOLE CARDS ***
Dealt to jeje_sat [Ad 5s 9h 2c]
jeje_sat: folds
Uncalled bet (300) returned to Tuche37300
Tuche37300 collected 600 from pot
Tuche37300: doesn't show hand
*** SUMMARY ***
Total pot 600 | Rake 0
Seat 1: jeje_sat (button) (small blind) folded before Flop
Seat 5: Tuche37300 (big blind) collected (600)


PokerStars Home Game Hand #235420684949: {Club #4837790} Tournament #3394929594, €0.13+€0.05+€0.02 EUR Omaha Pot Limit - Level XI (300/600) - 2022/04/11 18:29:07 CET [2022/04/11 12:29:07 ET]
Table '3394929594 1' 6-max Seat #5 is the button
Seat 1: jeje_sat (30267 in chips, €0.12 bounty)
Seat 5: Tuche37300 (29733 in chips, €0.15 bounty)
Tuche37300: posts small blind 300
jeje_sat: posts big blind 600
*** HOLE CARDS ***
Dealt to jeje_sat [5d 9s Ah 9h]
Tuche37300: calls 300
jeje_sat: checks
*** FLOP *** [4c Qh 7s]
jeje_sat: checks
Tuche37300: bets 600
jeje_sat: folds
Uncalled bet (600) returned to Tuche37300
Tuche37300 collected 1200 from pot
Tuche37300: doesn't show hand
*** SUMMARY ***
Total pot 1200 | Rake 0
Board [4c Qh 7s]
Seat 1: jeje_sat (big blind) folded on the Flop
Seat 5: Tuche37300 (button) (small blind) collected (1200)


PokerStars Home Game Hand #235420700971: {Club #4837790} Tournament #3394929594, €0.13+€0.05+€0.02 EUR Omaha Pot Limit - Level XI (300/600) - 2022/04/11 18:29:55 CET [2022/04/11 12:29:55 ET]
Table '3394929594 1' 6-max Seat #1 is the button
Seat 1: jeje_sat (29667 in chips, €0.12 bounty)
Seat 5: Tuche37300 (30333 in chips, €0.15 bounty)
jeje_sat: posts small blind 300
Tuche37300: posts big blind 600
*** HOLE CARDS ***
Dealt to jeje_sat [6c Qs 2s Ah]
jeje_sat: raises 1200 to 1800
Tuche37300: folds
Uncalled bet (1200) returned to jeje_sat
jeje_sat collected 1200 from pot
jeje_sat: doesn't show hand
*** SUMMARY ***
Total pot 1200 | Rake 0
Seat 1: jeje_sat (button) (small blind) collected (1200)
Seat 5: Tuche37300 (big blind) folded before Flop


PokerStars Home Game Hand #235420706867: {Club #4837790} Tournament #3394929594, €0.13+€0.05+€0.02 EUR Omaha Pot Limit - Level XI (300/600) - 2022/04/11 18:30:11 CET [2022/04/11 12:30:11 ET]
Table '3394929594 1' 6-max Seat #5 is the button
Seat 1: jeje_sat (30267 in chips, €0.12 bounty)
Seat 5: Tuche37300 (29733 in chips, €0.15 bounty)
Tuche37300: posts small blind 300
jeje_sat: posts big blind 600
*** HOLE CARDS ***
Dealt to jeje_sat [6s 7h Qs Ac]
Tuche37300: raises 1200 to 1800
jeje_sat: folds
Uncalled bet (1200) returned to Tuche37300
Tuche37300 collected 1200 from pot
Tuche37300: doesn't show hand
*** SUMMARY ***
Total pot 1200 | Rake 0
Seat 1: jeje_sat (big blind) folded before Flop
Seat 5: Tuche37300 (button) (small blind) collected (1200)


PokerStars Home Game Hand #235420711519: {Club #4837790} Tournament #3394929594, €0.13+€0.05+€0.02 EUR Omaha Pot Limit - Level XI (300/600) - 2022/04/11 18:30:25 CET [2022/04/11 12:30:25 ET]
Table '3394929594 1' 6-max Seat #1 is the button
Seat 1: jeje_sat (29667 in chips, €0.12 bounty)
Seat 5: Tuche37300 (30333 in chips, €0.15 bounty)
jeje_sat: posts small blind 300
Tuche37300: posts big blind 600
*** HOLE CARDS ***
Dealt to jeje_sat [Kd Ks 3c 8d]
jeje_sat: raises 1200 to 1800
Tuche37300: calls 1200
*** FLOP *** [3s 6c 8c]
Tuche37300: checks
jeje_sat: bets 1800
Tuche37300: folds
Uncalled bet (1800) returned to jeje_sat
jeje_sat collected 3600 from pot
jeje_sat: doesn't show hand
*** SUMMARY ***
Total pot 3600 | Rake 0
Board [3s 6c 8c]
Seat 1: jeje_sat (button) (small blind) collected (3600)
Seat 5: Tuche37300 (big blind) folded on the Flop


PokerStars Home Game Hand #235420722915: {Club #4837790} Tournament #3394929594, €0.13+€0.05+€0.02 EUR Omaha Pot Limit - Level XI (300/600) - 2022/04/11 18:30:58 CET [2022/04/11 12:30:58 ET]
Table '3394929594 1' 6-max Seat #5 is the button
Seat 1: jeje_sat (31467 in chips, €0.12 bounty)
Seat 5: Tuche37300 (28533 in chips, €0.15 bounty)
Tuche37300: posts small blind 300
jeje_sat: posts big blind 600
*** HOLE CARDS ***
Dealt to jeje_sat [Ad 7c 2s Ts]
Tuche37300: raises 1200 to 1800
jeje_sat: folds
Uncalled bet (1200) returned to Tuche37300
Tuche37300 collected 1200 from pot
Tuche37300: doesn't show hand
*** SUMMARY ***
Total pot 1200 | Rake 0
Seat 1: jeje_sat (big blind) folded before Flop
Seat 5: Tuche37300 (button) (small blind) collected (1200)


PokerStars Home Game Hand #235420726384: {Club #4837790} Tournament #3394929594, €0.13+€0.05+€0.02 EUR Omaha Pot Limit - Level XI (300/600) - 2022/04/11 18:31:08 CET [2022/04/11 12:31:08 ET]
Table '3394929594 1' 6-max Seat #1 is the button
Seat 1: jeje_sat (30867 in chips, €0.12 bounty)
Seat 5: Tuche37300 (29133 in chips, €0.15 bounty)
jeje_sat: posts small blind 300
Tuche37300: posts big blind 600
*** HOLE CARDS ***
Dealt to jeje_sat [7s Td 7d Ah]
jeje_sat: raises 1200 to 1800
Tuche37300: calls 1200
*** FLOP *** [8c Js 7c]
Tuche37300: bets 600
jeje_sat: calls 600
*** TURN *** [8c Js 7c] [4s]
Tuche37300: bets 2400
jeje_sat: calls 2400
*** RIVER *** [8c Js 7c 4s] [Jh]
Tuche37300: bets 4800
jeje_sat: raises 19200 to 24000
Tuche37300 said, "9 10??? me dit pas ca mdr"
Tuche37300: folds
Uncalled bet (19200) returned to jeje_sat
jeje_sat collected 19200 from pot
jeje_sat: doesn't show hand
*** SUMMARY ***
Total pot 19200 | Rake 0
Board [8c Js 7c 4s Jh]
Seat 1: jeje_sat (button) (small blind) collected (19200)
Seat 5: Tuche37300 (big blind) folded on the River


PokerStars Home Game Hand #235420744496: {Club #4837790} Tournament #3394929594, €0.13+€0.05+€0.02 EUR Omaha Pot Limit - Level XII (350/700) - 2022/04/11 18:32:01 CET [2022/04/11 12:32:01 ET]
Table '3394929594 1' 6-max Seat #5 is the button
Seat 1: jeje_sat (40467 in chips, €0.12 bounty)
Seat 5: Tuche37300 (19533 in chips, €0.15 bounty)
Tuche37300: posts small blind 350
jeje_sat: posts big blind 700
*** HOLE CARDS ***
Dealt to jeje_sat [6s 8c 3h 8d]
Tuche37300 said, "profite"
Tuche37300 said, "mdr"
Tuche37300: calls 350
jeje_sat: checks
*** FLOP *** [8h 3d 5s]
jeje_sat: bets 1400
Tuche37300: folds
Uncalled bet (1400) returned to jeje_sat
jeje_sat collected 1400 from pot
jeje_sat: doesn't show hand
*** SUMMARY ***
Total pot 1400 | Rake 0
Board [8h 3d 5s]
Seat 1: jeje_sat (big blind) collected (1400)
Seat 5: Tuche37300 (button) (small blind) folded on the Flop


PokerStars Home Game Hand #235420754443: {Club #4837790} Tournament #3394929594, €0.13+€0.05+€0.02 EUR Omaha Pot Limit - Level XII (350/700) - 2022/04/11 18:32:29 CET [2022/04/11 12:32:29 ET]
Table '3394929594 1' 6-max Seat #1 is the button
Seat 1: jeje_sat (41167 in chips, €0.12 bounty)
Seat 5: Tuche37300 (18833 in chips, €0.15 bounty)
jeje_sat: posts small blind 350
Tuche37300: posts big blind 700
*** HOLE CARDS ***
Dealt to jeje_sat [Qc 3h Qh 8d]
jeje_sat: raises 1400 to 2100
Tuche37300: folds
Uncalled bet (1400) returned to jeje_sat
jeje_sat collected 1400 from pot
jeje_sat: doesn't show hand
*** SUMMARY ***
Total pot 1400 | Rake 0
Seat 1: jeje_sat (button) (small blind) collected (1400)
Seat 5: Tuche37300 (big blind) folded before Flop


PokerStars Home Game Hand #235420757682: {Club #4837790} Tournament #3394929594, €0.13+€0.05+€0.02 EUR Omaha Pot Limit - Level XII (350/700) - 2022/04/11 18:32:39 CET [2022/04/11 12:32:39 ET]
Table '3394929594 1' 6-max Seat #5 is the button
Seat 1: jeje_sat (41867 in chips, €0.12 bounty)
Seat 5: Tuche37300 (18133 in chips, €0.15 bounty)
Tuche37300: posts small blind 350
jeje_sat: posts big blind 700
*** HOLE CARDS ***
Dealt to jeje_sat [Tc Ad 9d 9h]
Tuche37300: folds
Uncalled bet (350) returned to jeje_sat
jeje_sat collected 700 from pot
jeje_sat: doesn't show hand
*** SUMMARY ***
Total pot 700 | Rake 0
Seat 1: jeje_sat (big blind) collected (700)
Seat 5: Tuche37300 (button) (small blind) folded before Flop


PokerStars Home Game Hand #235420759807: {Club #4837790} Tournament #3394929594, €0.13+€0.05+€0.02 EUR Omaha Pot Limit - Level XII (350/700) - 2022/04/11 18:32:45 CET [2022/04/11 12:32:45 ET]
Table '3394929594 1' 6-max Seat #1 is the button
Seat 1: jeje_sat (42217 in chips, €0.12 bounty)
Seat 5: Tuche37300 (17783 in chips, €0.15 bounty)
jeje_sat: posts small blind 350
Tuche37300: posts big blind 700
*** HOLE CARDS ***
Dealt to jeje_sat [Kd 4c Jc Kh]
jeje_sat: raises 1400 to 2100
Tuche37300: folds
Uncalled bet (1400) returned to jeje_sat
jeje_sat collected 1400 from pot
jeje_sat: doesn't show hand
*** SUMMARY ***
Total pot 1400 | Rake 0
Seat 1: jeje_sat (button) (small blind) collected (1400)
Seat 5: Tuche37300 (big blind) folded before Flop


PokerStars Home Game Hand #235420763678: {Club #4837790} Tournament #3394929594, €0.13+€0.05+€0.02 EUR Omaha Pot Limit - Level XII (350/700) - 2022/04/11 18:32:56 CET [2022/04/11 12:32:56 ET]
Table '3394929594 1' 6-max Seat #5 is the button
Seat 1: jeje_sat (42917 in chips, €0.12 bounty)
Seat 5: Tuche37300 (17083 in chips, €0.15 bounty)
Tuche37300: posts small blind 350
jeje_sat: posts big blind 700
*** HOLE CARDS ***
Dealt to jeje_sat [Kc 6c 4d 6s]
Tuche37300: raises 1400 to 2100
jeje_sat: folds
Uncalled bet (1400) returned to Tuche37300
Tuche37300 collected 1400 from pot
Tuche37300: doesn't show hand
*** SUMMARY ***
Total pot 1400 | Rake 0
Seat 1: jeje_sat (big blind) folded before Flop
Seat 5: Tuche37300 (button) (small blind) collected (1400)


PokerStars Home Game Hand #235420766965: {Club #4837790} Tournament #3394929594, €0.13+€0.05+€0.02 EUR Omaha Pot Limit - Level XII (350/700) - 2022/04/11 18:33:05 CET [2022/04/11 12:33:05 ET]
Table '3394929594 1' 6-max Seat #1 is the button
Seat 1: jeje_sat (42217 in chips, €0.12 bounty)
Seat 5: Tuche37300 (17783 in chips, €0.15 bounty)
jeje_sat: posts small blind 350
Tuche37300: posts big blind 700
*** HOLE CARDS ***
Dealt to jeje_sat [Jh Kh 7h 3d]
jeje_sat: raises 1400 to 2100
Tuche37300: calls 1400
*** FLOP *** [6d Ts Js]
Tuche37300: checks
jeje_sat: bets 2100
Tuche37300: folds
Uncalled bet (2100) returned to jeje_sat
jeje_sat collected 4200 from pot
jeje_sat: doesn't show hand
*** SUMMARY ***
Total pot 4200 | Rake 0
Board [6d Ts Js]
Seat 1: jeje_sat (button) (small blind) collected (4200)
Seat 5: Tuche37300 (big blind) folded on the Flop


PokerStars Home Game Hand #235420776665: {Club #4837790} Tournament #3394929594, €0.13+€0.05+€0.02 EUR Omaha Pot Limit - Level XII (350/700) - 2022/04/11 18:33:33 CET [2022/04/11 12:33:33 ET]
Table '3394929594 1' 6-max Seat #5 is the button
Seat 1: jeje_sat (44317 in chips, €0.12 bounty)
Seat 5: Tuche37300 (15683 in chips, €0.15 bounty)
Tuche37300: posts small blind 350
jeje_sat: posts big blind 700
*** HOLE CARDS ***
Dealt to jeje_sat [9s 7h 3d Tc]
Tuche37300: calls 350
jeje_sat: checks
*** FLOP *** [Qd 7c Ts]
jeje_sat: bets 700
Tuche37300: raises 2800 to 3500
jeje_sat: folds
Uncalled bet (2800) returned to Tuche37300
Tuche37300 collected 2800 from pot
Tuche37300: doesn't show hand
*** SUMMARY ***
Total pot 2800 | Rake 0
Board [Qd 7c Ts]
Seat 1: jeje_sat (big blind) folded on the Flop
Seat 5: Tuche37300 (button) (small blind) collected (2800)


PokerStars Home Game Hand #235420783404: {Club #4837790} Tournament #3394929594, €0.13+€0.05+€0.02 EUR Omaha Pot Limit - Level XII (350/700) - 2022/04/11 18:33:52 CET [2022/04/11 12:33:52 ET]
Table '3394929594 1' 6-max Seat #1 is the button
Seat 1: jeje_sat (42917 in chips, €0.12 bounty)
Seat 5: Tuche37300 (17083 in chips, €0.15 bounty)
jeje_sat: posts small blind 350
Tuche37300: posts big blind 700
*** HOLE CARDS ***
Dealt to jeje_sat [Kh 2c Jc Ah]
jeje_sat: raises 1400 to 2100
Tuche37300: folds
Uncalled bet (1400) returned to jeje_sat
jeje_sat collected 1400 from pot
jeje_sat: doesn't show hand
*** SUMMARY ***
Total pot 1400 | Rake 0
Seat 1: jeje_sat (button) (small blind) collected (1400)
Seat 5: Tuche37300 (big blind) folded before Flop


PokerStars Home Game Hand #235420786576: {Club #4837790} Tournament #3394929594, €0.13+€0.05+€0.02 EUR Omaha Pot Limit - Level XII (350/700) - 2022/04/11 18:34:01 CET [2022/04/11 12:34:01 ET]
Table '3394929594 1' 6-max Seat #5 is the button
Seat 1: jeje_sat (43617 in chips, €0.12 bounty)
Seat 5: Tuche37300 (16383 in chips, €0.15 bounty)
Tuche37300: posts small blind 350
jeje_sat: posts big blind 700
*** HOLE CARDS ***
Dealt to jeje_sat [Ah Td 3d 9s]
Tuche37300: folds
Uncalled bet (350) returned to jeje_sat
jeje_sat collected 700 from pot
jeje_sat: doesn't show hand
*** SUMMARY ***
Total pot 700 | Rake 0
Seat 1: jeje_sat (big blind) collected (700)
Seat 5: Tuche37300 (button) (small blind) folded before Flop


PokerStars Home Game Hand #235420788769: {Club #4837790} Tournament #3394929594, €0.13+€0.05+€0.02 EUR Omaha Pot Limit - Level XII (350/700) - 2022/04/11 18:34:08 CET [2022/04/11 12:34:08 ET]
Table '3394929594 1' 6-max Seat #1 is the button
Seat 1: jeje_sat (43967 in chips, €0.12 bounty)
Seat 5: Tuche37300 (16033 in chips, €0.15 bounty)
jeje_sat: posts small blind 350
Tuche37300: posts big blind 700
*** HOLE CARDS ***
Dealt to jeje_sat [7d Qs Ah Jh]
jeje_sat: raises 1400 to 2100
Tuche37300 said, "c est pas ma specialitÃ© desole si je te mets des horreus ^^"
Tuche37300: calls 1400
*** FLOP *** [Ac Qd As]
Tuche37300: checks
jeje_sat: bets 2100
Tuche37300: folds
Uncalled bet (2100) returned to jeje_sat
jeje_sat collected 4200 from pot
jeje_sat: doesn't show hand
*** SUMMARY ***
Total pot 4200 | Rake 0
Board [Ac Qd As]
Seat 1: jeje_sat (button) (small blind) collected (4200)
Seat 5: Tuche37300 (big blind) folded on the Flop


PokerStars Home Game Hand #235420800166: {Club #4837790} Tournament #3394929594, €0.13+€0.05+€0.02 EUR Omaha Pot Limit - Level XII (350/700) - 2022/04/11 18:34:41 CET [2022/04/11 12:34:41 ET]
Table '3394929594 1' 6-max Seat #5 is the button
Seat 1: jeje_sat (46067 in chips, €0.12 bounty)
Seat 5: Tuche37300 (13933 in chips, €0.15 bounty)
Tuche37300: posts small blind 350
jeje_sat: posts big blind 700
*** HOLE CARDS ***
Dealt to jeje_sat [8d Ks 4s 2c]
Tuche37300: folds
Uncalled bet (350) returned to jeje_sat
jeje_sat said, ":)"
jeje_sat collected 700 from pot
jeje_sat: doesn't show hand
*** SUMMARY ***
Total pot 700 | Rake 0
Seat 1: jeje_sat (big blind) collected (700)
Seat 5: Tuche37300 (button) (small blind) folded before Flop


PokerStars Home Game Hand #235420802385: {Club #4837790} Tournament #3394929594, €0.13+€0.05+€0.02 EUR Omaha Pot Limit - Level XII (350/700) - 2022/04/11 18:34:47 CET [2022/04/11 12:34:47 ET]
Table '3394929594 1' 6-max Seat #1 is the button
Seat 1: jeje_sat (46417 in chips, €0.12 bounty)
Seat 5: Tuche37300 (13583 in chips, €0.15 bounty)
jeje_sat: posts small blind 350
Tuche37300: posts big blind 700
*** HOLE CARDS ***
Dealt to jeje_sat [Qh 3d Td Th]
jeje_sat: raises 1400 to 2100
Tuche37300 said, "je suis nul mdr"
Tuche37300: folds
Uncalled bet (1400) returned to jeje_sat
jeje_sat collected 1400 from pot
jeje_sat: doesn't show hand
*** SUMMARY ***
Total pot 1400 | Rake 0
Seat 1: jeje_sat (button) (small blind) collected (1400)
Seat 5: Tuche37300 (big blind) folded before Flop


PokerStars Home Game Hand #235420806561: {Club #4837790} Tournament #3394929594, €0.13+€0.05+€0.02 EUR Omaha Pot Limit - Level XII (350/700) - 2022/04/11 18:34:59 CET [2022/04/11 12:34:59 ET]
Table '3394929594 1' 6-max Seat #5 is the button
Seat 1: jeje_sat (47117 in chips, €0.12 bounty)
Seat 5: Tuche37300 (12883 in chips, €0.15 bounty)
Tuche37300: posts small blind 350
jeje_sat: posts big blind 700
*** HOLE CARDS ***
Dealt to jeje_sat [6c Ts Tc 7h]
jeje_sat said, "mais non ;)"
Tuche37300: raises 1400 to 2100
jeje_sat: calls 1400
*** FLOP *** [6d Qs 5s]
jeje_sat: checks
Tuche37300: bets 4200
jeje_sat: folds
Uncalled bet (4200) returned to Tuche37300
Tuche37300 collected 4200 from pot
Tuche37300: doesn't show hand
*** SUMMARY ***
Total pot 4200 | Rake 0
Board [6d Qs 5s]
Seat 1: jeje_sat (big blind) folded on the Flop
Seat 5: Tuche37300 (button) (small blind) collected (4200)


PokerStars Home Game Hand #235420812771: {Club #4837790} Tournament #3394929594, €0.13+€0.05+€0.02 EUR Omaha Pot Limit - Level XII (350/700) - 2022/04/11 18:35:17 CET [2022/04/11 12:35:17 ET]
Table '3394929594 1' 6-max Seat #1 is the button
Seat 1: jeje_sat (45017 in chips, €0.12 bounty)
Seat 5: Tuche37300 (14983 in chips, €0.15 bounty)
jeje_sat: posts small blind 350
Tuche37300: posts big blind 700
*** HOLE CARDS ***
Dealt to jeje_sat [6h 7c Ts 6s]
jeje_sat: raises 1400 to 2100
Tuche37300: folds
Uncalled bet (1400) returned to jeje_sat
jeje_sat collected 1400 from pot
jeje_sat: doesn't show hand
*** SUMMARY ***
Total pot 1400 | Rake 0
Seat 1: jeje_sat (button) (small blind) collected (1400)
Seat 5: Tuche37300 (big blind) folded before Flop


PokerStars Home Game Hand #235420815655: {Club #4837790} Tournament #3394929594, €0.13+€0.05+€0.02 EUR Omaha Pot Limit - Level XII (350/700) - 2022/04/11 18:35:26 CET [2022/04/11 12:35:26 ET]
Table '3394929594 1' 6-max Seat #5 is the button
Seat 1: jeje_sat (45717 in chips, €0.12 bounty)
Seat 5: Tuche37300 (14283 in chips, €0.15 bounty)
Tuche37300: posts small blind 350
jeje_sat: posts big blind 700
*** HOLE CARDS ***
Dealt to jeje_sat [Kc 8s Qc Jh]
Tuche37300: raises 1400 to 2100
jeje_sat: calls 1400
*** FLOP *** [7h 8c Kh]
jeje_sat: checks
Tuche37300: bets 4200
jeje_sat: raises 12600 to 16800
Tuche37300: calls 7983 and is all-in
Uncalled bet (4617) returned to jeje_sat
*** TURN *** [7h 8c Kh] [4s]
*** RIVER *** [7h 8c Kh 4s] [3h]
*** SHOW DOWN ***
jeje_sat: shows [Kc 8s Qc Jh] (two pair, Kings and Eights)
Tuche37300: shows [Qd 2h Ks Ah] (a flush, Ace high)
Tuche37300 collected 28566 from pot
*** SUMMARY ***
Total pot 28566 | Rake 0
Board [7h 8c Kh 4s 3h]
Seat 1: jeje_sat (big blind) showed [Kc 8s Qc Jh] and lost with two pair, Kings and Eights
Seat 5: Tuche37300 (button) (small blind) showed [Qd 2h Ks Ah] and won (28566) with a flush, Ace high


PokerStars Home Game Hand #235420826211: {Club #4837790} Tournament #3394929594, €0.13+€0.05+€0.02 EUR Omaha Pot Limit - Level XII (350/700) - 2022/04/11 18:35:56 CET [2022/04/11 12:35:56 ET]
Table '3394929594 1' 6-max Seat #1 is the button
Seat 1: jeje_sat (31434 in chips, €0.12 bounty)
Seat 5: Tuche37300 (28566 in chips, €0.15 bounty)
jeje_sat: posts small blind 350
Tuche37300: posts big blind 700
*** HOLE CARDS ***
Dealt to jeje_sat [Ks 9s 4h Qs]
jeje_sat: raises 1400 to 2100
Tuche37300: calls 1400
*** FLOP *** [5d 7d 6c]
Tuche37300 said, "obligÃ© ^^"
Tuche37300: checks
jeje_sat: checks
*** TURN *** [5d 7d 6c] [As]
Tuche37300: bets 2100
jeje_sat: folds
Uncalled bet (2100) returned to Tuche37300
Tuche37300 collected 4200 from pot
Tuche37300: doesn't show hand
*** SUMMARY ***
Total pot 4200 | Rake 0
Board [5d 7d 6c As]
Seat 1: jeje_sat (button) (small blind) folded on the Turn
Seat 5: Tuche37300 (big blind) collected (4200)


PokerStars Home Game Hand #235420835368: {Club #4837790} Tournament #3394929594, €0.13+€0.05+€0.02 EUR Omaha Pot Limit - Level XII (350/700) - 2022/04/11 18:36:22 CET [2022/04/11 12:36:22 ET]
Table '3394929594 1' 6-max Seat #5 is the button
Seat 1: jeje_sat (29334 in chips, €0.12 bounty)
Seat 5: Tuche37300 (30666 in chips, €0.15 bounty)
Tuche37300: posts small blind 350
jeje_sat: posts big blind 700
*** HOLE CARDS ***
Dealt to jeje_sat [6c 2d 5d 2s]
Tuche37300: calls 350
jeje_sat: raises 1400 to 2100
Tuche37300: calls 1400
*** FLOP *** [5h 4h 7d]
jeje_sat: checks
Tuche37300: bets 4200
jeje_sat: raises 12600 to 16800
Tuche37300: raises 11766 to 28566 and is all-in
jeje_sat: calls 10434 and is all-in
Uncalled bet (1332) returned to Tuche37300
*** TURN *** [5h 4h 7d] [8d]
*** RIVER *** [5h 4h 7d 8d] [9d]
*** SHOW DOWN ***
jeje_sat: shows [6c 2d 5d 2s] (a flush, Nine high)
Tuche37300: shows [6s 7h 3c 6d] (a straight, Five to Nine)
jeje_sat collected 58668 from pot
*** SUMMARY ***
Total pot 58668 | Rake 0
Board [5h 4h 7d 8d 9d]
Seat 1: jeje_sat (big blind) showed [6c 2d 5d 2s] and won (58668) with a flush, Nine high
Seat 5: Tuche37300 (button) (small blind) showed [6s 7h 3c 6d] and lost with a straight, Five to Nine


PokerStars Home Game Hand #235420849742: {Club #4837790} Tournament #3394929594, €0.13+€0.05+€0.02 EUR Omaha Pot Limit - Level XIII (400/800) - 2022/04/11 18:37:04 CET [2022/04/11 12:37:04 ET]
Table '3394929594 1' 6-max Seat #1 is the button
Seat 1: jeje_sat (58668 in chips, €0.12 bounty)
Seat 5: Tuche37300 (1332 in chips, €0.15 bounty)
jeje_sat: posts small blind 400
Tuche37300: posts big blind 800
*** HOLE CARDS ***
Dealt to jeje_sat [5d 8s 7h 9s]
jeje_sat: raises 1600 to 2400
Tuche37300 said, "pire que tout la mdr"
Tuche37300: calls 532 and is all-in
Uncalled bet (1068) returned to jeje_sat
*** FLOP *** [2s Qd Qc]
*** TURN *** [2s Qd Qc] [3c]
*** RIVER *** [2s Qd Qc 3c] [Ks]
*** SHOW DOWN ***
Tuche37300: shows [3s 4h Jh 6c] (two pair, Queens and Threes)
jeje_sat: shows [5d 8s 7h 9s] (a pair of Queens)
Tuche37300 collected 2664 from pot
*** SUMMARY ***
Total pot 2664 | Rake 0
Board [2s Qd Qc 3c Ks]
Seat 1: jeje_sat (button) (small blind) showed [5d 8s 7h 9s] and lost with a pair of Queens
Seat 5: Tuche37300 (big blind) showed [3s 4h Jh 6c] and won (2664) with two pair, Queens and Threes


PokerStars Home Game Hand #235420855532: {Club #4837790} Tournament #3394929594, €0.13+€0.05+€0.02 EUR Omaha Pot Limit - Level XIII (400/800) - 2022/04/11 18:37:21 CET [2022/04/11 12:37:21 ET]
Table '3394929594 1' 6-max Seat #5 is the button
Seat 1: jeje_sat (57336 in chips, €0.12 bounty)
Seat 5: Tuche37300 (2664 in chips, €0.15 bounty)
Tuche37300: posts small blind 400
jeje_sat: posts big blind 800
*** HOLE CARDS ***
Dealt to jeje_sat [8c Ah Jh 7d]
Tuche37300: raises 1600 to 2400
jeje_sat: raises 4800 to 7200
Tuche37300: calls 264 and is all-in
Uncalled bet (4536) returned to jeje_sat
*** FLOP *** [5s Ad 6s]
*** TURN *** [5s Ad 6s] [9d]
*** RIVER *** [5s Ad 6s 9d] [5c]
*** SHOW DOWN ***
jeje_sat: shows [8c Ah Jh 7d] (a straight, Five to Nine)
Tuche37300: shows [3c Kc 2d 9h] (two pair, Nines and Fives)
jeje_sat collected 5328 from pot
jeje_sat wins €0.08 for eliminating Tuche37300 and their own bounty increases by €0.07 to €0.19
Tuche37300 finished the tournament in 2nd place and received €0.46.
jeje_sat wins the tournament and receives €0.79 - congratulations!
*** SUMMARY ***
Total pot 5328 | Rake 0
Board [5s Ad 6s 9d 5c]
Seat 1: jeje_sat (big blind) showed [8c Ah Jh 7d] and won (5328) with a straight, Five to Nine
Seat 5: Tuche37300 (button) (small blind) showed [3c Kc 2d 9h] and lost with two pair, Nines and Fives


