Winamax Poker - Go Fast "Bucarest" - HandId: #16870380-6305-1643806641 - Omaha pot limit (0.01€/0.02€) - 2022/02/02 12:57:21 UTC
Table: 'Bucarest' 6-max (real money) Seat #6 is the button
Seat 1: doc81 (4.85€)
Seat 2: Sonia62 (1.90€)
Seat 3: dent95 (4.82€)
Seat 4: jelachatte (2€)
Seat 5: la volubile (0.46€)
Seat 6: gsalex (2€)
*** ANTE/BLINDS ***
doc81 posts small blind 0.01€
Sonia62 posts big blind 0.02€
Dealt to jelachatte [7d Tc 5s 4d]
*** PRE-FLOP *** 
dent95 folds
jelachatte folds
la volubile calls 0.02€
gsalex raises 0.07€ to 0.09€
doc81 calls 0.08€
Sonia62 calls 0.07€
la volubile calls 0.07€
*** FLOP *** [6d Ah 5h]
doc81 checks
Sonia62 checks
la volubile checks
gsalex bets 0.36€
doc81 folds
Sonia62 folds
la volubile raises 0.01€ to 0.37€ and is all-in
gsalex calls 0.01€
*** TURN *** [6d Ah 5h][2d]
*** RIVER *** [6d Ah 5h 2d][Qc]
*** SHOW DOWN ***
la volubile shows [4s Jh 8c 4h] (One pair : 4)
gsalex shows [7h Qh Ac 3c] (Two pairs : Aces and Queens)
gsalex collected 0.99€ from pot
*** SUMMARY ***
Total pot 0.99€ | Rake 0.11€
Board: [6d Ah 5h 2d Qc]
Seat 5: la volubile showed [4s Jh 8c 4h] and lost with One pair : 4
Seat 6: gsalex (button) showed [7h Qh Ac 3c] and won 0.99€ with Two pairs : Aces and Queens


Winamax Poker - Go Fast "Bucarest" - HandId: #16870380-6306-1643806689 - Omaha pot limit (0.01€/0.02€) - 2022/02/02 12:58:09 UTC
Table: 'Bucarest' 6-max (real money) Seat #6 is the button
Seat 1: Sonia62 (1.81€)
Seat 2: jmc28100 (2.75€)
Seat 3: doc81 (4.76€)
Seat 4: Yo_Mama (0.99€)
Seat 5: jelachatte (2€)
Seat 6: dent95 (4.82€)
*** ANTE/BLINDS ***
Sonia62 posts small blind 0.01€
jmc28100 posts big blind 0.02€
Dealt to jelachatte [Ad Th 9c 5h]
*** PRE-FLOP *** 
doc81 calls 0.02€
Yo_Mama folds
jelachatte folds
dent95 calls 0.02€
Sonia62 calls 0.01€
jmc28100 checks
*** FLOP *** [Jd 8c Ks]
Sonia62 bets 0.02€
jmc28100 calls 0.02€
doc81 calls 0.02€
dent95 folds
*** TURN *** [Jd 8c Ks][6c]
Sonia62 bets 0.02€
jmc28100 calls 0.02€
doc81 folds
*** RIVER *** [Jd 8c Ks 6c][7s]
Sonia62 bets 0.06€
jmc28100 raises 0.06€ to 0.12€
Sonia62 calls 0.06€
*** SHOW DOWN ***
Sonia62 shows [4c 7d Js Tc] (Two pairs : Jacks and 7)
jmc28100 shows [9h 7c Qs Kd] (Two pairs : Kings and 7)
jmc28100 collected 0.38€ from pot
*** SUMMARY ***
Total pot 0.38€ | Rake 0.04€
Board: [Jd 8c Ks 6c 7s]
Seat 1: Sonia62 (small blind) showed [4c 7d Js Tc] and lost with Two pairs : Jacks and 7
Seat 2: jmc28100 (big blind) showed [9h 7c Qs Kd] and won 0.38€ with Two pairs : Kings and 7


Winamax Poker - Go Fast "Bucarest" - HandId: #16870380-6307-1643806737 - Omaha pot limit (0.01€/0.02€) - 2022/02/02 12:58:57 UTC
Table: 'Bucarest' 6-max (real money) Seat #6 is the button
Seat 1: gsalex (2.53€)
Seat 2: la volubile (2€)
Seat 3: jelachatte (2€)
Seat 4: doc81 (4.72€)
Seat 5: Yo_Mama (0.99€)
Seat 6: dent95 (4.80€)
*** ANTE/BLINDS ***
gsalex posts small blind 0.01€
la volubile posts big blind 0.02€
Dealt to jelachatte [9s Tc Ah 6s]
*** PRE-FLOP *** 
jelachatte folds
doc81 calls 0.02€
Yo_Mama raises 0.02€ to 0.04€
dent95 calls 0.04€
gsalex calls 0.03€
la volubile calls 0.02€
doc81 calls 0.02€
*** FLOP *** [4d 6h 7c]
gsalex checks
la volubile checks
doc81 checks
Yo_Mama bets 0.12€
dent95 calls 0.12€
gsalex folds
la volubile folds
doc81 calls 0.12€
*** TURN *** [4d 6h 7c][4h]
doc81 checks
Yo_Mama bets 0.19€
dent95 folds
doc81 calls 0.19€
*** RIVER *** [4d 6h 7c 4h][Kc]
doc81 checks
Yo_Mama checks
*** SHOW DOWN ***
doc81 shows [9d 5h Js Jh] (Two pairs : Jacks and 4)
Yo_Mama shows [4c 2s Jd 5d] (Trips of 4)
Yo_Mama collected 0.85€ from pot
*** SUMMARY ***
Total pot 0.85€ | Rake 0.09€
Board: [4d 6h 7c 4h Kc]
Seat 4: doc81 showed [9d 5h Js Jh] and lost with Two pairs : Jacks and 4
Seat 5: Yo_Mama showed [4c 2s Jd 5d] and won 0.85€ with Trips of 4


Winamax Poker - Go Fast "Bucarest" - HandId: #16870380-6308-1643806829 - Omaha pot limit (0.01€/0.02€) - 2022/02/02 13:00:29 UTC
Table: 'Bucarest' 6-max (real money) Seat #6 is the button
Seat 1: Yo_Mama (1.49€)
Seat 2: dent95 (4.64€)
Seat 3: gsalex (2.49€)
Seat 4: la volubile (2€)
Seat 5: jmc28100 (2.95€)
Seat 6: jelachatte (2€)
*** ANTE/BLINDS ***
Yo_Mama posts small blind 0.01€
dent95 posts big blind 0.02€
Dealt to jelachatte [5d 2c 3d 4h]
*** PRE-FLOP *** 
gsalex raises 0.02€ to 0.04€
la volubile folds
jmc28100 calls 0.04€
jelachatte calls 0.04€
Yo_Mama calls 0.03€
dent95 calls 0.02€
*** FLOP *** [Kd Kc 6h]
Yo_Mama checks
dent95 checks
gsalex checks
jmc28100 checks
jelachatte checks
*** TURN *** [Kd Kc 6h][Qs]
Yo_Mama bets 0.09€
dent95 folds
gsalex folds
jmc28100 calls 0.09€
jelachatte folds
*** RIVER *** [Kd Kc 6h Qs][As]
Yo_Mama checks
jmc28100 bets 0.38€
Yo_Mama folds
jmc28100 collected 0.72€ from pot
*** SUMMARY ***
Total pot 0.72€ | Rake 0.04€
Board: [Kd Kc 6h Qs As]
Seat 5: jmc28100 won 0.72€


Winamax Poker - Go Fast "Bucarest" - HandId: #16870380-6309-1643806884 - Omaha pot limit (0.01€/0.02€) - 2022/02/02 13:01:24 UTC
Table: 'Bucarest' 6-max (real money) Seat #6 is the button
Seat 1: la volubile (2€)
Seat 2: jelachatte (2€)
Seat 3: dent95 (4.60€)
Seat 4: gsalex (2.45€)
Seat 5: doc81 (4.37€)
Seat 6: Yo_Mama (1.36€)
*** ANTE/BLINDS ***
la volubile posts small blind 0.01€
jelachatte posts big blind 0.02€
Dealt to jelachatte [3d Kd 9h Ac]
*** PRE-FLOP *** 
dent95 folds
gsalex calls 0.02€
doc81 calls 0.02€
Yo_Mama calls 0.02€
la volubile calls 0.01€
jelachatte checks
*** FLOP *** [7s 8d 7d]
la volubile checks
jelachatte checks
gsalex checks
doc81 checks
Yo_Mama checks
*** TURN *** [7s 8d 7d][3h]
la volubile checks
jelachatte checks
gsalex checks
doc81 checks
Yo_Mama checks
*** RIVER *** [7s 8d 7d 3h][Kh]
la volubile checks
jelachatte checks
gsalex checks
doc81 checks
Yo_Mama checks
*** SHOW DOWN ***
la volubile shows [Ad Qh 2c 2h] (Two pairs : 7 and 2)
jelachatte shows [3d Kd 9h Ac] (Two pairs : Kings and 7)
gsalex shows [6h Jd 8h Ah] (Two pairs : 8 and 7)
Yo_Mama shows [Ks 5h 5d Qc] (Two pairs : Kings and 7)
doc81 shows [Ts Kc 8c Th] (Two pairs : Kings and 8)
doc81 collected 0.09€ from pot
*** SUMMARY ***
Total pot 0.09€ | Rake 0.01€
Board: [7s 8d 7d 3h Kh]
Seat 1: la volubile (small blind) showed [Ad Qh 2c 2h] and lost with Two pairs : 7 and 2
Seat 2: jelachatte (big blind) showed [3d Kd 9h Ac] and lost with Two pairs : Kings and 7
Seat 4: gsalex showed [6h Jd 8h Ah] and lost with Two pairs : 8 and 7
Seat 5: doc81 showed [Ts Kc 8c Th] and won 0.09€ with Two pairs : Kings and 8
Seat 6: Yo_Mama (button) showed [Ks 5h 5d Qc] and lost with Two pairs : Kings and 7


Winamax Poker - Go Fast "Bucarest" - HandId: #16870380-6311-1643807018 - Omaha pot limit (0.01€/0.02€) - 2022/02/02 13:03:38 UTC
Table: 'Bucarest' 6-max (real money) Seat #6 is the button
Seat 1: jelachatte (2€)
Seat 2: Ici C Goku (0.50€)
Seat 3: la volubile (1.88€)
Seat 4: dent95 (4.60€)
Seat 5: jmc28100 (3.08€)
Seat 6: doc81 (4.36€)
*** ANTE/BLINDS ***
jelachatte posts small blind 0.01€
Ici C Goku posts big blind 0.02€
Dealt to jelachatte [3h 2s 3d Ad]
*** PRE-FLOP *** 
la volubile folds
dent95 folds
jmc28100 folds
doc81 calls 0.02€
jelachatte raises 0.06€ to 0.08€
Ici C Goku calls 0.06€
doc81 calls 0.06€
*** FLOP *** [As 8d 7c]
jelachatte bets 0.12€
Ici C Goku folds
doc81 calls 0.12€
*** TURN *** [As 8d 7c][Qs]
jelachatte bets 0.32€
doc81 calls 0.32€
*** RIVER *** [As 8d 7c Qs][Td]
jelachatte checks
doc81 checks
*** SHOW DOWN ***
jelachatte shows [3h 2s 3d Ad] (One pair : Aces)
doc81 shows [Jc Ah Ts 3s] (Two pairs : Aces and Tens)
doc81 collected 1.01€ from pot
*** SUMMARY ***
Total pot 1.01€ | Rake 0.11€
Board: [As 8d 7c Qs Td]
Seat 1: jelachatte (small blind) showed [3h 2s 3d Ad] and lost with One pair : Aces
Seat 6: doc81 (button) showed [Jc Ah Ts 3s] and won 1.01€ with Two pairs : Aces and Tens


Winamax Poker - Go Fast "Bucarest" - HandId: #16870380-6313-1643807086 - Omaha pot limit (0.01€/0.02€) - 2022/02/02 13:04:46 UTC
Table: 'Bucarest' 6-max (real money) Seat #6 is the button
Seat 1: Ici C Goku (0.42€)
Seat 2: doc81 (4.85€)
Seat 3: 2HANDS (1.18€)
Seat 4: jmc28100 (3€)
Seat 5: jelachatte (2€)
Seat 6: gsalex (2.63€)
*** ANTE/BLINDS ***
Ici C Goku posts small blind 0.01€
doc81 posts big blind 0.02€
Dealt to jelachatte [3d Ts 8d 8s]
*** PRE-FLOP *** 
2HANDS folds
jmc28100 calls 0.02€
jelachatte folds
gsalex folds
Ici C Goku calls 0.01€
doc81 checks
*** FLOP *** [6d 9d 2h]
Ici C Goku checks
doc81 checks
jmc28100 checks
*** TURN *** [6d 9d 2h][7d]
Ici C Goku checks
doc81 checks
jmc28100 checks
*** RIVER *** [6d 9d 2h 7d][3h]
Ici C Goku checks
doc81 checks
jmc28100 checks
*** SHOW DOWN ***
Ici C Goku shows [Kh Jd Jc Kc] (One pair : Kings)
jmc28100 shows [4h Th Ks 9h] (One pair : 9)
doc81 shows [7h As 6c Js] (Two pairs : 7 and 6)
doc81 collected 0.05€ from pot
*** SUMMARY ***
Total pot 0.05€ | Rake 0.01€
Board: [6d 9d 2h 7d 3h]
Seat 1: Ici C Goku (small blind) showed [Kh Jd Jc Kc] and lost with One pair : Kings
Seat 2: doc81 (big blind) showed [7h As 6c Js] and won 0.05€ with Two pairs : 7 and 6
Seat 4: jmc28100 showed [4h Th Ks 9h] and lost with One pair : 9


Winamax Poker - Go Fast "Bucarest" - HandId: #16870380-6314-1643807101 - Omaha pot limit (0.01€/0.02€) - 2022/02/02 13:05:01 UTC
Table: 'Bucarest' 6-max (real money) Seat #6 is the button
Seat 1: 2HANDS (1.18€)
Seat 2: Alesk win (2€)
Seat 3: la volubile (1.98€)
Seat 4: Yo_Mama (1.26€)
Seat 5: gsalex (2.63€)
Seat 6: jelachatte (2€)
*** ANTE/BLINDS ***
2HANDS posts small blind 0.01€
Alesk win posts big blind 0.02€
Dealt to jelachatte [Qh Jc Ah 6s]
*** PRE-FLOP *** 
la volubile calls 0.02€
Yo_Mama folds
gsalex calls 0.02€
jelachatte raises 0.09€ to 0.11€
2HANDS folds
Alesk win calls 0.09€
la volubile calls 0.09€
gsalex calls 0.09€
*** FLOP *** [9h Jd 9s]
Alesk win checks
la volubile checks
gsalex checks
jelachatte bets 0.23€
Alesk win calls 0.23€
la volubile folds
gsalex folds
*** TURN *** [9h Jd 9s][Tc]
Alesk win checks
jelachatte checks
*** RIVER *** [9h Jd 9s Tc][3d]
Alesk win bets 0.91€
jelachatte folds
Alesk win collected 1.73€ from pot
*** SUMMARY ***
Total pot 1.73€ | Rake 0.09€
Board: [9h Jd 9s Tc 3d]
Seat 2: Alesk win (big blind) won 1.73€


Winamax Poker - Go Fast "Bucarest" - HandId: #16870380-6317-1643807205 - Omaha pot limit (0.01€/0.02€) - 2022/02/02 13:06:45 UTC
Table: 'Bucarest' 6-max (real money) Seat #6 is the button
Seat 1: celisem (0.58€)
Seat 2: doc81 (4.86€)
Seat 3: Alesk win (2.48€)
Seat 4: jelachatte (2€)
Seat 5: Ici C Goku (0.40€)
Seat 6: Yo_Mama (1.26€)
*** ANTE/BLINDS ***
celisem posts small blind 0.01€
doc81 posts big blind 0.02€
Dealt to jelachatte [Tc Th 2h 3d]
*** PRE-FLOP *** 
Alesk win raises 0.05€ to 0.07€
jelachatte folds
Ici C Goku folds
Yo_Mama calls 0.07€
celisem calls 0.06€
doc81 calls 0.05€
*** FLOP *** [Kd 9s 4h]
celisem checks
doc81 checks
Alesk win bets 0.28€
Yo_Mama calls 0.28€
celisem folds
doc81 calls 0.28€
*** TURN *** [Kd 9s 4h][4c]
doc81 checks
Alesk win bets 0.56€
Yo_Mama raises 0.35€ to 0.91€ and is all-in
doc81 folds
Alesk win calls 0.35€
*** RIVER *** [Kd 9s 4h 4c][6d]
*** SHOW DOWN ***
Alesk win shows [Kh Qh 2s 4d] (Full of 4 and Kings)
Yo_Mama shows [9c 3c 4s 9d] (Full of 9 and 4)
Yo_Mama collected 2.65€ from pot
*** SUMMARY ***
Total pot 2.65€ | Rake 0.29€
Board: [Kd 9s 4h 4c 6d]
Seat 3: Alesk win showed [Kh Qh 2s 4d] and lost with Full of 4 and Kings
Seat 6: Yo_Mama (button) showed [9c 3c 4s 9d] and won 2.65€ with Full of 9 and 4


Winamax Poker - Go Fast "Bucarest" - HandId: #16870380-6318-1643807233 - Omaha pot limit (0.01€/0.02€) - 2022/02/02 13:07:13 UTC
Table: 'Bucarest' 6-max (real money) Seat #6 is the button
Seat 1: lefraisier (1.91€)
Seat 2: jmc28100 (2.89€)
Seat 3: gsalex (2.43€)
Seat 4: Ici C Goku (0.40€)
Seat 5: 2HANDS (1.09€)
Seat 6: jelachatte (2€)
*** ANTE/BLINDS ***
lefraisier posts small blind 0.01€
jmc28100 posts big blind 0.02€
Dealt to jelachatte [8d 3h 2h 5s]
*** PRE-FLOP *** 
gsalex calls 0.02€
Ici C Goku calls 0.02€
2HANDS folds
jelachatte folds
lefraisier folds
jmc28100 checks
*** FLOP *** [5d 4s 8h]
jmc28100 checks
gsalex bets 0.07€
Ici C Goku folds
jmc28100 calls 0.07€
*** TURN *** [5d 4s 8h][Ac]
jmc28100 checks
gsalex checks
*** RIVER *** [5d 4s 8h Ac][Td]
jmc28100 bets 0.21€
gsalex folds
jmc28100 collected 0.40€ from pot
*** SUMMARY ***
Total pot 0.40€ | Rake 0.02€
Board: [5d 4s 8h Ac Td]
Seat 2: jmc28100 (big blind) won 0.40€


Winamax Poker - Go Fast "Bucarest" - HandId: #16870380-6319-1643807266 - Omaha pot limit (0.01€/0.02€) - 2022/02/02 13:07:46 UTC
Table: 'Bucarest' 6-max (real money) Seat #6 is the button
Seat 1: jelachatte (2€)
Seat 2: la volubile (2.20€)
Seat 3: celisem (0.51€)
Seat 4: lefraisier (1.90€)
Seat 5: Ici C Goku (0.38€)
Seat 6: 2HANDS (1.09€)
*** ANTE/BLINDS ***
jelachatte posts small blind 0.01€
la volubile posts big blind 0.02€
Dealt to jelachatte [5d 6h 4c 7s]
*** PRE-FLOP *** 
celisem calls 0.02€
lefraisier folds
Ici C Goku calls 0.02€
2HANDS calls 0.02€
jelachatte calls 0.01€
la volubile checks
*** FLOP *** [6c 2c 8s]
jelachatte checks
la volubile checks
celisem checks
Ici C Goku checks
2HANDS checks
*** TURN *** [6c 2c 8s][9d]
jelachatte bets 0.07€
la volubile folds
celisem calls 0.07€
Ici C Goku folds
2HANDS folds
*** RIVER *** [6c 2c 8s 9d][Ks]
jelachatte checks
celisem checks
*** SHOW DOWN ***
celisem shows [8d 6d Kc 5s] (Two pairs : Kings and 8)
jelachatte shows [5d 6h 4c 7s] (Straight 9 high)
jelachatte collected 0.22€ from pot
*** SUMMARY ***
Total pot 0.22€ | Rake 0.02€
Board: [6c 2c 8s 9d Ks]
Seat 1: jelachatte (small blind) showed [5d 6h 4c 7s] and won 0.22€ with Straight 9 high
Seat 3: celisem showed [8d 6d Kc 5s] and lost with Two pairs : Kings and 8


Winamax Poker - Go Fast "Bucarest" - HandId: #16870380-6323-1643807384 - Omaha pot limit (0.01€/0.02€) - 2022/02/02 13:09:44 UTC
Table: 'Bucarest' 6-max (real money) Seat #6 is the button
Seat 1: doc81 (4.18€)
Seat 2: la volubile (2.38€)
Seat 3: jelachatte (2.13€)
Seat 4: celisem (0.42€)
Seat 5: 2HANDS (1€)
Seat 6: lefraisier (1.81€)
*** ANTE/BLINDS ***
doc81 posts small blind 0.01€
la volubile posts big blind 0.02€
Dealt to jelachatte [5s 7s 6s 5c]
*** PRE-FLOP *** 
jelachatte folds
celisem folds
2HANDS folds
lefraisier calls 0.02€
doc81 calls 0.01€
la volubile checks
*** FLOP *** [Js Qs As]
doc81 checks
la volubile checks
lefraisier checks
*** TURN *** [Js Qs As][9s]
doc81 checks
la volubile checks
lefraisier checks
*** RIVER *** [Js Qs As 9s][Td]
doc81 checks
la volubile checks
lefraisier checks
*** SHOW DOWN ***
la volubile shows [2d 9d 9c 2c] (Trips of 9)
lefraisier shows [4h Jc 9h 7c] (Two pairs : Jacks and 9)
doc81 shows [Kd 3c Jh 5h] (Straight Ace high)
doc81 collected 0.05€ from pot
*** SUMMARY ***
Total pot 0.05€ | Rake 0.01€
Board: [Js Qs As 9s Td]
Seat 1: doc81 (small blind) showed [Kd 3c Jh 5h] and won 0.05€ with Straight Ace high
Seat 2: la volubile (big blind) showed [2d 9d 9c 2c] and lost with Trips of 9
Seat 6: lefraisier (button) showed [4h Jc 9h 7c] and lost with Two pairs : Jacks and 9


Winamax Poker - Go Fast "Bucarest" - HandId: #16870380-6324-1643807420 - Omaha pot limit (0.01€/0.02€) - 2022/02/02 13:10:20 UTC
Table: 'Bucarest' 6-max (real money) Seat #6 is the button
Seat 1: 2HANDS (1€)
Seat 2: doc81 (4.21€)
Seat 3: Ici C Goku (0.36€)
Seat 4: lefraisier (1.79€)
Seat 5: celisem (0.42€)
Seat 6: jelachatte (2.13€)
*** ANTE/BLINDS ***
2HANDS posts small blind 0.01€
doc81 posts big blind 0.02€
Dealt to jelachatte [9d 7s 8h 6c]
*** PRE-FLOP *** 
Ici C Goku folds
lefraisier folds
celisem calls 0.02€
jelachatte folds
2HANDS calls 0.01€
doc81 checks
*** FLOP *** [2d 5s Js]
2HANDS checks
doc81 checks
celisem checks
*** TURN *** [2d 5s Js][5h]
2HANDS checks
doc81 checks
celisem checks
*** RIVER *** [2d 5s Js 5h][3c]
2HANDS checks
doc81 checks
celisem checks
*** SHOW DOWN ***
2HANDS shows [Ac 2s 3s 6d] (Two pairs : 5 and 3)
doc81 shows [8d 3d Kd Jd] (Two pairs : Jacks and 5)
celisem shows [Jc Kc 2h Qd] (Two pairs : Jacks and 5)
celisem collected 0.03€ from pot
doc81 collected 0.02€ from pot
*** SUMMARY ***
Total pot 0.05€ | Rake 0.01€
Board: [2d 5s Js 5h 3c]
Seat 1: 2HANDS (small blind) showed [Ac 2s 3s 6d] and lost with Two pairs : 5 and 3
Seat 2: doc81 (big blind) showed [8d 3d Kd Jd] and won 0.02€ with Two pairs : Jacks and 5
Seat 5: celisem showed [Jc Kc 2h Qd] and won 0.03€ with Two pairs : Jacks and 5


Winamax Poker - Go Fast "Bucarest" - HandId: #16870380-6326-1643807478 - Omaha pot limit (0.01€/0.02€) - 2022/02/02 13:11:18 UTC
Table: 'Bucarest' 6-max (real money) Seat #6 is the button
Seat 1: Yo_Mama (2.08€)
Seat 2: gsalex (2.55€)
Seat 3: jmc28100 (5€)
Seat 4: jelachatte (2.13€)
Seat 5: Ici C Goku (0.36€)
Seat 6: lefraisier (1.79€)
Hold-up to Pot: total 0.10€
*** ANTE/BLINDS ***
Yo_Mama posts small blind 0.01€
gsalex posts big blind 0.02€
Dealt to jelachatte [7d Jd 8c 9d]
*** PRE-FLOP *** 
jmc28100 calls 0.02€
jelachatte folds
Ici C Goku calls 0.02€
lefraisier calls 0.02€
Yo_Mama calls 0.01€
gsalex raises 0.08€ to 0.10€
jmc28100 calls 0.08€
Ici C Goku folds
lefraisier calls 0.08€
Yo_Mama calls 0.08€
*** FLOP *** [Qh 6s 7h]
Yo_Mama checks
gsalex bets 0.52€
jmc28100 folds
lefraisier folds
Yo_Mama folds
gsalex collected 1€ from pot
*** SUMMARY ***
Total pot 1€ | Rake 0.04€
Board: [Qh 6s 7h]
Seat 2: gsalex (big blind) won 1€


Winamax Poker - Go Fast "Bucarest" - HandId: #16870380-6327-1643807515 - Omaha pot limit (0.01€/0.02€) - 2022/02/02 13:11:55 UTC
Table: 'Bucarest' 6-max (real money) Seat #6 is the button
Seat 1: Ici C Goku (0.34€)
Seat 2: jelachatte (2.13€)
Seat 3: doc81 (4.21€)
Seat 4: celisem (0.43€)
Seat 5: 2HANDS (0.98€)
Seat 6: lefraisier (1.69€)
*** ANTE/BLINDS ***
Ici C Goku posts small blind 0.01€
jelachatte posts big blind 0.02€
Dealt to jelachatte [3d Kh Jd 7d]
*** PRE-FLOP *** 
doc81 calls 0.02€
celisem calls 0.02€
2HANDS calls 0.02€
lefraisier calls 0.02€
Ici C Goku calls 0.01€
jelachatte checks
*** FLOP *** [Td 8c 4d]
Ici C Goku bets 0.04€
jelachatte folds
doc81 calls 0.04€
celisem calls 0.04€
2HANDS calls 0.04€
lefraisier folds
*** TURN *** [Td 8c 4d][5d]
Ici C Goku checks
doc81 checks
celisem checks
2HANDS checks
*** RIVER *** [Td 8c 4d 5d][Qs]
Ici C Goku checks
doc81 checks
celisem checks
2HANDS checks
*** SHOW DOWN ***
Ici C Goku shows [4h 8s 5c 9c] (Two pairs : 8 and 5)
doc81 shows [2c Th Ah Qc] (Two pairs : Queens and Tens)
2HANDS shows [8d Ts Jh Kc] (Two pairs : Tens and 8)
celisem shows [Tc Jc 9d 3s] (Straight Queen high)
celisem collected 0.25€ from pot
*** SUMMARY ***
Total pot 0.25€ | Rake 0.03€
Board: [Td 8c 4d 5d Qs]
Seat 1: Ici C Goku (small blind) showed [4h 8s 5c 9c] and lost with Two pairs : 8 and 5
Seat 3: doc81 showed [2c Th Ah Qc] and lost with Two pairs : Queens and Tens
Seat 4: celisem showed [Tc Jc 9d 3s] and won 0.25€ with Straight Queen high
Seat 5: 2HANDS showed [8d Ts Jh Kc] and lost with Two pairs : Tens and 8


Winamax Poker - Go Fast "Bucarest" - HandId: #16870380-6329-1643807614 - Omaha pot limit (0.01€/0.02€) - 2022/02/02 13:13:34 UTC
Table: 'Bucarest' 6-max (real money) Seat #6 is the button
Seat 1: gsalex (2.91€)
Seat 2: Ici C Goku (0.28€)
Seat 3: doc81 (4.15€)
Seat 4: Yo_Mama (1.98€)
Seat 5: jelachatte (2.11€)
Seat 6: celisem (0.62€)
*** ANTE/BLINDS ***
gsalex posts small blind 0.01€
Ici C Goku posts big blind 0.02€
Dealt to jelachatte [4c 2s 7d Tc]
*** PRE-FLOP *** 
doc81 calls 0.02€
Yo_Mama folds
jelachatte folds
celisem raises 0.02€ to 0.04€
gsalex raises 0.12€ to 0.16€
Ici C Goku folds
doc81 calls 0.14€
celisem calls 0.12€
*** FLOP *** [3s Ad Kd]
gsalex bets 0.50€
doc81 folds
celisem calls 0.46€ and is all-in
*** TURN *** [3s Ad Kd][4h]
*** RIVER *** [3s Ad Kd 4h][Kh]
*** SHOW DOWN ***
celisem shows [Th Qc 7s As] (Two pairs : Aces and Kings)
gsalex shows [Ts 4s Ah Ac] (Full of Aces and Kings)
gsalex collected 1.32€ from pot
*** SUMMARY ***
Total pot 1.32€ | Rake 0.14€
Board: [3s Ad Kd 4h Kh]
Seat 1: gsalex (small blind) showed [Ts 4s Ah Ac] and won 1.32€ with Full of Aces and Kings
Seat 6: celisem (button) showed [Th Qc 7s As] and lost with Two pairs : Aces and Kings


Winamax Poker - Go Fast "Bucarest" - HandId: #16870380-6331-1643807681 - Omaha pot limit (0.01€/0.02€) - 2022/02/02 13:14:41 UTC
Table: 'Bucarest' 6-max (real money) Seat #6 is the button
Seat 1: jmc28100 (4.83€)
Seat 2: 2HANDS (0.92€)
Seat 3: la volubile (2.57€)
Seat 4: doc81 (3.99€)
Seat 5: gsalex (3.57€)
Seat 6: jelachatte (2.11€)
*** ANTE/BLINDS ***
jmc28100 posts small blind 0.01€
2HANDS posts big blind 0.02€
Dealt to jelachatte [Jc Qs Ad 6d]
*** PRE-FLOP *** 
la volubile calls 0.02€
doc81 calls 0.02€
gsalex folds
jelachatte raises 0.09€ to 0.11€
jmc28100 folds
2HANDS calls 0.09€
la volubile calls 0.09€
doc81 calls 0.09€
*** FLOP *** [7d 8d 5d]
2HANDS bets 0.45€
la volubile calls 0.45€
doc81 folds
jelachatte raises 1.55€ to 2€ and is all-in
2HANDS calls 0.36€ and is all-in
la volubile raises 0.46€ to 2.46€ and is all-in
*** TURN *** [7d 8d 5d][Jd]
*** RIVER *** [7d 8d 5d Jd][Qh]
*** SHOW DOWN ***
2HANDS shows [4d 9h Td 7c] (Flush Jack high)
la volubile shows [Kd 3d Ks 3c] (Flush King high)
jelachatte shows [Jc Qs Ad 6d] (Flush Ace high)
jelachatte collected 4.73€ from main pot
la volubile collected 0.46€ from side pot 1
*** SUMMARY ***
Total pot 5.19€ | Rake 0.53€
Board: [7d 8d 5d Jd Qh]
Seat 2: 2HANDS (big blind) showed [4d 9h Td 7c] and lost with Flush Jack high
Seat 3: la volubile showed [Kd 3d Ks 3c] and won 0.46€ with Flush King high
Seat 6: jelachatte (button) showed [Jc Qs Ad 6d] and won 4.73€ with Flush Ace high


Winamax Poker - Go Fast "Bucarest" - HandId: #16870380-6333-1643807801 - Omaha pot limit (0.01€/0.02€) - 2022/02/02 13:16:41 UTC
Table: 'Bucarest' 6-max (real money) Seat #6 is the button
Seat 1: 2143658709 (1.95€)
Seat 2: jmc28100 (4.77€)
Seat 3: doc81 (3.88€)
Seat 4: n13tless (3.76€)
Seat 5: jelachatte (4.73€)
Seat 6: Yo_Mama (1.75€)
*** ANTE/BLINDS ***
2143658709 posts small blind 0.01€
jmc28100 posts big blind 0.02€
Dealt to jelachatte [Kh 4d 4h 9c]
*** PRE-FLOP *** 
doc81 calls 0.02€
n13tless folds
jelachatte folds
Yo_Mama calls 0.02€
2143658709 calls 0.01€
jmc28100 checks
*** FLOP *** [5s 2c Jh]
2143658709 checks
jmc28100 checks
doc81 checks
Yo_Mama checks
*** TURN *** [5s 2c Jh][Qd]
2143658709 bets 0.08€
jmc28100 calls 0.08€
doc81 calls 0.08€
Yo_Mama folds
*** RIVER *** [5s 2c Jh Qd][5h]
2143658709 bets 0.16€
jmc28100 folds
doc81 folds
2143658709 collected 0.45€ from pot
*** SUMMARY ***
Total pot 0.45€ | Rake 0.03€
Board: [5s 2c Jh Qd 5h]
Seat 1: 2143658709 (small blind) won 0.45€


Winamax Poker - Go Fast "Bucarest" - HandId: #16870380-6334-1643807868 - Omaha pot limit (0.01€/0.02€) - 2022/02/02 13:17:48 UTC
Table: 'Bucarest' 6-max (real money) Seat #6 is the button
Seat 1: Yo_Mama (1.73€)
Seat 2: doc81 (3.78€)
Seat 3: jelachatte (4.73€)
Seat 4: jmc28100 (4.67€)
Seat 5: n13tless (3.76€)
Seat 6: Alpha_Golf (0.18€)
*** ANTE/BLINDS ***
Yo_Mama posts small blind 0.01€
doc81 posts big blind 0.02€
Dealt to jelachatte [5h 2h 4h 5s]
*** PRE-FLOP *** 
jelachatte folds
jmc28100 calls 0.02€
n13tless folds
Alpha_Golf raises 0.02€ to 0.04€
Yo_Mama folds
doc81 calls 0.02€
jmc28100 calls 0.02€
*** FLOP *** [3d 8c 7h]
doc81 checks
jmc28100 checks
Alpha_Golf checks
*** TURN *** [3d 8c 7h][3h]
doc81 checks
jmc28100 checks
Alpha_Golf checks
*** RIVER *** [3d 8c 7h 3h][Js]
doc81 bets 0.13€
jmc28100 raises 0.39€ to 0.52€
Alpha_Golf folds
doc81 folds
jmc28100 collected 0.74€ from pot
*** SUMMARY ***
Total pot 0.74€ | Rake 0.04€
Board: [3d 8c 7h 3h Js]
Seat 4: jmc28100 won 0.74€


Winamax Poker - Go Fast "Bucarest" - HandId: #16870380-6337-1643808175 - Omaha pot limit (0.01€/0.02€) - 2022/02/02 13:22:55 UTC
Table: 'Bucarest' 6-max (real money) Seat #6 is the button
Seat 1: jmc28100 (2.99€)
Seat 2: jelachatte (4.73€)
Seat 3: doc81 (3.26€)
Seat 4: n13tless (3.67€)
Seat 5: 2143658709 (4.09€)
Seat 6: Yo_Mama (1.70€)
Hold-up to Pot: total 0.20€
*** ANTE/BLINDS ***
jmc28100 posts small blind 0.01€
jelachatte posts big blind 0.02€
Dealt to jelachatte [Jd 9c 6h 4h]
*** PRE-FLOP *** 
doc81 calls 0.02€
n13tless calls 0.02€
2143658709 calls 0.02€
Yo_Mama calls 0.02€
jmc28100 calls 0.01€
jelachatte checks
*** FLOP *** [Ks 7c 3d]
jmc28100 checks
jelachatte checks
doc81 checks
n13tless checks
2143658709 checks
Yo_Mama bets 0.14€
jmc28100 calls 0.14€
jelachatte folds
doc81 calls 0.14€
n13tless folds
2143658709 folds
*** TURN *** [Ks 7c 3d][Qs]
jmc28100 checks
doc81 checks
Yo_Mama bets 0.37€
jmc28100 calls 0.37€
doc81 folds
*** RIVER *** [Ks 7c 3d Qs][3h]
jmc28100 bets 1.48€
Yo_Mama folds
jmc28100 collected 2.83€ from pot
*** SUMMARY ***
Total pot 2.83€ | Rake 0.13€
Board: [Ks 7c 3d Qs 3h]
Seat 1: jmc28100 (small blind) won 2.83€


Winamax Poker - Go Fast "Bucarest" - HandId: #16870380-6338-1643808263 - Omaha pot limit (0.01€/0.02€) - 2022/02/02 13:24:23 UTC
Table: 'Bucarest' 6-max (real money) Seat #6 is the button
Seat 1: jelachatte (4.71€)
Seat 2: la volubile (2€)
Seat 3: doc81 (3.10€)
Seat 4: Yo_Mama (1.17€)
Seat 5: 2143658709 (4.07€)
Seat 6: n13tless (3.65€)
Hold-up to Pot: total 0.10€
*** ANTE/BLINDS ***
jelachatte posts small blind 0.01€
la volubile posts big blind 0.02€
Dealt to jelachatte [Tc 2c Jc Ad]
*** PRE-FLOP *** 
doc81 calls 0.02€
Yo_Mama calls 0.02€
2143658709 calls 0.02€
n13tless calls 0.02€
jelachatte folds
la volubile checks
*** FLOP *** [4c Jd Ks]
la volubile checks
doc81 checks
Yo_Mama bets 0.12€
2143658709 calls 0.12€
n13tless calls 0.12€
la volubile folds
doc81 calls 0.12€
*** TURN *** [4c Jd Ks][Td]
doc81 checks
Yo_Mama bets 0.46€
2143658709 folds
n13tless folds
doc81 folds
Yo_Mama collected 1.09€ from pot
*** SUMMARY ***
Total pot 1.09€ | Rake 0.06€
Board: [4c Jd Ks Td]
Seat 4: Yo_Mama won 1.09€


Winamax Poker - Go Fast "Bucarest" - HandId: #16870380-6339-1643808335 - Omaha pot limit (0.01€/0.02€) - 2022/02/02 13:25:35 UTC
Table: 'Bucarest' 6-max (real money) Seat #6 is the button
Seat 1: la volubile (1.98€)
Seat 2: doc81 (2.96€)
Seat 3: Yo_Mama (1.66€)
Seat 4: jmc28100 (3.81€)
Seat 5: jelachatte (4.70€)
Seat 6: n13tless (3.51€)
*** ANTE/BLINDS ***
la volubile posts small blind 0.01€
doc81 posts big blind 0.02€
Dealt to jelachatte [Jh 3c Jd 5h]
*** PRE-FLOP *** 
Yo_Mama folds
jmc28100 folds
jelachatte raises 0.05€ to 0.07€
n13tless calls 0.07€
la volubile folds
doc81 calls 0.05€
*** FLOP *** [Kh 9c 7d]
doc81 checks
jelachatte checks
n13tless checks
*** TURN *** [Kh 9c 7d][9d]
doc81 checks
jelachatte bets 0.11€
n13tless folds
doc81 calls 0.11€
*** RIVER *** [Kh 9c 7d 9d][6s]
doc81 checks
jelachatte checks
*** SHOW DOWN ***
jelachatte shows [Jh 3c Jd 5h] (Two pairs : Jacks and 9)
doc81 shows [Ks 3h 4s 4h] (Two pairs : Kings and 9)
doc81 collected 0.40€ from pot
*** SUMMARY ***
Total pot 0.40€ | Rake 0.04€
Board: [Kh 9c 7d 9d 6s]
Seat 2: doc81 (big blind) showed [Ks 3h 4s 4h] and won 0.40€ with Two pairs : Kings and 9
Seat 5: jelachatte showed [Jh 3c Jd 5h] and lost with Two pairs : Jacks and 9


Winamax Poker - Go Fast "Bucarest" - HandId: #16870380-6341-1643808469 - Omaha pot limit (0.01€/0.02€) - 2022/02/02 13:27:49 UTC
Table: 'Bucarest' 6-max (real money) Seat #6 is the button
Seat 1: n13tless (3.34€)
Seat 2: Yo_Mama (1.87€)
Seat 3: doc81 (3.16€)
Seat 4: la volubile (1.95€)
Seat 5: jelachatte (4.52€)
Seat 6: 2143658709 (3.93€)
*** ANTE/BLINDS ***
n13tless posts small blind 0.01€
Yo_Mama posts big blind 0.02€
Dealt to jelachatte [2d 2h 6c 5d]
*** PRE-FLOP *** 
doc81 calls 0.02€
la volubile calls 0.02€
jelachatte folds
2143658709 calls 0.02€
n13tless folds
Yo_Mama raises 0.08€ to 0.10€
doc81 calls 0.08€
la volubile calls 0.08€
2143658709 calls 0.08€
*** FLOP *** [Ac Kh Kd]
Yo_Mama checks
doc81 checks
la volubile checks
2143658709 checks
*** TURN *** [Ac Kh Kd][8d]
Yo_Mama bets 0.18€
doc81 folds
la volubile folds
2143658709 folds
Yo_Mama collected 0.55€ from pot
*** SUMMARY ***
Total pot 0.55€ | Rake 0.04€
Board: [Ac Kh Kd 8d]
Seat 2: Yo_Mama (big blind) won 0.55€


Winamax Poker - Go Fast "Bucarest" - HandId: #16870380-6342-1643808533 - Omaha pot limit (0.01€/0.02€) - 2022/02/02 13:28:53 UTC
Table: 'Bucarest' 6-max (real money) Seat #6 is the button
Seat 1: 2143658709 (3.83€)
Seat 2: doc81 (3.06€)
Seat 3: n13tless (3.33€)
Seat 4: jelachatte (4.52€)
Seat 5: la volubile (1.85€)
Seat 6: Yo_Mama (2.14€)
*** ANTE/BLINDS ***
2143658709 posts small blind 0.01€
doc81 posts big blind 0.02€
Dealt to jelachatte [3c 8c 6s Ad]
*** PRE-FLOP *** 
n13tless folds
jelachatte folds
la volubile calls 0.02€
Yo_Mama raises 0.02€ to 0.04€
2143658709 calls 0.03€
doc81 calls 0.02€
la volubile calls 0.02€
*** FLOP *** [Tc 9s 6d]
2143658709 checks
doc81 checks
la volubile checks
Yo_Mama checks
*** TURN *** [Tc 9s 6d][Qc]
2143658709 bets 0.11€
doc81 calls 0.11€
la volubile folds
Yo_Mama calls 0.11€
*** RIVER *** [Tc 9s 6d Qc][3s]
2143658709 bets 0.37€
doc81 calls 0.37€
Yo_Mama folds
*** SHOW DOWN ***
2143658709 shows [3d 2c Jh Ac] (One pair : 3)
doc81 shows [8d 9d 7c Jd] (Straight Queen high)
doc81 collected 1.11€ from pot
*** SUMMARY ***
Total pot 1.11€ | Rake 0.12€
Board: [Tc 9s 6d Qc 3s]
Seat 1: 2143658709 (small blind) showed [3d 2c Jh Ac] and lost with One pair : 3
Seat 2: doc81 (big blind) showed [8d 9d 7c Jd] and won 1.11€ with Straight Queen high


Winamax Poker - Go Fast "Bucarest" - HandId: #16870380-6343-1643808606 - Omaha pot limit (0.01€/0.02€) - 2022/02/02 13:30:06 UTC
Table: 'Bucarest' 6-max (real money) Seat #6 is the button
Seat 1: doc81 (3.65€)
Seat 2: Epouvantable (2€)
Seat 3: jelachatte (4.52€)
Seat 4: n13tless (3.33€)
Seat 5: Yo_Mama (1.99€)
Seat 6: la volubile (1.81€)
Hold-up to Pot: total 0.10€
*** ANTE/BLINDS ***
doc81 posts small blind 0.01€
Epouvantable posts big blind 0.02€
Dealt to jelachatte [Jh Qd Js Ac]
*** PRE-FLOP *** 
jelachatte raises 0.05€ to 0.07€
n13tless calls 0.07€
Yo_Mama calls 0.07€
la volubile calls 0.07€
doc81 calls 0.06€
Epouvantable calls 0.05€
*** FLOP *** [9d 3h Ad]
doc81 checks
Epouvantable checks
jelachatte bets 0.26€
n13tless folds
Yo_Mama folds
la volubile calls 0.26€
doc81 calls 0.26€
Epouvantable folds
*** TURN *** [9d 3h Ad][7d]
doc81 checks
jelachatte checks
la volubile checks
*** RIVER *** [9d 3h Ad 7d][8h]
doc81 checks
jelachatte checks
la volubile bets 0.65€
doc81 calls 0.65€
jelachatte folds
*** SHOW DOWN ***
la volubile shows [Jc Ts Qh Ks] (Straight Jack high)
doc81 shows [Ah Kc 5d Jd] (Flush Ace high)
doc81 collected 2.35€ from pot
*** SUMMARY ***
Total pot 2.35€ | Rake 0.25€
Board: [9d 3h Ad 7d 8h]
Seat 1: doc81 (small blind) showed [Ah Kc 5d Jd] and won 2.35€ with Flush Ace high
Seat 6: la volubile (button) showed [Jc Ts Qh Ks] and lost with Straight Jack high


Winamax Poker - Go Fast "Bucarest" - HandId: #16870380-6344-1643808677 - Omaha pot limit (0.01€/0.02€) - 2022/02/02 13:31:17 UTC
Table: 'Bucarest' 6-max (real money) Seat #6 is the button
Seat 1: Epouvantable (1.93€)
Seat 2: jelachatte (4.19€)
Seat 3: Yo_Mama (1.92€)
Seat 4: doc81 (5.02€)
Seat 5: n13tless (3.26€)
Seat 6: la volubile (0.83€)
*** ANTE/BLINDS ***
Epouvantable posts small blind 0.01€
jelachatte posts big blind 0.02€
Dealt to jelachatte [2c Qs 7h Ah]
*** PRE-FLOP *** 
Yo_Mama folds
doc81 calls 0.02€
n13tless folds
la volubile calls 0.02€
Epouvantable raises 0.02€ to 0.04€
jelachatte calls 0.02€
doc81 calls 0.02€
la volubile calls 0.02€
*** FLOP *** [Ks Ac 2d]
Epouvantable bets 0.16€
jelachatte calls 0.16€
doc81 folds
la volubile folds
*** TURN *** [Ks Ac 2d][6h]
Epouvantable checks
jelachatte bets 0.32€
Epouvantable folds
jelachatte collected 0.75€ from pot
*** SUMMARY ***
Total pot 0.75€ | Rake 0.05€
Board: [Ks Ac 2d 6h]
Seat 2: jelachatte (big blind) won 0.75€


Winamax Poker - Go Fast "Bucarest" - HandId: #16870380-6345-1643808743 - Omaha pot limit (0.01€/0.02€) - 2022/02/02 13:32:23 UTC
Table: 'Bucarest' 6-max (real money) Seat #5 is the button
Seat 1: jelachatte (4.42€)
Seat 2: Yo_Mama (1.92€)
Seat 3: Epouvantable (1.73€)
Seat 4: doc81 (4.98€)
Seat 5: n13tless (3.26€)
*** ANTE/BLINDS ***
jelachatte posts small blind 0.01€
Yo_Mama posts big blind 0.02€
Dealt to jelachatte [9c 7d As 6d]
*** PRE-FLOP *** 
Epouvantable calls 0.02€
doc81 calls 0.02€
n13tless folds
jelachatte folds
Yo_Mama raises 0.07€ to 0.09€
Epouvantable calls 0.07€
doc81 calls 0.07€
*** FLOP *** [Qc 9h Th]
Yo_Mama checks
Epouvantable bets 0.02€
doc81 calls 0.02€
Yo_Mama folds
*** TURN *** [Qc 9h Th][3d]
Epouvantable checks
doc81 checks
*** RIVER *** [Qc 9h Th 3d][6h]
Epouvantable bets 0.02€
doc81 raises 0.36€ to 0.38€
Epouvantable calls 0.36€
*** SHOW DOWN ***
doc81 shows [8c Ad Qd Kd] (One pair : Queens)
Epouvantable shows [5h 2h 8d 4h] (Flush Ten high)
Epouvantable collected 0.97€ from pot
*** SUMMARY ***
Total pot 0.97€ | Rake 0.11€
Board: [Qc 9h Th 3d 6h]
Seat 3: Epouvantable showed [5h 2h 8d 4h] and won 0.97€ with Flush Ten high
Seat 4: doc81 showed [8c Ad Qd Kd] and lost with One pair : Queens


Winamax Poker - Go Fast "Bucarest" - HandId: #16870380-6346-1643808807 - Omaha pot limit (0.01€/0.02€) - 2022/02/02 13:33:27 UTC
Table: 'Bucarest' 6-max (real money) Seat #6 is the button
Seat 1: Yo_Mama (1.83€)
Seat 2: TorviCalls (2€)
Seat 3: doc81 (4.49€)
Seat 4: Epouvantable (2.21€)
Seat 5: jelachatte (4.41€)
Seat 6: n13tless (3.26€)
*** ANTE/BLINDS ***
Yo_Mama posts small blind 0.01€
TorviCalls posts big blind 0.02€
Dealt to jelachatte [4c Ks Js 3c]
*** PRE-FLOP *** 
doc81 calls 0.02€
Epouvantable raises 0.02€ to 0.04€
jelachatte folds
n13tless calls 0.04€
Yo_Mama calls 0.03€
TorviCalls calls 0.02€
doc81 raises 0.20€ to 0.24€
Epouvantable calls 0.20€
n13tless raises 0.80€ to 1.04€
Yo_Mama folds
TorviCalls folds
doc81 calls 0.80€
Epouvantable calls 0.80€
*** FLOP *** [Ts Th Qd]
doc81 bets 3.20€
Epouvantable folds
n13tless calls 2.22€ and is all-in
*** TURN *** [Ts Th Qd][7d]
*** RIVER *** [Ts Th Qd 7d][6s]
*** SHOW DOWN ***
doc81 shows [2h Qh 6d 5s] (Two pairs : Queens and Tens)
n13tless shows [Tc Ac 3d 2d] (Trips of Tens)
n13tless collected 6.94€ from main pot
doc81 collected 0.98€ from side pot 1
*** SUMMARY ***
Total pot 7.92€ | Rake 0.70€
Board: [Ts Th Qd 7d 6s]
Seat 3: doc81 showed [2h Qh 6d 5s] and won 0.98€ with Two pairs : Queens and Tens
Seat 6: n13tless (button) showed [Tc Ac 3d 2d] and won 6.94€ with Trips of Tens


Winamax Poker - Go Fast "Bucarest" - HandId: #16870380-6347-1643808883 - Omaha pot limit (0.01€/0.02€) - 2022/02/02 13:34:43 UTC
Table: 'Bucarest' 6-max (real money) Seat #6 is the button
Seat 1: TorviCalls (2€)
Seat 2: Neophyte37 (2€)
Seat 3: doc81 (1.23€)
Seat 4: Yo_Mama (1.79€)
Seat 5: Epouvantable (1.17€)
Seat 6: jelachatte (4.41€)
*** ANTE/BLINDS ***
TorviCalls posts small blind 0.01€
Neophyte37 posts big blind 0.02€
Dealt to jelachatte [Tc 2s 9c Kd]
*** PRE-FLOP *** 
doc81 raises 0.05€ to 0.07€
Yo_Mama calls 0.07€
Epouvantable raises 0.05€ to 0.12€
jelachatte folds
TorviCalls folds
Neophyte37 folds
doc81 raises 0.34€ to 0.46€
Yo_Mama calls 0.39€
Epouvantable calls 0.34€
*** FLOP *** [Jh 6s 7d]
doc81 bets 0.77€ and is all-in
Yo_Mama raises 0.56€ to 1.33€ and is all-in
Epouvantable calls 0.71€ and is all-in
*** TURN *** [Jh 6s 7d][5h]
*** RIVER *** [Jh 6s 7d 5h][6d]
*** SHOW DOWN ***
doc81 shows [2h 4d 8d 5s] (Straight 8 high)
Epouvantable shows [9h Ts Qs Kh] (One pair : 6)
Yo_Mama shows [9d 3h 8s 7s] (Straight 9 high)
Yo_Mama collected 3.85€ from pot
*** SUMMARY ***
Total pot 3.85€ | Rake 0.37€
Board: [Jh 6s 7d 5h 6d]
Seat 3: doc81 showed [2h 4d 8d 5s] and lost with Straight 8 high
Seat 4: Yo_Mama showed [9d 3h 8s 7s] and won 3.85€ with Straight 9 high
Seat 5: Epouvantable showed [9h Ts Qs Kh] and lost with One pair : 6


Winamax Poker - Go Fast "Bucarest" - HandId: #16870380-6348-1643808935 - Omaha pot limit (0.01€/0.02€) - 2022/02/02 13:35:35 UTC
Table: 'Bucarest' 6-max (real money) Seat #3 is the button
Seat 1: n13tless (6.94€)
Seat 2: TorviCalls (1.99€)
Seat 3: jelachatte (4.41€)
Hold-up to Pot: total 0.10€
*** ANTE/BLINDS ***
n13tless posts small blind 0.01€
TorviCalls posts big blind 0.02€
Dealt to jelachatte [6h 3s Ks Jc]
*** PRE-FLOP *** 
jelachatte folds
n13tless raises 0.04€ to 0.06€
TorviCalls calls 0.04€
*** FLOP *** [8s 3h Tc]
n13tless bets 0.08€
TorviCalls calls 0.08€
*** TURN *** [8s 3h Tc][6d]
n13tless checks
TorviCalls checks
*** RIVER *** [8s 3h Tc 6d][7s]
n13tless checks
TorviCalls bets 0.38€
n13tless folds
TorviCalls collected 0.73€ from pot
*** SUMMARY ***
Total pot 0.73€ | Rake 0.03€
Board: [8s 3h Tc 6d 7s]
Seat 2: TorviCalls (big blind) won 0.73€


Winamax Poker - Go Fast "Bucarest" - HandId: #16870380-6349-1643808967 - Omaha pot limit (0.01€/0.02€) - 2022/02/02 13:36:07 UTC
Table: 'Bucarest' 6-max (real money) Seat #4 is the button
Seat 1: jelachatte (4.41€)
Seat 2: n13tless (6.80€)
Seat 3: TorviCalls (2.20€)
Seat 4: Yo_Mama (3.85€)
Hold-up to Pot: total 0.10€
*** ANTE/BLINDS ***
jelachatte posts small blind 0.01€
n13tless posts big blind 0.02€
Dealt to jelachatte [9d Qd 4s 9c]
*** PRE-FLOP *** 
TorviCalls calls 0.02€
Yo_Mama folds
jelachatte folds
n13tless checks
*** FLOP *** [Kc Ad Js]
n13tless checks
TorviCalls checks
*** TURN *** [Kc Ad Js][5c]
n13tless checks
TorviCalls checks
*** RIVER *** [Kc Ad Js 5c][Qh]
n13tless bets 0.15€
TorviCalls raises 0.45€ to 0.60€
n13tless calls 0.45€
*** SHOW DOWN ***
n13tless shows [6h As Th 4h] (Straight Ace high)
TorviCalls shows [Td Kh 8h 6s] (Straight Ace high)
TorviCalls collected 0.61€ from pot
n13tless collected 0.61€ from pot
*** SUMMARY ***
Total pot 1.22€ | Rake 0.13€
Board: [Kc Ad Js 5c Qh]
Seat 2: n13tless (big blind) showed [6h As Th 4h] and won 0.61€ with Straight Ace high
Seat 3: TorviCalls showed [Td Kh 8h 6s] and won 0.61€ with Straight Ace high


Winamax Poker - Go Fast "Bucarest" - HandId: #16870380-6350-1643809002 - Omaha pot limit (0.01€/0.02€) - 2022/02/02 13:36:42 UTC
Table: 'Bucarest' 6-max (real money) Seat #4 is the button
Seat 1: n13tless (6.79€)
Seat 2: TorviCalls (2.19€)
Seat 3: Yo_Mama (3.85€)
Seat 4: jelachatte (4.40€)
*** ANTE/BLINDS ***
n13tless posts small blind 0.01€
TorviCalls posts big blind 0.02€
Dealt to jelachatte [6c Ac 3d Ts]
*** PRE-FLOP *** 
Yo_Mama raises 0.04€ to 0.06€
jelachatte calls 0.06€
n13tless folds
TorviCalls calls 0.04€
*** FLOP *** [7s 8c 9c]
TorviCalls checks
Yo_Mama checks
jelachatte bets 0.19€
TorviCalls calls 0.19€
Yo_Mama folds
*** TURN *** [7s 8c 9c][6d]
TorviCalls checks
jelachatte bets 0.57€
TorviCalls folds
jelachatte collected 1.08€ from pot
*** SUMMARY ***
Total pot 1.08€ | Rake 0.06€
Board: [7s 8c 9c 6d]
Seat 4: jelachatte (button) won 1.08€


Winamax Poker - Go Fast "Bucarest" - HandId: #16870380-6351-1643809088 - Omaha pot limit (0.01€/0.02€) - 2022/02/02 13:38:08 UTC
Table: 'Bucarest' 6-max (real money) Seat #4 is the button
Seat 1: TorviCalls (1.94€)
Seat 2: jelachatte (4.66€)
Seat 3: n13tless (6.78€)
Seat 4: Yo_Mama (3.79€)
*** ANTE/BLINDS ***
TorviCalls posts small blind 0.01€
jelachatte posts big blind 0.02€
Dealt to jelachatte [Kc Ac Jc 3d]
*** PRE-FLOP *** 
n13tless folds
Yo_Mama calls 0.02€
TorviCalls calls 0.01€
jelachatte raises 0.06€ to 0.08€
Yo_Mama calls 0.06€
TorviCalls calls 0.06€
*** FLOP *** [3s Qd 4h]
TorviCalls checks
jelachatte checks
Yo_Mama bets 0.14€
TorviCalls raises 0.52€ to 0.66€
jelachatte folds
Yo_Mama calls 0.52€
*** TURN *** [3s Qd 4h][2d]
TorviCalls bets 1.20€ and is all-in
Yo_Mama calls 1.20€
*** RIVER *** [3s Qd 4h 2d][Qh]
*** SHOW DOWN ***
Yo_Mama shows [Tc 6c 5d 5s] (Straight 6 high)
TorviCalls shows [Ah 7d Qc 4d] (Full of Queens and 4)
TorviCalls collected 3.56€ from pot
*** SUMMARY ***
Total pot 3.56€ | Rake 0.40€
Board: [3s Qd 4h 2d Qh]
Seat 1: TorviCalls (small blind) showed [Ah 7d Qc 4d] and won 3.56€ with Full of Queens and 4
Seat 4: Yo_Mama (button) showed [Tc 6c 5d 5s] and lost with Straight 6 high


Winamax Poker - Go Fast "Bucarest" - HandId: #16870380-6352-1643809149 - Omaha pot limit (0.01€/0.02€) - 2022/02/02 13:39:09 UTC
Table: 'Bucarest' 6-max (real money) Seat #4 is the button
Seat 1: jelachatte (4.58€)
Seat 2: Yo_Mama (1.85€)
Seat 3: TorviCalls (3.56€)
Seat 4: n13tless (6.78€)
Hold-up to Pot: total 0.10€
*** ANTE/BLINDS ***
jelachatte posts small blind 0.01€
Yo_Mama posts big blind 0.02€
Dealt to jelachatte [2h 9c Js 2c]
*** PRE-FLOP *** 
TorviCalls raises 0.04€ to 0.06€
n13tless calls 0.06€
jelachatte folds
Yo_Mama calls 0.04€
*** FLOP *** [Th 5c 8h]
Yo_Mama checks
TorviCalls checks
n13tless bets 0.14€
Yo_Mama folds
TorviCalls folds
n13tless collected 0.41€ from pot
*** SUMMARY ***
Total pot 0.41€ | Rake 0.02€
Board: [Th 5c 8h]
Seat 4: n13tless (button) won 0.41€


Winamax Poker - Go Fast "Bucarest" - HandId: #16870380-6353-1643809192 - Omaha pot limit (0.01€/0.02€) - 2022/02/02 13:39:52 UTC
Table: 'Bucarest' 6-max (real money) Seat #4 is the button
Seat 1: Yo_Mama (1.79€)
Seat 2: n13tless (6.99€)
Seat 3: jelachatte (4.57€)
Seat 4: TorviCalls (3.50€)
*** ANTE/BLINDS ***
Yo_Mama posts small blind 0.01€
n13tless posts big blind 0.02€
Dealt to jelachatte [5d 9c Js 7c]
*** PRE-FLOP *** 
jelachatte folds
TorviCalls raises 0.03€ to 0.05€
Yo_Mama calls 0.04€
n13tless raises 0.15€ to 0.20€
TorviCalls calls 0.15€
Yo_Mama calls 0.15€
*** FLOP *** [Ah 4c 6s]
Yo_Mama checks
n13tless bets 0.60€
TorviCalls folds
Yo_Mama calls 0.60€
*** TURN *** [Ah 4c 6s][6c]
Yo_Mama checks
n13tless checks
*** RIVER *** [Ah 4c 6s 6c][9s]
Yo_Mama checks
n13tless bets 1€
Yo_Mama folds
n13tless collected 2.62€ from pot
*** SUMMARY ***
Total pot 2.62€ | Rake 0.18€
Board: [Ah 4c 6s 6c 9s]
Seat 2: n13tless (big blind) won 2.62€


Winamax Poker - Go Fast "Bucarest" - HandId: #16870380-6354-1643809270 - Omaha pot limit (0.01€/0.02€) - 2022/02/02 13:41:10 UTC
Table: 'Bucarest' 6-max (real money) Seat #4 is the button
Seat 1: Yo_Mama (0.99€)
Seat 2: n13tless (7.81€)
Seat 3: TorviCalls (3.30€)
Seat 4: jelachatte (4.57€)
*** ANTE/BLINDS ***
Yo_Mama posts small blind 0.01€
n13tless posts big blind 0.02€
Dealt to jelachatte [7s 5h 4d 5d]
*** PRE-FLOP *** 
TorviCalls raises 0.03€ to 0.05€
jelachatte folds
Yo_Mama raises 0.12€ to 0.17€
n13tless folds
TorviCalls calls 0.12€
*** FLOP *** [4c Ah Tc]
Yo_Mama bets 0.36€
TorviCalls raises 0.36€ to 0.72€
Yo_Mama raises 0.10€ to 0.82€ and is all-in
TorviCalls calls 0.10€
*** TURN *** [4c Ah Tc][9c]
*** RIVER *** [4c Ah Tc 9c][Kh]
*** SHOW DOWN ***
Yo_Mama shows [Kd Qs 8s Ad] (Two pairs : Aces and Kings)
TorviCalls shows [Kc 7d 2h As] (Two pairs : Aces and Kings)
TorviCalls collected 0.90€ from pot
Yo_Mama collected 0.90€ from pot
*** SUMMARY ***
Total pot 1.80€ | Rake 0.20€
Board: [4c Ah Tc 9c Kh]
Seat 1: Yo_Mama (small blind) showed [Kd Qs 8s Ad] and won 0.90€ with Two pairs : Aces and Kings
Seat 3: TorviCalls showed [Kc 7d 2h As] and won 0.90€ with Two pairs : Aces and Kings


Winamax Poker - Go Fast "Bucarest" - HandId: #16870380-6355-1643809313 - Omaha pot limit (0.01€/0.02€) - 2022/02/02 13:41:53 UTC
Table: 'Bucarest' 6-max (real money) Seat #4 is the button
Seat 1: n13tless (7.79€)
Seat 2: TorviCalls (3.21€)
Seat 3: Yo_Mama (0.90€)
Seat 4: jelachatte (4.57€)
Hold-up to Pot: total 0.10€
*** ANTE/BLINDS ***
n13tless posts small blind 0.01€
TorviCalls posts big blind 0.02€
Dealt to jelachatte [As 9d Kd 5d]
*** PRE-FLOP *** 
Yo_Mama raises 0.04€ to 0.06€
jelachatte folds
n13tless calls 0.05€
TorviCalls calls 0.04€
*** FLOP *** [2d 9c 6c]
n13tless checks
TorviCalls checks
Yo_Mama checks
*** TURN *** [2d 9c 6c][4s]
n13tless checks
TorviCalls bets 0.14€
Yo_Mama folds
n13tless calls 0.14€
*** RIVER *** [2d 9c 6c 4s][7d]
n13tless checks
TorviCalls checks
*** SHOW DOWN ***
n13tless shows [6h Jh 8d 2s] (Two pairs : 6 and 2)
TorviCalls shows [3s 4d 4h 8s] (Trips of 4)
TorviCalls collected 0.51€ from pot
*** SUMMARY ***
Total pot 0.51€ | Rake 0.05€
Board: [2d 9c 6c 4s 7d]
Seat 1: n13tless (small blind) showed [6h Jh 8d 2s] and lost with Two pairs : 6 and 2
Seat 2: TorviCalls (big blind) showed [3s 4d 4h 8s] and won 0.51€ with Trips of 4


Winamax Poker - Go Fast "Bucarest" - HandId: #16870380-6356-1643809359 - Omaha pot limit (0.01€/0.02€) - 2022/02/02 13:42:39 UTC
Table: 'Bucarest' 6-max (real money) Seat #6 is the button
Seat 1: TorviCalls (3.52€)
Seat 2: Yo_Mama (0.84€)
Seat 3: n13tless (7.59€)
Seat 4: Mahendra96 (2€)
Seat 5: lucho01 (2€)
Seat 6: jelachatte (4.57€)
Hold-up to Pot: total 0.10€
*** ANTE/BLINDS ***
TorviCalls posts small blind 0.01€
Yo_Mama posts big blind 0.02€
Dealt to jelachatte [Ah 4c 2c 6c]
*** PRE-FLOP *** 
n13tless folds
Mahendra96 folds
lucho01 raises 0.02€ to 0.04€
jelachatte folds
TorviCalls raises 0.06€ to 0.10€
Yo_Mama calls 0.08€
lucho01 calls 0.06€
*** FLOP *** [7d 5c Th]
TorviCalls bets 0.15€
Yo_Mama calls 0.15€
lucho01 folds
*** TURN *** [7d 5c Th][9h]
TorviCalls checks
Yo_Mama bets 0.59€ and is all-in
TorviCalls folds
Yo_Mama collected 1.23€ from pot
*** SUMMARY ***
Total pot 1.23€ | Rake 0.06€
Board: [7d 5c Th 9h]
Seat 2: Yo_Mama (big blind) won 1.23€


Winamax Poker - Go Fast "Bucarest" - HandId: #16870380-6357-1643809458 - Omaha pot limit (0.01€/0.02€) - 2022/02/02 13:44:18 UTC
Table: 'Bucarest' 6-max (real money) Seat #5 is the button
Seat 1: jelachatte (4.57€)
Seat 2: lucho01 (1.90€)
Seat 3: Yo_Mama (1.23€)
Seat 4: TorviCalls (3.27€)
Seat 5: n13tless (7.59€)
Hold-up to Pot: total 0.10€
*** ANTE/BLINDS ***
jelachatte posts small blind 0.01€
lucho01 posts big blind 0.02€
Dealt to jelachatte [6h 5d 6c Ah]
*** PRE-FLOP *** 
Yo_Mama folds
TorviCalls raises 0.04€ to 0.06€
n13tless calls 0.06€
jelachatte calls 0.05€
lucho01 calls 0.04€
*** FLOP *** [5h 3s Tc]
jelachatte checks
lucho01 checks
TorviCalls checks
n13tless checks
*** TURN *** [5h 3s Tc][Qs]
jelachatte checks
lucho01 bets 0.02€
TorviCalls calls 0.02€
n13tless folds
jelachatte folds
*** RIVER *** [5h 3s Tc Qs][2d]
lucho01 bets 0.38€
TorviCalls calls 0.38€
*** SHOW DOWN ***
TorviCalls shows [As 9h 2c Qh] (Two pairs : Queens and 2)
lucho01 shows [4c 5s 2h 6s] (Straight 6 high)
lucho01 collected 1.04€ from pot
*** SUMMARY ***
Total pot 1.04€ | Rake 0.10€
Board: [5h 3s Tc Qs 2d]
Seat 2: lucho01 (big blind) showed [4c 5s 2h 6s] and won 1.04€ with Straight 6 high
Seat 4: TorviCalls showed [As 9h 2c Qh] and lost with Two pairs : Queens and 2


Winamax Poker - Go Fast "Bucarest" - HandId: #16870380-6358-1643809566 - Omaha pot limit (0.01€/0.02€) - 2022/02/02 13:46:06 UTC
Table: 'Bucarest' 6-max (real money) Seat #5 is the button
Seat 1: lucho01 (2.48€)
Seat 2: TorviCalls (2.81€)
Seat 3: jelachatte (4.51€)
Seat 4: n13tless (7.53€)
Seat 5: Yo_Mama (1.23€)
*** ANTE/BLINDS ***
lucho01 posts small blind 0.01€
TorviCalls posts big blind 0.02€
Dealt to jelachatte [6c 3s Kc 6h]
*** PRE-FLOP *** 
jelachatte folds
n13tless raises 0.03€ to 0.05€
Yo_Mama calls 0.05€
lucho01 folds
TorviCalls calls 0.03€
*** FLOP *** [Qh Qc Th]
TorviCalls checks
n13tless bets 0.08€
Yo_Mama folds
TorviCalls folds
n13tless collected 0.22€ from pot
*** SUMMARY ***
Total pot 0.22€ | Rake 0.02€
Board: [Qh Qc Th]
Seat 4: n13tless won 0.22€


Winamax Poker - Go Fast "Bucarest" - HandId: #16870380-6359-1643809726 - Omaha pot limit (0.01€/0.02€) - 2022/02/02 13:48:46 UTC
Table: 'Bucarest' 6-max (real money) Seat #4 is the button
Seat 1: n13tless (7.62€)
Seat 2: jelachatte (4.51€)
Seat 3: TorviCalls (2.76€)
Seat 4: Yo_Mama (1.18€)
*** ANTE/BLINDS ***
n13tless posts small blind 0.01€
jelachatte posts big blind 0.02€
Dealt to jelachatte [Jd 7h 4d Qs]
*** PRE-FLOP *** 
TorviCalls calls 0.02€
Yo_Mama folds
n13tless calls 0.01€
jelachatte checks
*** FLOP *** [6h 8h 3d]
n13tless checks
jelachatte checks
TorviCalls checks
*** TURN *** [6h 8h 3d][Ks]
n13tless checks
jelachatte checks
TorviCalls bets 0.06€
n13tless calls 0.06€
jelachatte folds
*** RIVER *** [6h 8h 3d Ks][Ts]
n13tless checks
TorviCalls bets 0.09€
n13tless calls 0.09€
*** SHOW DOWN ***
n13tless shows [Tc Th 9s 6s] (Trips of Tens)
TorviCalls shows [6c 9h 7c Kc] (Straight Ten high)
TorviCalls collected 0.32€ from pot
*** SUMMARY ***
Total pot 0.32€ | Rake 0.04€
Board: [6h 8h 3d Ks Ts]
Seat 1: n13tless (small blind) showed [Tc Th 9s 6s] and lost with Trips of Tens
Seat 3: TorviCalls showed [6c 9h 7c Kc] and won 0.32€ with Straight Ten high


Winamax Poker - Go Fast "Bucarest" - HandId: #16870380-6360-1643809764 - Omaha pot limit (0.01€/0.02€) - 2022/02/02 13:49:24 UTC
Table: 'Bucarest' 6-max (real money) Seat #4 is the button
Seat 1: TorviCalls (2.91€)
Seat 2: n13tless (7.45€)
Seat 3: Yo_Mama (1.18€)
Seat 4: jelachatte (4.49€)
*** ANTE/BLINDS ***
TorviCalls posts small blind 0.01€
n13tless posts big blind 0.02€
Dealt to jelachatte [Kc 8h 9c 7c]
*** PRE-FLOP *** 
Yo_Mama raises 0.05€ to 0.07€
jelachatte calls 0.07€
TorviCalls calls 0.06€
n13tless folds
*** FLOP *** [Qs 7s 4s]
TorviCalls checks
Yo_Mama checks
jelachatte checks
*** TURN *** [Qs 7s 4s][3d]
TorviCalls checks
Yo_Mama bets 0.09€
jelachatte folds
TorviCalls calls 0.09€
*** RIVER *** [Qs 7s 4s 3d][7d]
TorviCalls checks
Yo_Mama checks
*** SHOW DOWN ***
Yo_Mama shows [6s Jh Qc 9h] (Two pairs : Queens and 7)
TorviCalls shows [2s 4d 5d 6d] (Straight 7 high)
TorviCalls collected 0.37€ from pot
*** SUMMARY ***
Total pot 0.37€ | Rake 0.04€
Board: [Qs 7s 4s 3d 7d]
Seat 1: TorviCalls (small blind) showed [2s 4d 5d 6d] and won 0.37€ with Straight 7 high
Seat 3: Yo_Mama showed [6s Jh Qc 9h] and lost with Two pairs : Queens and 7


Winamax Poker - Go Fast "Bucarest" - HandId: #16870380-6361-1643809856 - Omaha pot limit (0.01€/0.02€) - 2022/02/02 13:50:56 UTC
Table: 'Bucarest' 6-max (real money) Seat #4 is the button
Seat 1: jelachatte (4.42€)
Seat 2: Yo_Mama (1.02€)
Seat 3: n13tless (7.43€)
Seat 4: TorviCalls (3.12€)
*** ANTE/BLINDS ***
jelachatte posts small blind 0.01€
Yo_Mama posts big blind 0.02€
Dealt to jelachatte [Th Ad 7s Ts]
*** PRE-FLOP *** 
n13tless folds
TorviCalls calls 0.02€
jelachatte calls 0.01€
Yo_Mama checks
*** FLOP *** [Td Jc 2s]
jelachatte bets 0.03€
Yo_Mama calls 0.03€
TorviCalls folds
*** TURN *** [Td Jc 2s][6d]
jelachatte bets 0.08€
Yo_Mama calls 0.08€
*** RIVER *** [Td Jc 2s 6d][3h]
jelachatte checks
Yo_Mama checks
*** SHOW DOWN ***
Yo_Mama shows [Ks 6h Qd 4s] (One pair : 6)
jelachatte shows [Th Ad 7s Ts] (Trips of Tens)
jelachatte collected 0.25€ from pot
*** SUMMARY ***
Total pot 0.25€ | Rake 0.03€
Board: [Td Jc 2s 6d 3h]
Seat 1: jelachatte (small blind) showed [Th Ad 7s Ts] and won 0.25€ with Trips of Tens
Seat 2: Yo_Mama (big blind) showed [Ks 6h Qd 4s] and lost with One pair : 6


Winamax Poker - Go Fast "Bucarest" - HandId: #16870380-6363-1643809932 - Omaha pot limit (0.01€/0.02€) - 2022/02/02 13:52:12 UTC
Table: 'Bucarest' 6-max (real money) Seat #4 is the button
Seat 1: Yo_Mama (0.91€)
Seat 2: FayaCoco (0.50€)
Seat 3: jelachatte (4.54€)
Seat 4: TorviCalls (3.08€)
*** ANTE/BLINDS ***
Yo_Mama posts small blind 0.01€
FayaCoco posts big blind 0.02€
Dealt to jelachatte [9c Ad 9d 5h]
*** PRE-FLOP *** 
jelachatte calls 0.02€
TorviCalls calls 0.02€
Yo_Mama folds
FayaCoco checks
*** FLOP *** [Jd As 9s]
FayaCoco bets 0.02€
jelachatte raises 0.05€ to 0.07€
TorviCalls folds
FayaCoco calls 0.05€
*** TURN *** [Jd As 9s][4c]
FayaCoco checks
jelachatte bets 0.14€
FayaCoco calls 0.14€
*** RIVER *** [Jd As 9s 4c][6h]
FayaCoco checks
jelachatte checks
*** SHOW DOWN ***
FayaCoco shows [8c 2c Ah 2h] (One pair : Aces)
jelachatte shows [9c Ad 9d 5h] (Trips of 9)
jelachatte collected 0.44€ from pot
*** SUMMARY ***
Total pot 0.44€ | Rake 0.05€
Board: [Jd As 9s 4c 6h]
Seat 2: FayaCoco (big blind) showed [8c 2c Ah 2h] and lost with One pair : Aces
Seat 3: jelachatte showed [9c Ad 9d 5h] and won 0.44€ with Trips of 9


Winamax Poker - Go Fast "Bucarest" - HandId: #16870380-6364-1643809999 - Omaha pot limit (0.01€/0.02€) - 2022/02/02 13:53:19 UTC
Table: 'Bucarest' 6-max (real money) Seat #3 is the button
Seat 1: FayaCoco (0.27€)
Seat 2: jelachatte (4.75€)
Seat 3: TorviCalls (3.06€)
*** ANTE/BLINDS ***
FayaCoco posts small blind 0.01€
jelachatte posts big blind 0.02€
Dealt to jelachatte [Kh 6d Qd 8c]
*** PRE-FLOP *** 
TorviCalls raises 0.03€ to 0.05€
FayaCoco folds
jelachatte folds
TorviCalls collected 0.08€ from pot
*** SUMMARY ***
Total pot 0.08€ | No rake
Seat 3: TorviCalls (button) won 0.08€


Winamax Poker - Go Fast "Bucarest" - HandId: #16870380-6365-1643810011 - Omaha pot limit (0.01€/0.02€) - 2022/02/02 13:53:31 UTC
Table: 'Bucarest' 6-max (real money) Seat #3 is the button
Seat 1: TorviCalls (3.09€)
Seat 2: jelachatte (4.73€)
Seat 3: FayaCoco (0.26€)
*** ANTE/BLINDS ***
TorviCalls posts small blind 0.01€
jelachatte posts big blind 0.02€
Dealt to jelachatte [6d 8c 4s As]
*** PRE-FLOP *** 
FayaCoco folds
TorviCalls raises 0.04€ to 0.06€
jelachatte calls 0.04€
*** FLOP *** [3d 6c Ad]
TorviCalls bets 0.06€
jelachatte calls 0.06€
*** TURN *** [3d 6c Ad][Ac]
TorviCalls bets 0.17€
jelachatte calls 0.17€
*** RIVER *** [3d 6c Ad Ac][5d]
TorviCalls checks
jelachatte bets 0.58€
TorviCalls folds
jelachatte collected 1.10€ from pot
*** SUMMARY ***
Total pot 1.10€ | Rake 0.06€
Board: [3d 6c Ad Ac 5d]
Seat 2: jelachatte (big blind) won 1.10€


Winamax Poker - Go Fast "Bucarest" - HandId: #16870380-6366-1643810038 - Omaha pot limit (0.01€/0.02€) - 2022/02/02 13:53:58 UTC
Table: 'Bucarest' 6-max (real money) Seat #3 is the button
Seat 1: jelachatte (4.96€)
Seat 2: TorviCalls (2.80€)
Seat 3: FayaCoco (0.26€)
*** ANTE/BLINDS ***
jelachatte posts small blind 0.01€
TorviCalls posts big blind 0.02€
Dealt to jelachatte [5d Ks Jh 2s]
*** PRE-FLOP *** 
FayaCoco calls 0.02€
jelachatte folds
TorviCalls raises 0.05€ to 0.07€
FayaCoco calls 0.05€
*** FLOP *** [Kh 6d 2c]
TorviCalls checks
FayaCoco checks
*** TURN *** [Kh 6d 2c][4h]
TorviCalls bets 0.15€
FayaCoco calls 0.15€
*** RIVER *** [Kh 6d 2c 4h][8s]
TorviCalls bets 0.45€
FayaCoco calls 0.04€ and is all-in
*** SHOW DOWN ***
FayaCoco shows [2d 9c Kd Jc] (Two pairs : Kings and 2)
TorviCalls shows [3c As Qc 5h] (Straight 6 high)
TorviCalls collected 0.89€ from pot
*** SUMMARY ***
Total pot 0.89€ | Rake 0.05€
Board: [Kh 6d 2c 4h 8s]
Seat 2: TorviCalls (big blind) showed [3c As Qc 5h] and won 0.89€ with Straight 6 high
Seat 3: FayaCoco (button) showed [2d 9c Kd Jc] and lost with Two pairs : Kings and 2


Winamax Poker - Go Fast "Bucarest" - HandId: #16870380-6367-1643810082 - Omaha pot limit (0.01€/0.02€) - 2022/02/02 13:54:42 UTC
Table: 'Bucarest' 6-max (real money) Seat #3 is the button
Seat 1: jelachatte (4.95€)
Seat 2: Yo_Mama (0.90€)
Seat 3: TorviCalls (3.02€)
*** ANTE/BLINDS ***
jelachatte posts small blind 0.01€
Yo_Mama posts big blind 0.02€
Dealt to jelachatte [8d Qd 3c 8h]
*** PRE-FLOP *** 
TorviCalls calls 0.02€
jelachatte folds
Yo_Mama checks
*** FLOP *** [5s Ad 7s]
Yo_Mama checks
TorviCalls checks
*** TURN *** [5s Ad 7s][4c]
Yo_Mama checks
TorviCalls checks
*** RIVER *** [5s Ad 7s 4c][Tc]
Yo_Mama checks
TorviCalls checks
*** SHOW DOWN ***
Yo_Mama shows [2c 7c 9h 8s] (One pair : 7)
TorviCalls shows [4s 9c Ts 6d] (Two pairs : Tens and 4)
TorviCalls collected 0.04€ from pot
*** SUMMARY ***
Total pot 0.04€ | Rake 0.01€
Board: [5s Ad 7s 4c Tc]
Seat 2: Yo_Mama (big blind) showed [2c 7c 9h 8s] and lost with One pair : 7
Seat 3: TorviCalls (button) showed [4s 9c Ts 6d] and won 0.04€ with Two pairs : Tens and 4


Winamax Poker - Go Fast "Bucarest" - HandId: #16870380-6368-1643810117 - Omaha pot limit (0.01€/0.02€) - 2022/02/02 13:55:17 UTC
Table: 'Bucarest' 6-max (real money) Seat #3 is the button
Seat 1: jelachatte (4.94€)
Seat 2: Yo_Mama (0.88€)
Seat 3: TorviCalls (3.04€)
*** ANTE/BLINDS ***
jelachatte posts small blind 0.01€
Yo_Mama posts big blind 0.02€
Dealt to jelachatte [7c Jh Jd Qh]
*** PRE-FLOP *** 
TorviCalls raises 0.05€ to 0.07€
jelachatte calls 0.06€
Yo_Mama calls 0.05€
*** FLOP *** [5c 3s Kh]
jelachatte checks
Yo_Mama bets 0.14€
TorviCalls folds
jelachatte folds
Yo_Mama collected 0.33€ from pot
*** SUMMARY ***
Total pot 0.33€ | Rake 0.02€
Board: [5c 3s Kh]
Seat 2: Yo_Mama (big blind) won 0.33€


Winamax Poker - Go Fast "Bucarest" - HandId: #16870380-6369-1643810139 - Omaha pot limit (0.01€/0.02€) - 2022/02/02 13:55:39 UTC
Table: 'Bucarest' 6-max (real money) Seat #3 is the button
Seat 1: Yo_Mama (1€)
Seat 2: jelachatte (4.87€)
Seat 3: TorviCalls (2.97€)
Hold-up to Pot: total 0.10€
*** ANTE/BLINDS ***
Yo_Mama posts small blind 0.01€
jelachatte posts big blind 0.02€
Dealt to jelachatte [5c 3c 9d Kd]
*** PRE-FLOP *** 
TorviCalls calls 0.02€
Yo_Mama calls 0.01€
jelachatte checks
*** FLOP *** [As 8d Js]
Yo_Mama checks
jelachatte checks
TorviCalls checks
*** TURN *** [As 8d Js][Qc]
Yo_Mama checks
jelachatte checks
TorviCalls checks
*** RIVER *** [As 8d Js Qc][6h]
Yo_Mama checks
jelachatte checks
TorviCalls checks
*** SHOW DOWN ***
jelachatte shows [5c 3c 9d Kd] (High card : Ace)
TorviCalls shows [5d 4h 7d 2h] (High card : Ace)
Yo_Mama shows [4c 7h Jh Th] (One pair : Jacks)
Yo_Mama collected 0.15€ from pot
*** SUMMARY ***
Total pot 0.15€ | Rake 0.01€
Board: [As 8d Js Qc 6h]
Seat 1: Yo_Mama (small blind) showed [4c 7h Jh Th] and won 0.15€ with One pair : Jacks
Seat 2: jelachatte (big blind) showed [5c 3c 9d Kd] and lost with High card : Ace
Seat 3: TorviCalls (button) showed [5d 4h 7d 2h] and lost with High card : Ace


Winamax Poker - Go Fast "Bucarest" - HandId: #16870380-6370-1643810182 - Omaha pot limit (0.01€/0.02€) - 2022/02/02 13:56:22 UTC
Table: 'Bucarest' 6-max (real money) Seat #3 is the button
Seat 1: jelachatte (4.85€)
Seat 2: Yo_Mama (1.13€)
Seat 3: TorviCalls (2.95€)
*** ANTE/BLINDS ***
jelachatte posts small blind 0.01€
Yo_Mama posts big blind 0.02€
Dealt to jelachatte [Ac Kh 3d Ah]
*** PRE-FLOP *** 
TorviCalls raises 0.03€ to 0.05€
jelachatte raises 0.12€ to 0.17€
Yo_Mama calls 0.15€
TorviCalls calls 0.12€
*** FLOP *** [5d 4c 8c]
jelachatte bets 0.26€
Yo_Mama folds
TorviCalls folds
jelachatte collected 0.72€ from pot
*** SUMMARY ***
Total pot 0.72€ | Rake 0.05€
Board: [5d 4c 8c]
Seat 1: jelachatte (small blind) won 0.72€


Winamax Poker - Go Fast "Bucarest" - HandId: #16870380-6371-1643810220 - Omaha pot limit (0.01€/0.02€) - 2022/02/02 13:57:00 UTC
Table: 'Bucarest' 6-max (real money) Seat #3 is the button
Seat 1: Yo_Mama (0.96€)
Seat 2: jelachatte (5.14€)
Seat 3: TorviCalls (2.78€)
*** ANTE/BLINDS ***
Yo_Mama posts small blind 0.01€
jelachatte posts big blind 0.02€
Dealt to jelachatte [5h 3s 6h Kd]
*** PRE-FLOP *** 
TorviCalls calls 0.02€
Yo_Mama raises 0.06€ to 0.08€
jelachatte folds
TorviCalls folds
Yo_Mama collected 0.12€ from pot
*** SUMMARY ***
Total pot 0.12€ | No rake
Seat 1: Yo_Mama (small blind) won 0.12€


Winamax Poker - Go Fast "Bucarest" - HandId: #16870380-6372-1643810231 - Omaha pot limit (0.01€/0.02€) - 2022/02/02 13:57:11 UTC
Table: 'Bucarest' 6-max (real money) Seat #3 is the button
Seat 1: Yo_Mama (1€)
Seat 2: TorviCalls (2.76€)
Seat 3: jelachatte (5.12€)
*** ANTE/BLINDS ***
Yo_Mama posts small blind 0.01€
TorviCalls posts big blind 0.02€
Dealt to jelachatte [7h Jh 8d 8c]
*** PRE-FLOP *** 
jelachatte raises 0.05€ to 0.07€
Yo_Mama calls 0.06€
TorviCalls raises 0.21€ to 0.28€
jelachatte calls 0.21€
Yo_Mama calls 0.21€
*** FLOP *** [5s 3c Th]
Yo_Mama bets 0.72€ and is all-in
TorviCalls raises 1.76€ to 2.48€ and is all-in
jelachatte folds
*** TURN *** [5s 3c Th][7c]
*** RIVER *** [5s 3c Th 7c][Ac]
*** SHOW DOWN ***
Yo_Mama shows [3s 5d Tc Ad] (Two pairs : Aces and Tens)
TorviCalls shows [2s Kc 2h Ks] (One pair : Kings)
TorviCalls collected 1.76€ from side pot 1
Yo_Mama collected 2.05€ from main pot
*** SUMMARY ***
Total pot 3.81€ | Rake 0.23€
Board: [5s 3c Th 7c Ac]
Seat 1: Yo_Mama (small blind) showed [3s 5d Tc Ad] and won 2.05€ with Two pairs : Aces and Tens
Seat 2: TorviCalls (big blind) showed [2s Kc 2h Ks] and won 1.76€ with One pair : Kings


Winamax Poker - Go Fast "Bucarest" - HandId: #16870380-6373-1643810265 - Omaha pot limit (0.01€/0.02€) - 2022/02/02 13:57:45 UTC
Table: 'Bucarest' 6-max (real money) Seat #3 is the button
Seat 1: jelachatte (4.84€)
Seat 2: Yo_Mama (2.05€)
Seat 3: TorviCalls (1.76€)
*** ANTE/BLINDS ***
jelachatte posts small blind 0.01€
Yo_Mama posts big blind 0.02€
Dealt to jelachatte [6h 7h Qs 9h]
*** PRE-FLOP *** 
TorviCalls calls 0.02€
jelachatte folds
Yo_Mama checks
*** FLOP *** [Ah Td 7c]
Yo_Mama checks
TorviCalls bets 0.05€
Yo_Mama calls 0.05€
*** TURN *** [Ah Td 7c][9d]
Yo_Mama checks
TorviCalls bets 0.15€
Yo_Mama raises 0.45€ to 0.60€
TorviCalls calls 0.45€
*** RIVER *** [Ah Td 7c 9d][Th]
Yo_Mama checks
TorviCalls bets 1.09€ and is all-in
Yo_Mama calls 1.09€
*** SHOW DOWN ***
Yo_Mama shows [Js 8s Kd 8c] (Straight Jack high)
TorviCalls shows [7s 4h 9s 7d] (Full of 7 and Tens)
TorviCalls collected 3.18€ from pot
*** SUMMARY ***
Total pot 3.18€ | Rake 0.35€
Board: [Ah Td 7c 9d Th]
Seat 2: Yo_Mama (big blind) showed [Js 8s Kd 8c] and lost with Straight Jack high
Seat 3: TorviCalls (button) showed [7s 4h 9s 7d] and won 3.18€ with Full of 7 and Tens


Winamax Poker - Go Fast "Bucarest" - HandId: #16870380-6374-1643810293 - Omaha pot limit (0.01€/0.02€) - 2022/02/02 13:58:13 UTC
Table: 'Bucarest' 6-max (real money) Seat #3 is the button
Seat 1: Yo_Mama (0.29€)
Seat 2: jelachatte (4.83€)
Seat 3: TorviCalls (3.18€)
Hold-up to Pot: total 0.10€
*** ANTE/BLINDS ***
Yo_Mama posts small blind 0.01€
jelachatte posts big blind 0.02€
Dealt to jelachatte [2c 4h Qh 7c]
*** PRE-FLOP *** 
TorviCalls raises 0.05€ to 0.07€
Yo_Mama raises 0.05€ to 0.12€
jelachatte folds
TorviCalls raises 0.19€ to 0.31€
Yo_Mama calls 0.17€ and is all-in
*** FLOP *** [9h Jd Kd]
*** TURN *** [9h Jd Kd][Kh]
*** RIVER *** [9h Jd Kd Kh][5s]
*** SHOW DOWN ***
Yo_Mama shows [Tc 8s As 5d] (Two pairs : Kings and 5)
TorviCalls shows [Td 6d 3d Ad] (One pair : Kings)
TorviCalls collected 0.02€ from side pot 1
Yo_Mama collected 0.64€ from main pot
*** SUMMARY ***
Total pot 0.66€ | Rake 0.06€
Board: [9h Jd Kd Kh 5s]
Seat 1: Yo_Mama (small blind) showed [Tc 8s As 5d] and won 0.64€ with Two pairs : Kings and 5
Seat 3: TorviCalls (button) showed [Td 6d 3d Ad] and won 0.02€ with One pair : Kings


Winamax Poker - Go Fast "Bucarest" - HandId: #16870380-6375-1643810332 - Omaha pot limit (0.01€/0.02€) - 2022/02/02 13:58:52 UTC
Table: 'Bucarest' 6-max (real money) Seat #3 is the button
Seat 1: TorviCalls (2.89€)
Seat 2: Yo_Mama (0.64€)
Seat 3: jelachatte (4.81€)
Hold-up to Pot: total 0.10€
*** ANTE/BLINDS ***
TorviCalls posts small blind 0.01€
Yo_Mama posts big blind 0.02€
Dealt to jelachatte [2h Th 4c 2s]
*** PRE-FLOP *** 
jelachatte folds
TorviCalls calls 0.01€
Yo_Mama raises 0.04€ to 0.06€
TorviCalls calls 0.04€
*** FLOP *** [5d Js 8s]
TorviCalls checks
Yo_Mama bets 0.22€
TorviCalls raises 0.46€ to 0.68€
Yo_Mama calls 0.36€ and is all-in
*** TURN *** [5d Js 8s][5s]
*** RIVER *** [5d Js 8s 5s][Kd]
*** SHOW DOWN ***
TorviCalls shows [Qh 7c 8d Jh] (Two pairs : Jacks and 8)
Yo_Mama shows [Kc 9s Jc 6s] (Flush Jack high)
Yo_Mama collected 1.25€ from main pot
TorviCalls collected 0.10€ from side pot 1
*** SUMMARY ***
Total pot 1.35€ | Rake 0.13€
Board: [5d Js 8s 5s Kd]
Seat 1: TorviCalls (small blind) showed [Qh 7c 8d Jh] and won 0.10€ with Two pairs : Jacks and 8
Seat 2: Yo_Mama (big blind) showed [Kc 9s Jc 6s] and won 1.25€ with Flush Jack high


Winamax Poker - Go Fast "Bucarest" - HandId: #16870380-6376-1643810360 - Omaha pot limit (0.01€/0.02€) - 2022/02/02 13:59:20 UTC
Table: 'Bucarest' 6-max (real money) Seat #3 is the button
Seat 1: Yo_Mama (1.25€)
Seat 2: TorviCalls (2.25€)
Seat 3: jelachatte (4.81€)
*** ANTE/BLINDS ***
Yo_Mama posts small blind 0.01€
TorviCalls posts big blind 0.02€
Dealt to jelachatte [7h 7d Ah 6s]
*** PRE-FLOP *** 
jelachatte calls 0.02€
Yo_Mama raises 0.06€ to 0.08€
TorviCalls calls 0.06€
jelachatte calls 0.06€
*** FLOP *** [9c Tc 7s]
Yo_Mama checks
TorviCalls checks
jelachatte bets 0.16€
Yo_Mama folds
TorviCalls folds
jelachatte collected 0.38€ from pot
*** SUMMARY ***
Total pot 0.38€ | Rake 0.02€
Board: [9c Tc 7s]
Seat 3: jelachatte (button) won 0.38€


Winamax Poker - Go Fast "Bucarest" - HandId: #16870380-6377-1643810389 - Omaha pot limit (0.01€/0.02€) - 2022/02/02 13:59:49 UTC
Table: 'Bucarest' 6-max (real money) Seat #3 is the button
Seat 1: Yo_Mama (1.17€)
Seat 2: jelachatte (4.95€)
Seat 3: TorviCalls (2.17€)
Hold-up to Pot: total 0.10€
*** ANTE/BLINDS ***
Yo_Mama posts small blind 0.01€
jelachatte posts big blind 0.02€
Dealt to jelachatte [Td 5s 6s Jh]
*** PRE-FLOP *** 
TorviCalls calls 0.02€
Yo_Mama calls 0.01€
jelachatte checks
*** FLOP *** [3d 5d Th]
Yo_Mama checks
jelachatte checks
TorviCalls checks
*** TURN *** [3d 5d Th][3h]
Yo_Mama checks
jelachatte checks
TorviCalls bets 0.16€
Yo_Mama folds
jelachatte folds
TorviCalls collected 0.31€ from pot
*** SUMMARY ***
Total pot 0.31€ | Rake 0.01€
Board: [3d 5d Th 3h]
Seat 3: TorviCalls (button) won 0.31€


Winamax Poker - Go Fast "Bucarest" - HandId: #16870380-6378-1643810421 - Omaha pot limit (0.01€/0.02€) - 2022/02/02 14:00:21 UTC
Table: 'Bucarest' 6-max (real money) Seat #3 is the button
Seat 1: Yo_Mama (1.15€)
Seat 2: TorviCalls (2.30€)
Seat 3: jelachatte (4.93€)
Hold-up to Pot: total 0.10€
*** ANTE/BLINDS ***
Yo_Mama posts small blind 0.01€
TorviCalls posts big blind 0.02€
Dealt to jelachatte [Qs 4h 9c 8d]
*** PRE-FLOP *** 
jelachatte folds
Yo_Mama raises 0.04€ to 0.06€
TorviCalls raises 0.12€ to 0.18€
Yo_Mama calls 0.12€
*** FLOP *** [2d Ah 8s]
Yo_Mama checks
TorviCalls bets 0.46€
Yo_Mama folds
TorviCalls collected 0.88€ from pot
*** SUMMARY ***
Total pot 0.88€ | Rake 0.04€
Board: [2d Ah 8s]
Seat 2: TorviCalls (big blind) won 0.88€


Winamax Poker - Go Fast "Bucarest" - HandId: #16870380-6379-1643810448 - Omaha pot limit (0.01€/0.02€) - 2022/02/02 14:00:48 UTC
Table: 'Bucarest' 6-max (real money) Seat #3 is the button
Seat 1: TorviCalls (2.54€)
Seat 2: Yo_Mama (0.97€)
Seat 3: jelachatte (4.93€)
*** ANTE/BLINDS ***
TorviCalls posts small blind 0.01€
Yo_Mama posts big blind 0.02€
Dealt to jelachatte [9c Tc Ah Qs]
*** PRE-FLOP *** 
jelachatte calls 0.02€
TorviCalls calls 0.01€
Yo_Mama checks
*** FLOP *** [Jh Th 8c]
TorviCalls bets 0.06€
Yo_Mama folds
jelachatte calls 0.06€
*** TURN *** [Jh Th 8c][5d]
TorviCalls checks
jelachatte bets 0.12€
TorviCalls calls 0.12€
*** RIVER *** [Jh Th 8c 5d][2h]
TorviCalls checks
jelachatte checks
*** SHOW DOWN ***
TorviCalls shows [7c Td 8s 4s] (Two pairs : Tens and 8)
jelachatte shows [9c Tc Ah Qs] (Straight Queen high)
jelachatte collected 0.38€ from pot
*** SUMMARY ***
Total pot 0.38€ | Rake 0.04€
Board: [Jh Th 8c 5d 2h]
Seat 1: TorviCalls (small blind) showed [7c Td 8s 4s] and lost with Two pairs : Tens and 8
Seat 3: jelachatte (button) showed [9c Tc Ah Qs] and won 0.38€ with Straight Queen high


Winamax Poker - Go Fast "Bucarest" - HandId: #16870380-6380-1643810491 - Omaha pot limit (0.01€/0.02€) - 2022/02/02 14:01:31 UTC
Table: 'Bucarest' 6-max (real money) Seat #3 is the button
Seat 1: Yo_Mama (0.95€)
Seat 2: jelachatte (5.11€)
Seat 3: TorviCalls (2.34€)
*** ANTE/BLINDS ***
Yo_Mama posts small blind 0.01€
jelachatte posts big blind 0.02€
Dealt to jelachatte [9d 2d Ac Kc]
*** PRE-FLOP *** 
TorviCalls calls 0.02€
Yo_Mama calls 0.01€
jelachatte checks
*** FLOP *** [6h 8d Qc]
Yo_Mama bets 0.04€
jelachatte folds
TorviCalls folds
Yo_Mama collected 0.09€ from pot
*** SUMMARY ***
Total pot 0.09€ | Rake 0.01€
Board: [6h 8d Qc]
Seat 1: Yo_Mama (small blind) won 0.09€


Winamax Poker - Go Fast "Bucarest" - HandId: #16870380-6381-1643810519 - Omaha pot limit (0.01€/0.02€) - 2022/02/02 14:01:59 UTC
Table: 'Bucarest' 6-max (real money) Seat #3 is the button
Seat 1: TorviCalls (2.32€)
Seat 2: Yo_Mama (0.98€)
Seat 3: jelachatte (5.09€)
*** ANTE/BLINDS ***
TorviCalls posts small blind 0.01€
Yo_Mama posts big blind 0.02€
Dealt to jelachatte [7h Kh 4c 3c]
*** PRE-FLOP *** 
jelachatte folds
TorviCalls raises 0.03€ to 0.05€
Yo_Mama raises 0.07€ to 0.12€
TorviCalls calls 0.07€
*** FLOP *** [Qh Qs Qc]
TorviCalls checks
Yo_Mama checks
*** TURN *** [Qh Qs Qc][2c]
TorviCalls checks
Yo_Mama bets 0.08€
TorviCalls folds
Yo_Mama collected 0.30€ from pot
*** SUMMARY ***
Total pot 0.30€ | Rake 0.02€
Board: [Qh Qs Qc 2c]
Seat 2: Yo_Mama (big blind) won 0.30€


Winamax Poker - Go Fast "Bucarest" - HandId: #16870380-6382-1643810559 - Omaha pot limit (0.01€/0.02€) - 2022/02/02 14:02:39 UTC
Table: 'Bucarest' 6-max (real money) Seat #3 is the button
Seat 1: TorviCalls (2.20€)
Seat 2: Yo_Mama (1.08€)
Seat 3: jelachatte (5.09€)
*** ANTE/BLINDS ***
TorviCalls posts small blind 0.01€
Yo_Mama posts big blind 0.02€
Dealt to jelachatte [8d Qs 9s Td]
*** PRE-FLOP *** 
jelachatte raises 0.05€ to 0.07€
TorviCalls folds
Yo_Mama folds
jelachatte collected 0.10€ from pot
*** SUMMARY ***
Total pot 0.10€ | No rake
Seat 3: jelachatte (button) won 0.10€


Winamax Poker - Go Fast "Bucarest" - HandId: #16870380-6383-1643810578 - Omaha pot limit (0.01€/0.02€) - 2022/02/02 14:02:58 UTC
Table: 'Bucarest' 6-max (real money) Seat #3 is the button
Seat 1: Yo_Mama (1.06€)
Seat 2: jelachatte (5.12€)
Seat 3: TorviCalls (2.19€)
*** ANTE/BLINDS ***
Yo_Mama posts small blind 0.01€
jelachatte posts big blind 0.02€
Dealt to jelachatte [Td 8s Qs 6d]
*** PRE-FLOP *** 
TorviCalls folds
Yo_Mama folds
jelachatte collected 0.03€ from pot
*** SUMMARY ***
Total pot 0.03€ | No rake
Seat 2: jelachatte (big blind) won 0.03€


Winamax Poker - Go Fast "Bucarest" - HandId: #16870380-6384-1643810591 - Omaha pot limit (0.01€/0.02€) - 2022/02/02 14:03:11 UTC
Table: 'Bucarest' 6-max (real money) Seat #3 is the button
Seat 1: jelachatte (5.13€)
Seat 2: TorviCalls (2.19€)
Seat 3: Yo_Mama (1.05€)
*** ANTE/BLINDS ***
jelachatte posts small blind 0.01€
TorviCalls posts big blind 0.02€
Dealt to jelachatte [Jh 6c Kc Qs]
*** PRE-FLOP *** 
Yo_Mama raises 0.04€ to 0.06€
jelachatte folds
TorviCalls calls 0.04€
*** FLOP *** [Tc 7s Ad]
TorviCalls checks
Yo_Mama checks
*** TURN *** [Tc 7s Ad][5s]
TorviCalls bets 0.13€
Yo_Mama calls 0.13€
*** RIVER *** [Tc 7s Ad 5s][2c]
TorviCalls bets 0.39€
Yo_Mama folds
TorviCalls collected 0.74€ from pot
*** SUMMARY ***
Total pot 0.74€ | Rake 0.04€
Board: [Tc 7s Ad 5s 2c]
Seat 2: TorviCalls (big blind) won 0.74€


Winamax Poker - Go Fast "Bucarest" - HandId: #16870380-6385-1643810629 - Omaha pot limit (0.01€/0.02€) - 2022/02/02 14:03:49 UTC
Table: 'Bucarest' 6-max (real money) Seat #3 is the button
Seat 1: Yo_Mama (0.86€)
Seat 2: TorviCalls (2.35€)
Seat 3: jelachatte (5.12€)
*** ANTE/BLINDS ***
Yo_Mama posts small blind 0.01€
TorviCalls posts big blind 0.02€
Dealt to jelachatte [Qd 8s Kh Qh]
*** PRE-FLOP *** 
jelachatte raises 0.05€ to 0.07€
Yo_Mama calls 0.06€
TorviCalls calls 0.05€
*** FLOP *** [Jh 7c Kd]
Yo_Mama checks
TorviCalls checks
jelachatte bets 0.11€
Yo_Mama calls 0.11€
TorviCalls calls 0.11€
*** TURN *** [Jh 7c Kd][Ac]
Yo_Mama bets 0.36€
TorviCalls folds
jelachatte calls 0.36€
*** RIVER *** [Jh 7c Kd Ac][6s]
Yo_Mama bets 0.32€ and is all-in
jelachatte folds
Yo_Mama collected 1.45€ from pot
*** SUMMARY ***
Total pot 1.45€ | Rake 0.13€
Board: [Jh 7c Kd Ac 6s]
Seat 1: Yo_Mama (small blind) won 1.45€


Winamax Poker - Go Fast "Bucarest" - HandId: #16870380-6386-1643810694 - Omaha pot limit (0.01€/0.02€) - 2022/02/02 14:04:54 UTC
Table: 'Bucarest' 6-max (real money) Seat #5 is the button
Seat 1: TorviCalls (2.17€)
Seat 2: Yo_Mama (1.45€)
Seat 3: TIKItes26 (0.60€)
Seat 4: jelachatte (4.58€)
Seat 5: Alpha_Golf (0.50€)
*** ANTE/BLINDS ***
TorviCalls posts small blind 0.01€
Yo_Mama posts big blind 0.02€
Dealt to jelachatte [Jc Ts 7h 2s]
*** PRE-FLOP *** 
TIKItes26 folds
jelachatte folds
Alpha_Golf raises 0.02€ to 0.04€
TorviCalls raises 0.09€ to 0.13€
Yo_Mama folds
Alpha_Golf calls 0.09€
*** FLOP *** [6c 6s 5h]
TorviCalls checks
Alpha_Golf checks
*** TURN *** [6c 6s 5h][2c]
TorviCalls bets 0.10€
Alpha_Golf folds
TorviCalls collected 0.35€ from pot
*** SUMMARY ***
Total pot 0.35€ | Rake 0.03€
Board: [6c 6s 5h 2c]
Seat 1: TorviCalls (small blind) won 0.35€


Winamax Poker - Go Fast "Bucarest" - HandId: #16870380-6387-1643810737 - Omaha pot limit (0.01€/0.02€) - 2022/02/02 14:05:37 UTC
Table: 'Bucarest' 6-max (real money) Seat #5 is the button
Seat 1: jelachatte (4.58€)
Seat 2: Alpha_Golf (0.37€)
Seat 3: TorviCalls (2.29€)
Seat 4: Yo_Mama (1.43€)
Seat 5: TIKItes26 (0.60€)
*** ANTE/BLINDS ***
jelachatte posts small blind 0.01€
Alpha_Golf posts big blind 0.02€
Dealt to jelachatte [Td Kh 7d Kd]
*** PRE-FLOP *** 
TorviCalls calls 0.02€
Yo_Mama raises 0.02€ to 0.04€
TIKItes26 folds
jelachatte raises 0.12€ to 0.16€
Alpha_Golf folds
TorviCalls folds
Yo_Mama calls 0.12€
*** FLOP *** [Qc Ac Ad]
jelachatte bets 0.18€
Yo_Mama folds
jelachatte collected 0.50€ from pot
*** SUMMARY ***
Total pot 0.50€ | Rake 0.04€
Board: [Qc Ac Ad]
Seat 1: jelachatte (small blind) won 0.50€


Winamax Poker - Go Fast "Bucarest" - HandId: #16870380-6389-1643810904 - Omaha pot limit (0.01€/0.02€) - 2022/02/02 14:08:24 UTC
Table: 'Bucarest' 6-max (real money) Seat #5 is the button
Seat 1: TorviCalls (2.21€)
Seat 2: Yo_Mama (1.38€)
Seat 3: Greg.50 (1.94€)
Seat 4: TIKItes26 (0.59€)
Seat 5: jelachatte (4.74€)
*** ANTE/BLINDS ***
TorviCalls posts small blind 0.01€
Yo_Mama posts big blind 0.02€
Dealt to jelachatte [3h Tc 7s 7d]
*** PRE-FLOP *** 
Greg.50 folds
TIKItes26 folds
jelachatte folds
TorviCalls calls 0.01€
Yo_Mama checks
*** FLOP *** [Kd 2d 4s]
TorviCalls bets 0.04€
Yo_Mama calls 0.04€
*** TURN *** [Kd 2d 4s][Kh]
TorviCalls checks
Yo_Mama bets 0.06€
TorviCalls folds
Yo_Mama collected 0.17€ from pot
*** SUMMARY ***
Total pot 0.17€ | Rake 0.01€
Board: [Kd 2d 4s Kh]
Seat 2: Yo_Mama (big blind) won 0.17€


Winamax Poker - Go Fast "Bucarest" - HandId: #16870380-6390-1643810953 - Omaha pot limit (0.01€/0.02€) - 2022/02/02 14:09:13 UTC
Table: 'Bucarest' 6-max (real money) Seat #6 is the button
Seat 1: Yo_Mama (1.43€)
Seat 2: Greg.50 (1.94€)
Seat 3: TorviCalls (2.15€)
Seat 4: Un jour sur2 (2€)
Seat 5: TIKItes26 (0.59€)
Seat 6: jelachatte (4.74€)
*** ANTE/BLINDS ***
Yo_Mama posts small blind 0.01€
Greg.50 posts big blind 0.02€
Dealt to jelachatte [Th 5c Jh 9s]
*** PRE-FLOP *** 
TorviCalls calls 0.02€
Un jour sur2 calls 0.02€
TIKItes26 folds
jelachatte folds
Yo_Mama calls 0.01€
Greg.50 checks
*** FLOP *** [5d 6h 8h]
Yo_Mama checks
Greg.50 bets 0.08€
TorviCalls folds
Un jour sur2 calls 0.08€
Yo_Mama calls 0.08€
*** TURN *** [5d 6h 8h][3c]
Yo_Mama checks
Greg.50 checks
Un jour sur2 checks
*** RIVER *** [5d 6h 8h 3c][Qd]
Yo_Mama checks
Greg.50 checks
Un jour sur2 checks
*** SHOW DOWN ***
Yo_Mama shows [2c 7d Ks Td] (High card : King)
Greg.50 shows [Kd 6s Tc 9h] (One pair : 6)
Un jour sur2 shows [8d 8c 3h Js] (Trips of 8)
Un jour sur2 collected 0.29€ from pot
*** SUMMARY ***
Total pot 0.29€ | Rake 0.03€
Board: [5d 6h 8h 3c Qd]
Seat 1: Yo_Mama (small blind) showed [2c 7d Ks Td] and lost with High card : King
Seat 2: Greg.50 (big blind) showed [Kd 6s Tc 9h] and lost with One pair : 6
Seat 4: Un jour sur2 showed [8d 8c 3h Js] and won 0.29€ with Trips of 8


Winamax Poker - Go Fast "Bucarest" - HandId: #16870380-6391-1643811010 - Omaha pot limit (0.01€/0.02€) - 2022/02/02 14:10:10 UTC
Table: 'Bucarest' 6-max (real money) Seat #6 is the button
Seat 1: Greg.50 (1.84€)
Seat 2: Un jour sur2 (2.19€)
Seat 3: ParisQJWin (1.76€)
Seat 4: Epouvantable (2€)
Seat 5: jelachatte (4.74€)
Seat 6: TIKItes26 (0.59€)
*** ANTE/BLINDS ***
Greg.50 posts small blind 0.01€
Un jour sur2 posts big blind 0.02€
Dealt to jelachatte [6c 9h 2h Kd]
*** PRE-FLOP *** 
ParisQJWin folds
Epouvantable calls 0.02€
jelachatte folds
TIKItes26 folds
Greg.50 raises 0.02€ to 0.04€
Un jour sur2 folds
Epouvantable calls 0.02€
*** FLOP *** [5h 8h 3s]
Greg.50 bets 0.10€
Epouvantable calls 0.10€
*** TURN *** [5h 8h 3s][2s]
Greg.50 bets 0.30€
Epouvantable raises 0.90€ to 1.20€
Greg.50 calls 0.90€
*** RIVER *** [5h 8h 3s 2s][Qs]
Greg.50 bets 0.50€ and is all-in
Epouvantable calls 0.50€
*** SHOW DOWN ***
Epouvantable shows [Ts 9c 6d 4h] (Straight 6 high)
Greg.50 shows [Js As 6h 7c] (Flush Ace high)
Greg.50 collected 3.33€ from pot
*** SUMMARY ***
Total pot 3.33€ | Rake 0.37€
Board: [5h 8h 3s 2s Qs]
Seat 1: Greg.50 (small blind) showed [Js As 6h 7c] and won 3.33€ with Flush Ace high
Seat 4: Epouvantable showed [Ts 9c 6d 4h] and lost with Straight 6 high


Winamax Poker - Go Fast "Bucarest" - HandId: #16870380-6392-1643811022 - Omaha pot limit (0.01€/0.02€) - 2022/02/02 14:10:22 UTC
Table: 'Bucarest' 6-max (real money) Seat #6 is the button
Seat 1: Un jour sur2 (2.17€)
Seat 2: TIKItes26 (0.59€)
Seat 3: jelachatte (4.74€)
Seat 4: ParisQJWin (1.76€)
Seat 5: TorviCalls (2.13€)
Seat 6: Yo_Mama (1.33€)
*** ANTE/BLINDS ***
Un jour sur2 posts small blind 0.01€
TIKItes26 posts big blind 0.02€
Dealt to jelachatte [Ad 2h 4c 6h]
*** PRE-FLOP *** 
jelachatte folds
ParisQJWin folds
TorviCalls calls 0.02€
Yo_Mama calls 0.02€
Un jour sur2 calls 0.01€
TIKItes26 checks
*** FLOP *** [8s 6d 2d]
Un jour sur2 bets 0.06€
TIKItes26 folds
TorviCalls calls 0.06€
Yo_Mama folds
*** TURN *** [8s 6d 2d][Qh]
Un jour sur2 bets 0.20€
TorviCalls calls 0.20€
*** RIVER *** [8s 6d 2d Qh][Ks]
Un jour sur2 bets 0.45€
TorviCalls calls 0.45€
*** SHOW DOWN ***
Un jour sur2 shows [5c 7s 9d Td] (High card : King)
TorviCalls shows [Qd Kc Ah 8d] (Two pairs : Kings and Queens)
TorviCalls collected 1.35€ from pot
*** SUMMARY ***
Total pot 1.35€ | Rake 0.15€
Board: [8s 6d 2d Qh Ks]
Seat 1: Un jour sur2 (small blind) showed [5c 7s 9d Td] and lost with High card : King
Seat 5: TorviCalls showed [Qd Kc Ah 8d] and won 1.35€ with Two pairs : Kings and Queens


Winamax Poker - Go Fast "Bucarest" - HandId: #16870380-6393-1643811056 - Omaha pot limit (0.01€/0.02€) - 2022/02/02 14:10:56 UTC
Table: 'Bucarest' 6-max (real money) Seat #6 is the button
Seat 1: TIKItes26 (0.57€)
Seat 2: Epouvantable (0.16€)
Seat 3: Yo_Mama (1.31€)
Seat 4: Greg.50 (3.33€)
Seat 5: ParisQJWin (1.76€)
Seat 6: jelachatte (4.74€)
*** ANTE/BLINDS ***
TIKItes26 posts small blind 0.01€
Epouvantable posts big blind 0.02€
Dealt to jelachatte [9d 9c 9h 8c]
*** PRE-FLOP *** 
Yo_Mama raises 0.04€ to 0.06€
Greg.50 calls 0.06€
ParisQJWin folds
jelachatte folds
TIKItes26 folds
Epouvantable raises 0.10€ to 0.16€ and is all-in
Yo_Mama calls 0.10€
Greg.50 calls 0.10€
*** FLOP *** [4c Jh Jc]
Yo_Mama checks
Greg.50 checks
*** TURN *** [4c Jh Jc][Ts]
Yo_Mama bets 0.16€
Greg.50 folds
*** RIVER *** [4c Jh Jc Ts][Th]
*** SHOW DOWN ***
Epouvantable shows [3c Kh Ad Jd] (Trips of Jacks)
Yo_Mama shows [Qd Qh 5d As] (Two pairs : Queens and Jacks)
Yo_Mama collected 0.16€ from side pot 1
Epouvantable collected 0.44€ from main pot
*** SUMMARY ***
Total pot 0.60€ | Rake 0.05€
Board: [4c Jh Jc Ts Th]
Seat 2: Epouvantable (big blind) showed [3c Kh Ad Jd] and won 0.44€ with Trips of Jacks
Seat 3: Yo_Mama showed [Qd Qh 5d As] and won 0.16€ with Two pairs : Queens and Jacks


Winamax Poker - Go Fast "Bucarest" - HandId: #16870380-6394-1643811095 - Omaha pot limit (0.01€/0.02€) - 2022/02/02 14:11:35 UTC
Table: 'Bucarest' 6-max (real money) Seat #6 is the button
Seat 1: Epouvantable (0.44€)
Seat 2: TorviCalls (2.75€)
Seat 3: Un jour sur2 (1.44€)
Seat 4: jelachatte (4.74€)
Seat 5: TIKItes26 (0.56€)
Seat 6: ParisQJWin (1.76€)
*** ANTE/BLINDS ***
Epouvantable posts small blind 0.01€
TorviCalls posts big blind 0.02€
Dealt to jelachatte [Kc Qs Ks 7s]
*** PRE-FLOP *** 
Un jour sur2 folds
jelachatte raises 0.05€ to 0.07€
TIKItes26 folds
ParisQJWin folds
Epouvantable folds
TorviCalls calls 0.05€
*** FLOP *** [8h 8d 6h]
TorviCalls checks
jelachatte bets 0.08€
TorviCalls folds
jelachatte collected 0.21€ from pot
*** SUMMARY ***
Total pot 0.21€ | Rake 0.02€
Board: [8h 8d 6h]
Seat 4: jelachatte won 0.21€


Winamax Poker - Go Fast "Bucarest" - HandId: #16870380-6396-1643811135 - Omaha pot limit (0.01€/0.02€) - 2022/02/02 14:12:15 UTC
Table: 'Bucarest' 6-max (real money) Seat #6 is the button
Seat 1: jelachatte (4.80€)
Seat 2: Vipecori (2€)
Seat 3: 2143658709 (2€)
Seat 4: TorviCalls (2.68€)
Seat 5: Epouvantable (0.43€)
Seat 6: TIKItes26 (0.56€)
Hold-up to Pot: total 0.10€
*** ANTE/BLINDS ***
jelachatte posts small blind 0.01€
Vipecori posts big blind 0.02€
Dealt to jelachatte [2c As 5h 9c]
*** PRE-FLOP *** 
2143658709 calls 0.02€
TorviCalls calls 0.02€
Epouvantable raises 0.02€ to 0.04€
TIKItes26 calls 0.04€
jelachatte folds
Vipecori raises 0.16€ to 0.20€
2143658709 folds
TorviCalls folds
Epouvantable calls 0.16€
TIKItes26 folds
*** FLOP *** [Ah 2s 4c]
Vipecori bets 0.59€
Epouvantable folds
Vipecori collected 1.13€ from pot
*** SUMMARY ***
Total pot 1.13€ | Rake 0.05€
Board: [Ah 2s 4c]
Seat 2: Vipecori (big blind) won 1.13€


Winamax Poker - Go Fast "Bucarest" - HandId: #16870380-6397-1643811174 - Omaha pot limit (0.01€/0.02€) - 2022/02/02 14:12:54 UTC
Table: 'Bucarest' 6-max (real money) Seat #6 is the button
Seat 1: Vipecori (2.34€)
Seat 2: Talab 07 (2€)
Seat 3: TIKItes26 (0.52€)
Seat 4: jelachatte (4.79€)
Seat 5: TorviCalls (2.66€)
Seat 6: Epouvantable (0.23€)
*** ANTE/BLINDS ***
Vipecori posts small blind 0.01€
Talab 07 posts big blind 0.02€
Dealt to jelachatte [4s 3c 7h 7c]
*** PRE-FLOP *** 
TIKItes26 folds
jelachatte folds
TorviCalls calls 0.02€
Epouvantable calls 0.02€
Vipecori calls 0.01€
Talab 07 raises 0.02€ to 0.04€
TorviCalls calls 0.02€
Epouvantable calls 0.02€
Vipecori calls 0.02€
*** FLOP *** [8h 3h 4h]
Vipecori checks
Talab 07 bets 0.12€
TorviCalls folds
Epouvantable folds
Vipecori folds
Talab 07 collected 0.26€ from pot
*** SUMMARY ***
Total pot 0.26€ | Rake 0.02€
Board: [8h 3h 4h]
Seat 2: Talab 07 (big blind) won 0.26€


Winamax Poker - Go Fast "Bucarest" - HandId: #16870380-6398-1643811203 - Omaha pot limit (0.01€/0.02€) - 2022/02/02 14:13:23 UTC
Table: 'Bucarest' 6-max (real money) Seat #6 is the button
Seat 1: 2143658709 (2€)
Seat 2: jelachatte (4.79€)
Seat 3: Yo_Mama (1.09€)
Seat 4: Epouvantable (0.19€)
Seat 5: TIKItes26 (0.52€)
Seat 6: Un jour sur2 (1.38€)
*** ANTE/BLINDS ***
2143658709 posts small blind 0.01€
jelachatte posts big blind 0.02€
Dealt to jelachatte [Td Jd 5h Jc]
*** PRE-FLOP *** 
Yo_Mama raises 0.04€ to 0.06€
Epouvantable calls 0.06€
TIKItes26 folds
Un jour sur2 folds
2143658709 raises 0.20€ to 0.26€
jelachatte folds
Yo_Mama calls 0.20€
Epouvantable calls 0.13€ and is all-in
*** FLOP *** [Ac As Ts]
2143658709 bets 0.21€
Yo_Mama folds
*** TURN *** [Ac As Ts][Kd]
*** RIVER *** [Ac As Ts Kd][3h]
*** SHOW DOWN ***
Epouvantable shows [4s Qc 6d 5d] (One pair : Aces)
2143658709 shows [Kc 8c 8h 7h] (Two pairs : Aces and Kings)
2143658709 collected 0.87€ from pot
*** SUMMARY ***
Total pot 0.87€ | Rake 0.07€
Board: [Ac As Ts Kd 3h]
Seat 1: 2143658709 (small blind) showed [Kc 8c 8h 7h] and won 0.87€ with Two pairs : Aces and Kings
Seat 4: Epouvantable showed [4s Qc 6d 5d] and lost with One pair : Aces


Winamax Poker - Go Fast "Bucarest" - HandId: #16870380-6399-1643811220 - Omaha pot limit (0.01€/0.02€) - 2022/02/02 14:13:40 UTC
Table: 'Bucarest' 6-max (real money) Seat #6 is the button
Seat 1: Talab 07 (2.10€)
Seat 2: jelachatte (4.77€)
Seat 3: Vipecori (2.30€)
Seat 4: TorviCalls (2.62€)
Seat 5: Un jour sur2 (1.38€)
Seat 6: TIKItes26 (0.52€)
*** ANTE/BLINDS ***
Talab 07 posts small blind 0.01€
jelachatte posts big blind 0.02€
Dealt to jelachatte [Ad Ks 9s Kc]
*** PRE-FLOP *** 
Vipecori calls 0.02€
TorviCalls folds
Un jour sur2 raises 0.07€ to 0.09€
TIKItes26 folds
Talab 07 folds
jelachatte raises 0.21€ to 0.30€
Vipecori folds
Un jour sur2 calls 0.21€
*** FLOP *** [Kd 2d 2h]
jelachatte checks
Un jour sur2 checks
*** TURN *** [Kd 2d 2h][5c]
jelachatte bets 0.42€
Un jour sur2 folds
jelachatte collected 0.99€ from pot
*** SUMMARY ***
Total pot 0.99€ | Rake 0.06€
Board: [Kd 2d 2h 5c]
Seat 2: jelachatte (big blind) won 0.99€


Winamax Poker - Go Fast "Bucarest" - HandId: #16870380-6402-1643811295 - Omaha pot limit (0.01€/0.02€) - 2022/02/02 14:14:55 UTC
Table: 'Bucarest' 6-max (real money) Seat #6 is the button
Seat 1: jelachatte (5.04€)
Seat 2: TorviCalls (2.62€)
Seat 3: Epouvantable (2€)
Seat 4: Talab 07 (2.07€)
Seat 5: ParisQJWin (1.38€)
Seat 6: Un jour sur2 (1.07€)
*** ANTE/BLINDS ***
jelachatte posts small blind 0.01€
TorviCalls posts big blind 0.02€
Dealt to jelachatte [3d Jd Kc 6d]
*** PRE-FLOP *** 
Epouvantable raises 0.05€ to 0.07€
Talab 07 calls 0.07€
ParisQJWin calls 0.07€
Un jour sur2 folds
jelachatte folds
TorviCalls folds
*** FLOP *** [2c Kd Kh]
Epouvantable checks
Talab 07 bets 0.02€
ParisQJWin folds
Epouvantable calls 0.02€
*** TURN *** [2c Kd Kh][7c]
Epouvantable checks
Talab 07 bets 0.28€
Epouvantable folds
Talab 07 collected 0.53€ from pot
*** SUMMARY ***
Total pot 0.53€ | Rake 0.03€
Board: [2c Kd Kh 7c]
Seat 4: Talab 07 won 0.53€


Winamax Poker - Go Fast "Bucarest" - HandId: #16870380-6403-1643811337 - Omaha pot limit (0.01€/0.02€) - 2022/02/02 14:15:37 UTC
Table: 'Bucarest' 6-max (real money) Seat #6 is the button
Seat 1: jelachatte (5.03€)
Seat 2: Yo_Mama (2€)
Seat 3: Un jour sur2 (2€)
Seat 4: 2143658709 (3.37€)
Seat 5: Epouvantable (1.91€)
Seat 6: ParisQJWin (1.31€)
*** ANTE/BLINDS ***
jelachatte posts small blind 0.01€
Yo_Mama posts big blind 0.02€
Dealt to jelachatte [Kc Jc 9h 7h]
*** PRE-FLOP *** 
Un jour sur2 raises 0.02€ to 0.04€
2143658709 calls 0.04€
Epouvantable raises 0.02€ to 0.06€
ParisQJWin calls 0.06€
jelachatte calls 0.05€
Yo_Mama calls 0.04€
Un jour sur2 calls 0.02€
2143658709 calls 0.02€
*** FLOP *** [2c 3c 6h]
jelachatte checks
Yo_Mama checks
Un jour sur2 bets 0.27€
2143658709 folds
Epouvantable raises 0.27€ to 0.54€
ParisQJWin folds
jelachatte folds
Yo_Mama folds
Un jour sur2 raises 1.40€ to 1.94€ and is all-in
Epouvantable calls 1.31€ and is all-in
*** TURN *** [2c 3c 6h][6s]
*** RIVER *** [2c 3c 6h 6s][Qs]
*** SHOW DOWN ***
Un jour sur2 shows [5d 8c 2d Qc] (Two pairs : Queens and 6)
Epouvantable shows [3s 9s 3h 9c] (Full of 3 and 6)
Epouvantable collected 3.65€ from main pot
Un jour sur2 collected 0.09€ from side pot 1
*** SUMMARY ***
Total pot 3.74€ | Rake 0.41€
Board: [2c 3c 6h 6s Qs]
Seat 3: Un jour sur2 showed [5d 8c 2d Qc] and won 0.09€ with Two pairs : Queens and 6
Seat 5: Epouvantable showed [3s 9s 3h 9c] and won 3.65€ with Full of 3 and 6


Winamax Poker - Go Fast "Bucarest" - HandId: #16870380-6404-1643811409 - Omaha pot limit (0.01€/0.02€) - 2022/02/02 14:16:49 UTC
Table: 'Bucarest' 6-max (real money) Seat #6 is the button
Seat 1: TorviCalls (2.60€)
Seat 2: Yo_Mama (1.94€)
Seat 3: jelachatte (4.97€)
Seat 4: ParisQJWin (1.25€)
Seat 5: 2143658709 (3.31€)
Seat 6: Talab 07 (2.23€)
*** ANTE/BLINDS ***
TorviCalls posts small blind 0.01€
Yo_Mama posts big blind 0.02€
Dealt to jelachatte [6s Jh Qh 6d]
*** PRE-FLOP *** 
jelachatte folds
ParisQJWin folds
2143658709 raises 0.05€ to 0.07€
Talab 07 folds
TorviCalls calls 0.06€
Yo_Mama calls 0.05€
*** FLOP *** [Tc Qd 4d]
TorviCalls checks
Yo_Mama checks
2143658709 bets 0.15€
TorviCalls calls 0.15€
Yo_Mama folds
*** TURN *** [Tc Qd 4d][Qs]
TorviCalls checks
2143658709 bets 0.38€
TorviCalls folds
2143658709 collected 0.84€ from pot
*** SUMMARY ***
Total pot 0.84€ | Rake 0.05€
Board: [Tc Qd 4d Qs]
Seat 5: 2143658709 won 0.84€


Winamax Poker - Go Fast "Bucarest" - HandId: #16870380-6405-1643811456 - Omaha pot limit (0.01€/0.02€) - 2022/02/02 14:17:36 UTC
Table: 'Bucarest' 6-max (real money) Seat #6 is the button
Seat 1: Yo_Mama (1.87€)
Seat 2: jelachatte (4.97€)
Seat 3: TorviCalls (2.38€)
Seat 4: Un jour sur2 (0.09€)
Seat 5: ParisQJWin (1.25€)
Seat 6: Epouvantable (3.65€)
*** ANTE/BLINDS ***
Yo_Mama posts small blind 0.01€
jelachatte posts big blind 0.02€
Dealt to jelachatte [2s Ks 4s 4h]
*** PRE-FLOP *** 
TorviCalls raises 0.03€ to 0.05€
Un jour sur2 raises 0.04€ to 0.09€ and is all-in
ParisQJWin calls 0.09€
Epouvantable raises 0.35€ to 0.44€
Yo_Mama folds
jelachatte folds
TorviCalls folds
ParisQJWin calls 0.35€
*** FLOP *** [2h Kc 3h]
ParisQJWin bets 0.81€ and is all-in
Epouvantable folds
*** TURN *** [2h Kc 3h][Qs]
*** RIVER *** [2h Kc 3h Qs][6c]
*** SHOW DOWN ***
Un jour sur2 shows [5c 8h Th 3c] (One pair : 3)
ParisQJWin shows [Jh 8s 6d Kh] (Two pairs : Kings and 6)
ParisQJWin collected 1.75€ from pot
*** SUMMARY ***
Total pot 1.75€ | Rake 0.11€
Board: [2h Kc 3h Qs 6c]
Seat 4: Un jour sur2 showed [5c 8h Th 3c] and lost with One pair : 3
Seat 5: ParisQJWin showed [Jh 8s 6d Kh] and won 1.75€ with Two pairs : Kings and 6


Winamax Poker - Go Fast "Bucarest" - HandId: #16870380-6406-1643811486 - Omaha pot limit (0.01€/0.02€) - 2022/02/02 14:18:06 UTC
Table: 'Bucarest' 6-max (real money) Seat #6 is the button
Seat 1: jelachatte (4.95€)
Seat 2: Yo_Mama (1.86€)
Seat 3: TIKItes26 (0.54€)
Seat 4: Epouvantable (3.21€)
Seat 5: Talab 07 (2.23€)
Seat 6: 2143658709 (3.55€)
Hold-up to Pot: total 0.20€
*** ANTE/BLINDS ***
jelachatte posts small blind 0.01€
Yo_Mama posts big blind 0.02€
Dealt to jelachatte [2d 3s As Js]
*** PRE-FLOP *** 
TIKItes26 calls 0.02€
Epouvantable folds
Talab 07 raises 0.02€ to 0.04€
2143658709 calls 0.04€
jelachatte calls 0.03€
Yo_Mama calls 0.02€
TIKItes26 calls 0.02€
*** FLOP *** [Ts 4h 9s]
jelachatte bets 0.20€
Yo_Mama folds
TIKItes26 raises 0.30€ to 0.50€ and is all-in
Talab 07 folds
2143658709 folds
jelachatte calls 0.30€
*** TURN *** [Ts 4h 9s][Ac]
*** RIVER *** [Ts 4h 9s Ac][2c]
*** SHOW DOWN ***
TIKItes26 shows [Jh Qs Ks 8d] (High card : Ace)
jelachatte shows [2d 3s As Js] (Two pairs : Aces and 2)
jelachatte collected 1.28€ from pot
*** SUMMARY ***
Total pot 1.28€ | Rake 0.12€
Board: [Ts 4h 9s Ac 2c]
Seat 1: jelachatte (small blind) showed [2d 3s As Js] and won 1.28€ with Two pairs : Aces and 2
Seat 3: TIKItes26 showed [Jh Qs Ks 8d] and lost with High card : Ace


Winamax Poker - Go Fast "Bucarest" - HandId: #16870380-6407-1643811529 - Omaha pot limit (0.01€/0.02€) - 2022/02/02 14:18:49 UTC
Table: 'Bucarest' 6-max (real money) Seat #6 is the button
Seat 1: Yo_Mama (1.82€)
Seat 2: jelachatte (5.69€)
Seat 3: TorviCalls (2.33€)
Seat 4: Un jour sur2 (1.46€)
Seat 5: Epouvantable (3.21€)
Seat 6: ParisQJWin (1.75€)
*** ANTE/BLINDS ***
Yo_Mama posts small blind 0.01€
jelachatte posts big blind 0.02€
Dealt to jelachatte [9c Ad 3h 5s]
*** PRE-FLOP *** 
TorviCalls raises 0.03€ to 0.05€
Un jour sur2 folds
Epouvantable raises 0.03€ to 0.08€
ParisQJWin folds
Yo_Mama raises 0.23€ to 0.31€
jelachatte folds
TorviCalls folds
Epouvantable folds
Yo_Mama collected 0.46€ from pot
*** SUMMARY ***
Total pot 0.46€ | No rake
Seat 1: Yo_Mama (small blind) won 0.46€


Winamax Poker - Go Fast "Bucarest" - HandId: #16870380-6408-1643811551 - Omaha pot limit (0.01€/0.02€) - 2022/02/02 14:19:11 UTC
Table: 'Bucarest' 6-max (real money) Seat #6 is the button
Seat 1: jelachatte (5.67€)
Seat 2: Valakk (2€)
Seat 3: ParisQJWin (1.75€)
Seat 4: 2143658709 (3.51€)
Seat 5: Un jour sur2 (1.46€)
Seat 6: Talab 07 (2.19€)
Hold-up to Pot: total 0.10€
*** ANTE/BLINDS ***
jelachatte posts small blind 0.01€
Valakk posts big blind 0.02€
Dealt to jelachatte [3h Kh Ad 5c]
*** PRE-FLOP *** 
ParisQJWin calls 0.02€
2143658709 calls 0.02€
Un jour sur2 calls 0.02€
Talab 07 calls 0.02€
jelachatte folds
Valakk raises 0.11€ to 0.13€
ParisQJWin calls 0.11€
2143658709 calls 0.11€
Un jour sur2 folds
Talab 07 folds
*** FLOP *** [Tc 4d Ac]
Valakk bets 0.54€
ParisQJWin calls 0.54€
2143658709 folds
*** TURN *** [Tc 4d Ac][6d]
Valakk bets 1.33€ and is all-in
ParisQJWin calls 1.08€ and is all-in
*** RIVER *** [Tc 4d Ac 6d][5s]
*** SHOW DOWN ***
ParisQJWin shows [Kd Jc 8h Qc] (High card : Ace)
Valakk shows [3c 4h 2s Th] (Straight 6 high)
Valakk collected 3.66€ from pot
*** SUMMARY ***
Total pot 3.66€ | Rake 0.37€
Board: [Tc 4d Ac 6d 5s]
Seat 2: Valakk (big blind) showed [3c 4h 2s Th] and won 3.66€ with Straight 6 high
Seat 3: ParisQJWin showed [Kd Jc 8h Qc] and lost with High card : Ace


Winamax Poker - Go Fast "Bucarest" - HandId: #16870380-6409-1643811624 - Omaha pot limit (0.01€/0.02€) - 2022/02/02 14:20:24 UTC
Table: 'Bucarest' 6-max (real money) Seat #6 is the button
Seat 1: Valakk (3.66€)
Seat 2: jelachatte (5.66€)
Seat 3: Yo_Mama (1.97€)
Seat 4: Talab 07 (2.17€)
Seat 5: Un jour sur2 (1.44€)
Seat 6: Epouvantable (3.13€)
Hold-up to Pot: total 0.10€
*** ANTE/BLINDS ***
Valakk posts small blind 0.01€
jelachatte posts big blind 0.02€
Dealt to jelachatte [Jh 6d Th Qd]
*** PRE-FLOP *** 
Yo_Mama raises 0.02€ to 0.04€
Talab 07 calls 0.04€
Un jour sur2 calls 0.04€
Epouvantable raises 0.16€ to 0.20€
Valakk raises 0.54€ to 0.74€
jelachatte folds
Yo_Mama folds
Talab 07 folds
Un jour sur2 raises 0.70€ to 1.44€ and is all-in
Epouvantable calls 1.24€
Valakk raises 0.70€ to 2.14€
Epouvantable calls 0.70€
*** FLOP *** [4s 8h 7h]
Valakk bets 1.52€ and is all-in
Epouvantable calls 0.99€ and is all-in
*** TURN *** [4s 8h 7h][6h]
*** RIVER *** [4s 8h 7h 6h][4h]
*** SHOW DOWN ***
Valakk shows [Tc Ac Ts 5c] (Two pairs : Tens and 4)
Un jour sur2 shows [Td 9d 5h Jd] (Straight Ten high)
Epouvantable shows [7d Ks Kd Js] (Two pairs : Kings and 4)
Epouvantable collected 3.12€ from side pot 1
Un jour sur2 collected 4.08€ from main pot
Valakk collected 0.53€ from side pot 2
*** SUMMARY ***
Total pot 7.73€ | Rake 0.70€
Board: [4s 8h 7h 6h 4h]
Seat 1: Valakk (small blind) showed [Tc Ac Ts 5c] and won 0.53€ with Two pairs : Tens and 4
Seat 5: Un jour sur2 showed [Td 9d 5h Jd] and won 4.08€ with Straight Ten high
Seat 6: Epouvantable (button) showed [7d Ks Kd Js] and won 3.12€ with Two pairs : Kings and 4


Winamax Poker - Go Fast "Bucarest" - HandId: #16870380-6410-1643811689 - Omaha pot limit (0.01€/0.02€) - 2022/02/02 14:21:29 UTC
Table: 'Bucarest' 6-max (real money) Seat #6 is the button
Seat 1: Yo_Mama (1.93€)
Seat 2: coreve28 (2€)
Seat 3: Valakk (0.53€)
Seat 4: jelachatte (5.64€)
Seat 5: 2143658709 (3.38€)
Seat 6: Epouvantable (3.12€)
Hold-up to Pot: total 0.10€
*** ANTE/BLINDS ***
Yo_Mama posts small blind 0.01€
coreve28 posts big blind 0.02€
Dealt to jelachatte [As 8c 6c 6s]
*** PRE-FLOP *** 
Valakk raises 0.05€ to 0.07€
jelachatte calls 0.07€
2143658709 folds
Epouvantable raises 0.05€ to 0.12€
Yo_Mama folds
coreve28 calls 0.10€
Valakk raises 0.41€ to 0.53€ and is all-in
jelachatte folds
Epouvantable calls 0.41€
coreve28 calls 0.41€
*** FLOP *** [Jd 6h 9s]
coreve28 checks
Epouvantable checks
*** TURN *** [Jd 6h 9s][3h]
coreve28 bets 0.02€
Epouvantable calls 0.02€
*** RIVER *** [Jd 6h 9s 3h][4h]
coreve28 bets 0.02€
Epouvantable calls 0.02€
*** SHOW DOWN ***
coreve28 shows [7s 3s 3c Ac] (Trips of 3)
Valakk shows [Ts 5s Qc Kc] (High card : King)
Epouvantable shows [Ad Kh 5c Jh] (Flush King high)
Epouvantable collected 1.67€ from pot
*** SUMMARY ***
Total pot 1.67€ | Rake 0.18€
Board: [Jd 6h 9s 3h 4h]
Seat 2: coreve28 (big blind) showed [7s 3s 3c Ac] and lost with Trips of 3
Seat 3: Valakk showed [Ts 5s Qc Kc] and lost with High card : King
Seat 6: Epouvantable (button) showed [Ad Kh 5c Jh] and won 1.67€ with Flush King high


Winamax Poker - Go Fast "Bucarest" - HandId: #16870380-6411-1643811748 - Omaha pot limit (0.01€/0.02€) - 2022/02/02 14:22:28 UTC
Table: 'Bucarest' 6-max (real money) Seat #6 is the button
Seat 1: jelachatte (5.57€)
Seat 2: pumamao (0.50€)
Seat 3: Yo_Mama (1.92€)
Seat 4: Epouvantable (4.22€)
Seat 5: Talab 07 (2.13€)
Seat 6: Un jour sur2 (4.08€)
Hold-up to Pot: total 0.10€
*** ANTE/BLINDS ***
jelachatte posts small blind 0.01€
pumamao posts big blind 0.02€
Dealt to jelachatte [Ks 6s 4d Jh]
*** PRE-FLOP *** 
Yo_Mama raises 0.02€ to 0.04€
Epouvantable folds
Talab 07 folds
Un jour sur2 folds
jelachatte folds
pumamao calls 0.02€
*** FLOP *** [4s Kh 5s]
pumamao bets 0.02€
Yo_Mama calls 0.02€
*** TURN *** [4s Kh 5s][6d]
pumamao bets 0.02€
Yo_Mama raises 0.12€ to 0.14€
pumamao calls 0.12€
*** RIVER *** [4s Kh 5s 6d][8h]
pumamao checks
Yo_Mama bets 0.38€
pumamao calls 0.30€ and is all-in
*** SHOW DOWN ***
pumamao shows [8c 7s As 5d] (Straight 8 high)
Yo_Mama shows [6c Qd Qs 7c] (Straight 8 high)
Yo_Mama collected 0.59€ from side pot 1
pumamao collected 0.50€ from main pot
*** SUMMARY ***
Total pot 1.09€ | Rake 0.10€
Board: [4s Kh 5s 6d 8h]
Seat 2: pumamao (big blind) showed [8c 7s As 5d] and won 0.50€ with Straight 8 high
Seat 3: Yo_Mama showed [6c Qd Qs 7c] and won 0.59€ with Straight 8 high


Winamax Poker - Go Fast "Bucarest" - HandId: #16870380-6412-1643811764 - Omaha pot limit (0.01€/0.02€) - 2022/02/02 14:22:44 UTC
Table: 'Bucarest' 6-max (real money) Seat #6 is the button
Seat 1: coreve28 (1.43€)
Seat 2: CL_Joker8 (0.50€)
Seat 3: jelachatte (5.56€)
Seat 4: Un jour sur2 (4.08€)
Seat 5: Epouvantable (4.22€)
Seat 6: 2143658709 (3.38€)
Hold-up to Pot: total 0.10€
*** ANTE/BLINDS ***
coreve28 posts small blind 0.01€
CL_Joker8 posts big blind 0.02€
Dealt to jelachatte [Qc 3c 4h 7h]
*** PRE-FLOP *** 
jelachatte folds
Un jour sur2 raises 0.03€ to 0.05€
Epouvantable folds
2143658709 calls 0.05€
coreve28 calls 0.04€
CL_Joker8 calls 0.03€
*** FLOP *** [6h 9c 5d]
coreve28 checks
CL_Joker8 checks
Un jour sur2 checks
2143658709 bets 0.20€
coreve28 folds
CL_Joker8 folds
Un jour sur2 folds
2143658709 collected 0.48€ from pot
*** SUMMARY ***
Total pot 0.48€ | Rake 0.02€
Board: [6h 9c 5d]
Seat 6: 2143658709 (button) won 0.48€


Winamax Poker - Go Fast "Bucarest" - HandId: #16870380-6413-1643811798 - Omaha pot limit (0.01€/0.02€) - 2022/02/02 14:23:18 UTC
Table: 'Bucarest' 6-max (real money) Seat #6 is the button
Seat 1: CL_Joker8 (0.45€)
Seat 2: Yo_Mama (1.93€)
Seat 3: pumamao (0.50€)
Seat 4: jelachatte (5.56€)
Seat 5: Talab 07 (2.13€)
Seat 6: Epouvantable (4.22€)
*** ANTE/BLINDS ***
CL_Joker8 posts small blind 0.01€
Yo_Mama posts big blind 0.02€
Dealt to jelachatte [7c Ad 9s 5c]
*** PRE-FLOP *** 
pumamao calls 0.02€
jelachatte folds
Talab 07 calls 0.02€
Epouvantable calls 0.02€
CL_Joker8 folds
Yo_Mama checks
*** FLOP *** [Ac Qs 9h]
Yo_Mama checks
pumamao bets 0.02€
Talab 07 calls 0.02€
Epouvantable folds
Yo_Mama folds
*** TURN *** [Ac Qs 9h][As]
pumamao checks
Talab 07 checks
*** RIVER *** [Ac Qs 9h As][4d]
pumamao checks
Talab 07 bets 0.10€
pumamao folds
Talab 07 collected 0.22€ from pot
*** SUMMARY ***
Total pot 0.22€ | Rake 0.01€
Board: [Ac Qs 9h As 4d]
Seat 5: Talab 07 won 0.22€


Winamax Poker - Go Fast "Bucarest" - HandId: #16870380-6414-1643811823 - Omaha pot limit (0.01€/0.02€) - 2022/02/02 14:23:43 UTC
Table: 'Bucarest' 6-max (real money) Seat #6 is the button
Seat 1: jelachatte (5.56€)
Seat 2: Epouvantable (4.20€)
Seat 3: CL_Joker8 (0.44€)
Seat 4: coreve28 (1.38€)
Seat 5: 2143658709 (3.61€)
Seat 6: Un jour sur2 (4.03€)
*** ANTE/BLINDS ***
jelachatte posts small blind 0.01€
Epouvantable posts big blind 0.02€
Dealt to jelachatte [8h As 4h 7c]
*** PRE-FLOP *** 
CL_Joker8 calls 0.02€
coreve28 calls 0.02€
2143658709 calls 0.02€
Un jour sur2 calls 0.02€
jelachatte folds
Epouvantable raises 0.08€ to 0.10€
CL_Joker8 calls 0.08€
coreve28 calls 0.08€
2143658709 folds
Un jour sur2 folds
*** FLOP *** [7s 3d 9d]
Epouvantable bets 0.02€
CL_Joker8 raises 0.32€ to 0.34€ and is all-in
coreve28 folds
Epouvantable calls 0.32€
*** TURN *** [7s 3d 9d][Ah]
*** RIVER *** [7s 3d 9d Ah][9c]
*** SHOW DOWN ***
Epouvantable shows [7d Ks Kh Th] (Two pairs : Kings and 9)
CL_Joker8 shows [4c 3s 3c 8s] (Full of 3 and 9)
CL_Joker8 collected 0.93€ from pot
*** SUMMARY ***
Total pot 0.93€ | Rake 0.10€
Board: [7s 3d 9d Ah 9c]
Seat 2: Epouvantable (big blind) showed [7d Ks Kh Th] and lost with Two pairs : Kings and 9
Seat 3: CL_Joker8 showed [4c 3s 3c 8s] and won 0.93€ with Full of 3 and 9


Winamax Poker - Go Fast "Bucarest" - HandId: #16870380-6415-1643811911 - Omaha pot limit (0.01€/0.02€) - 2022/02/02 14:25:11 UTC
Table: 'Bucarest' 6-max (real money) Seat #6 is the button
Seat 1: Yo_Mama (1.91€)
Seat 2: jelachatte (5.55€)
Seat 3: coreve28 (1.28€)
Seat 4: CL_Joker8 (0.93€)
Seat 5: 2143658709 (3.59€)
Seat 6: Talab 07 (2.21€)
*** ANTE/BLINDS ***
Yo_Mama posts small blind 0.01€
jelachatte posts big blind 0.02€
Dealt to jelachatte [Qs Qh 8h Qd]
*** PRE-FLOP *** 
coreve28 calls 0.02€
CL_Joker8 calls 0.02€
2143658709 calls 0.02€
Talab 07 raises 0.08€ to 0.10€
Yo_Mama raises 0.08€ to 0.18€
jelachatte folds
coreve28 calls 0.16€
CL_Joker8 calls 0.16€
2143658709 folds
Talab 07 raises 0.76€ to 0.94€
Yo_Mama calls 0.76€
coreve28 calls 0.76€
CL_Joker8 calls 0.75€ and is all-in
*** FLOP *** [Js Tc 3c]
Yo_Mama bets 0.97€ and is all-in
coreve28 calls 0.34€ and is all-in
Talab 07 calls 0.97€
*** TURN *** [Js Tc 3c][5s]
*** RIVER *** [Js Tc 3c 5s][Jd]
*** SHOW DOWN ***
coreve28 shows [Ts 7h Kh 8d] (Two pairs : Jacks and Tens)
CL_Joker8 shows [4s Ah 9h 6s] (One pair : Jacks)
Talab 07 shows [9d 5d 4c 7d] (Two pairs : Jacks and 5)
Yo_Mama shows [5h 2c 5c 4h] (Full of 5 and Jacks)
Yo_Mama collected 5.46€ from pot
*** SUMMARY ***
Total pot 5.46€ | Rake 0.61€
Board: [Js Tc 3c 5s Jd]
Seat 1: Yo_Mama (small blind) showed [5h 2c 5c 4h] and won 5.46€ with Full of 5 and Jacks
Seat 3: coreve28 showed [Ts 7h Kh 8d] and lost with Two pairs : Jacks and Tens
Seat 4: CL_Joker8 showed [4s Ah 9h 6s] and lost with One pair : Jacks
Seat 6: Talab 07 (button) showed [9d 5d 4c 7d] and lost with Two pairs : Jacks and 5


Winamax Poker - Go Fast "Bucarest" - HandId: #16870380-6416-1643811987 - Omaha pot limit (0.01€/0.02€) - 2022/02/02 14:26:27 UTC
Table: 'Bucarest' 6-max (real money) Seat #5 is the button
Seat 1: Talab 07 (0.30€)
Seat 2: Yo_Mama (5.46€)
Seat 3: 2143658709 (3.57€)
Seat 4: jelachatte (5.53€)
Seat 5: Epouvantable (3.76€)
*** ANTE/BLINDS ***
Talab 07 posts small blind 0.01€
Yo_Mama posts big blind 0.02€
Dealt to jelachatte [7s Js Jh Jd]
*** PRE-FLOP *** 
2143658709 calls 0.02€
jelachatte folds
Epouvantable calls 0.02€
Talab 07 raises 0.08€ to 0.10€
Yo_Mama calls 0.08€
2143658709 calls 0.08€
Epouvantable folds
*** FLOP *** [2s Qd 7h]
Talab 07 bets 0.20€ and is all-in
Yo_Mama calls 0.20€
2143658709 folds
*** TURN *** [2s Qd 7h][9c]
*** RIVER *** [2s Qd 7h 9c][Qs]
*** SHOW DOWN ***
Talab 07 shows [Kc 9s Jc 8d] (Two pairs : Queens and 9)
Yo_Mama shows [Qh 8s Qc Kh] (Quads of Queens)
Yo_Mama collected 0.65€ from pot
*** SUMMARY ***
Total pot 0.65€ | Rake 0.07€
Board: [2s Qd 7h 9c Qs]
Seat 1: Talab 07 (small blind) showed [Kc 9s Jc 8d] and lost with Two pairs : Queens and 9
Seat 2: Yo_Mama (big blind) showed [Qh 8s Qc Kh] and won 0.65€ with Quads of Queens


Winamax Poker - Go Fast "Bucarest" - HandId: #16870380-6417-1643812039 - Omaha pot limit (0.01€/0.02€) - 2022/02/02 14:27:19 UTC
Table: 'Bucarest' 6-max (real money) Seat #6 is the button
Seat 1: Yo_Mama (5.81€)
Seat 2: 2143658709 (3.47€)
Seat 3: MaisQueTCon (0.50€)
Seat 4: Epouvantable (3.74€)
Seat 5: jelachatte (5.53€)
Seat 6: coreve28 (2€)
*** ANTE/BLINDS ***
Yo_Mama posts small blind 0.01€
2143658709 posts big blind 0.02€
Dealt to jelachatte [3d Ks Th Jh]
*** PRE-FLOP *** 
MaisQueTCon raises 0.05€ to 0.07€
Epouvantable calls 0.07€
jelachatte folds
coreve28 calls 0.07€
Yo_Mama folds
2143658709 calls 0.05€
*** FLOP *** [Td 7s 2c]
2143658709 checks
MaisQueTCon checks
Epouvantable checks
coreve28 bets 0.02€
2143658709 calls 0.02€
MaisQueTCon calls 0.02€
Epouvantable folds
*** TURN *** [Td 7s 2c][5d]
2143658709 checks
MaisQueTCon checks
coreve28 bets 0.35€
2143658709 folds
MaisQueTCon folds
coreve28 collected 0.66€ from pot
*** SUMMARY ***
Total pot 0.66€ | Rake 0.04€
Board: [Td 7s 2c 5d]
Seat 6: coreve28 (button) won 0.66€


Winamax Poker - Go Fast "Bucarest" - HandId: #16870380-6418-1643812090 - Omaha pot limit (0.01€/0.02€) - 2022/02/02 14:28:10 UTC
Table: 'Bucarest' 6-max (real money) Seat #6 is the button
Seat 1: MaisQueTCon (0.41€)
Seat 2: Colombani13 (2€)
Seat 3: Epouvantable (3.67€)
Seat 4: Yo_Mama (5.80€)
Seat 5: Talab 07 (2€)
Seat 6: jelachatte (5.53€)
*** ANTE/BLINDS ***
MaisQueTCon posts small blind 0.01€
Colombani13 posts big blind 0.02€
Dealt to jelachatte [Th 8h Td 3s]
*** PRE-FLOP *** 
Epouvantable folds
Yo_Mama raises 0.04€ to 0.06€
Talab 07 calls 0.06€
jelachatte folds
MaisQueTCon folds
Colombani13 raises 0.04€ to 0.10€
Yo_Mama calls 0.04€
Talab 07 calls 0.04€
*** FLOP *** [5h 5s 7h]
Colombani13 bets 0.02€
Yo_Mama calls 0.02€
Talab 07 calls 0.02€
*** TURN *** [5h 5s 7h][3h]
Colombani13 checks
Yo_Mama checks
Talab 07 checks
*** RIVER *** [5h 5s 7h 3h][Jh]
Colombani13 checks
Yo_Mama checks
Talab 07 checks
*** SHOW DOWN ***
Colombani13 shows [Ac Ks Tc 8s] (One pair : 5)
Yo_Mama shows [Qh 9s Kc Js] (Two pairs : Jacks and 5)
Talab 07 shows [Jd As 6s 8d] (Two pairs : Jacks and 5)
Talab 07 collected 0.33€ from pot
*** SUMMARY ***
Total pot 0.33€ | Rake 0.04€
Board: [5h 5s 7h 3h Jh]
Seat 2: Colombani13 (big blind) showed [Ac Ks Tc 8s] and lost with One pair : 5
Seat 4: Yo_Mama showed [Qh 9s Kc Js] and lost with Two pairs : Jacks and 5
Seat 5: Talab 07 showed [Jd As 6s 8d] and won 0.33€ with Two pairs : Jacks and 5


Winamax Poker - Go Fast "Bucarest" - HandId: #16870380-6419-1643812248 - Omaha pot limit (0.01€/0.02€) - 2022/02/02 14:30:48 UTC
Table: 'Bucarest' 6-max (real money) Seat #6 is the button
Seat 1: Colombani13 (1.88€)
Seat 2: Talab 07 (2.21€)
Seat 3: Yo_Mama (5.68€)
Seat 4: 2143658709 (3.38€)
Seat 5: coreve28 (2.22€)
Seat 6: jelachatte (5.53€)
Hold-up to Pot: total 0.10€
*** ANTE/BLINDS ***
Colombani13 posts small blind 0.01€
Talab 07 posts big blind 0.02€
Dealt to jelachatte [Td Kh 9s 7h]
*** PRE-FLOP *** 
Yo_Mama calls 0.02€
2143658709 calls 0.02€
coreve28 folds
jelachatte folds
Colombani13 folds
Talab 07 checks
*** FLOP *** [Ad 6c 2h]
Talab 07 checks
Yo_Mama bets 0.09€
2143658709 calls 0.09€
Talab 07 folds
*** TURN *** [Ad 6c 2h][Qh]
Yo_Mama bets 0.26€
2143658709 calls 0.26€
*** RIVER *** [Ad 6c 2h Qh][Ah]
Yo_Mama bets 0.47€
2143658709 folds
Yo_Mama collected 1.26€ from pot
*** SUMMARY ***
Total pot 1.26€ | Rake 0.08€
Board: [Ad 6c 2h Qh Ah]
Seat 3: Yo_Mama won 1.26€


Winamax Poker - Go Fast "Bucarest" - HandId: #16870380-6420-1643812325 - Omaha pot limit (0.01€/0.02€) - 2022/02/02 14:32:05 UTC
Table: 'Bucarest' 6-max (real money) Seat #4 is the button
Seat 1: 2143658709 (3.01€)
Seat 2: jelachatte (5.53€)
Seat 3: Talab 07 (2.19€)
Seat 4: coreve28 (2.22€)
*** ANTE/BLINDS ***
2143658709 posts small blind 0.01€
jelachatte posts big blind 0.02€
Dealt to jelachatte [Qs 2d Jh 4c]
*** PRE-FLOP *** 
Talab 07 calls 0.02€
coreve28 calls 0.02€
2143658709 calls 0.01€
jelachatte checks
*** FLOP *** [9d 8c 9h]
2143658709 checks
jelachatte checks
Talab 07 checks
coreve28 checks
*** TURN *** [9d 8c 9h][Qd]
2143658709 checks
jelachatte bets 0.03€
Talab 07 calls 0.03€
coreve28 folds
2143658709 folds
*** RIVER *** [9d 8c 9h Qd][Kh]
jelachatte checks
Talab 07 checks
*** SHOW DOWN ***
Talab 07 shows [6s Th 4d As] (One pair : 9)
jelachatte shows [Qs 2d Jh 4c] (Two pairs : Queens and 9)
jelachatte collected 0.13€ from pot
*** SUMMARY ***
Total pot 0.13€ | Rake 0.01€
Board: [9d 8c 9h Qd Kh]
Seat 2: jelachatte (big blind) showed [Qs 2d Jh 4c] and won 0.13€ with Two pairs : Queens and 9
Seat 3: Talab 07 showed [6s Th 4d As] and lost with One pair : 9


Winamax Poker - Go Fast "Bucarest" - HandId: #16870380-6422-1643812520 - Omaha pot limit (0.01€/0.02€) - 2022/02/02 14:35:20 UTC
Table: 'Bucarest' 6-max (real money) Seat #4 is the button
Seat 1: Yo_Mama (5.63€)
Seat 2: jelachatte (5.61€)
Seat 3: Talab 07 (2.58€)
Seat 4: 2143658709 (2.92€)
*** ANTE/BLINDS ***
Yo_Mama posts small blind 0.01€
jelachatte posts big blind 0.02€
Dealt to jelachatte [Tc 2c 4s 4c]
*** PRE-FLOP *** 
Talab 07 folds
2143658709 calls 0.02€
Yo_Mama calls 0.01€
jelachatte checks
*** FLOP *** [As Kh Qc]
Yo_Mama checks
jelachatte checks
2143658709 bets 0.04€
Yo_Mama calls 0.04€
jelachatte folds
*** TURN *** [As Kh Qc][4h]
Yo_Mama checks
2143658709 checks
*** RIVER *** [As Kh Qc 4h][Kc]
Yo_Mama checks
2143658709 checks
*** SHOW DOWN ***
Yo_Mama shows [Qh Jc 9h 3d] (Two pairs : Kings and Queens)
2143658709 shows [2h 3s Ac 8h] (Two pairs : Aces and Kings)
2143658709 collected 0.13€ from pot
*** SUMMARY ***
Total pot 0.13€ | Rake 0.01€
Board: [As Kh Qc 4h Kc]
Seat 1: Yo_Mama (small blind) showed [Qh Jc 9h 3d] and lost with Two pairs : Kings and Queens
Seat 4: 2143658709 (button) showed [2h 3s Ac 8h] and won 0.13€ with Two pairs : Aces and Kings


Winamax Poker - Go Fast "Bucarest" - HandId: #16870380-6423-1643812583 - Omaha pot limit (0.01€/0.02€) - 2022/02/02 14:36:23 UTC
Table: 'Bucarest' 6-max (real money) Seat #4 is the button
Seat 1: Yo_Mama (5.57€)
Seat 2: jelachatte (5.59€)
Seat 3: 2143658709 (2.99€)
Seat 4: Talab 07 (2.58€)
*** ANTE/BLINDS ***
Yo_Mama posts small blind 0.01€
jelachatte posts big blind 0.02€
Dealt to jelachatte [Qh 8s Kc 9h]
*** PRE-FLOP *** 
2143658709 folds
Talab 07 calls 0.02€
Yo_Mama calls 0.01€
jelachatte checks
*** FLOP *** [8h 2h Ac]
Yo_Mama bets 0.04€
jelachatte calls 0.04€
Talab 07 calls 0.04€
*** TURN *** [8h 2h Ac][8c]
Yo_Mama bets 0.09€
jelachatte calls 0.09€
Talab 07 calls 0.09€
*** RIVER *** [8h 2h Ac 8c][Ad]
Yo_Mama bets 0.30€
jelachatte folds
Talab 07 folds
Yo_Mama collected 0.70€ from pot
*** SUMMARY ***
Total pot 0.70€ | Rake 0.05€
Board: [8h 2h Ac 8c Ad]
Seat 1: Yo_Mama (small blind) won 0.70€


Winamax Poker - Go Fast "Bucarest" - HandId: #16870380-6424-1643812687 - Omaha pot limit (0.01€/0.02€) - 2022/02/02 14:38:07 UTC
Table: 'Bucarest' 6-max (real money) Seat #4 is the button
Seat 1: jelachatte (5.44€)
Seat 2: Yo_Mama (5.82€)
Seat 3: Talab 07 (2.43€)
Seat 4: 2143658709 (2.99€)
*** ANTE/BLINDS ***
jelachatte posts small blind 0.01€
Yo_Mama posts big blind 0.02€
Dealt to jelachatte [7c Kc 4s 2c]
*** PRE-FLOP *** 
Talab 07 calls 0.02€
2143658709 calls 0.02€
jelachatte folds
Yo_Mama checks
*** FLOP *** [Kh 8d Th]
Yo_Mama checks
Talab 07 checks
2143658709 checks
*** TURN *** [Kh 8d Th][8s]
Yo_Mama checks
Talab 07 bets 0.05€
2143658709 folds
Yo_Mama folds
Talab 07 collected 0.11€ from pot
*** SUMMARY ***
Total pot 0.11€ | Rake 0.01€
Board: [Kh 8d Th 8s]
Seat 3: Talab 07 won 0.11€


Winamax Poker - Go Fast "Bucarest" - HandId: #16870380-6425-1643812743 - Omaha pot limit (0.01€/0.02€) - 2022/02/02 14:39:03 UTC
Table: 'Bucarest' 6-max (real money) Seat #4 is the button
Seat 1: Yo_Mama (5.80€)
Seat 2: jelachatte (5.43€)
Seat 3: Talab 07 (2.47€)
Seat 4: 2143658709 (2.97€)
*** ANTE/BLINDS ***
Yo_Mama posts small blind 0.01€
jelachatte posts big blind 0.02€
Dealt to jelachatte [Jc 8s 6c Ad]
*** PRE-FLOP *** 
Talab 07 calls 0.02€
2143658709 calls 0.02€
Yo_Mama folds
jelachatte checks
*** FLOP *** [9h Td Ah]
jelachatte checks
Talab 07 bets 0.05€
2143658709 folds
jelachatte calls 0.05€
*** TURN *** [9h Td Ah][Qc]
jelachatte bets 0.09€
Talab 07 raises 0.35€ to 0.44€
jelachatte calls 0.35€
*** RIVER *** [9h Td Ah Qc][Js]
jelachatte checks
Talab 07 checks
*** SHOW DOWN ***
Talab 07 shows [2d 7h 2h As] (One pair : Aces)
jelachatte shows [Jc 8s 6c Ad] (Straight Queen high)
jelachatte collected 0.94€ from pot
*** SUMMARY ***
Total pot 0.94€ | Rake 0.11€
Board: [9h Td Ah Qc Js]
Seat 2: jelachatte (big blind) showed [Jc 8s 6c Ad] and won 0.94€ with Straight Queen high
Seat 3: Talab 07 showed [2d 7h 2h As] and lost with One pair : Aces


Winamax Poker - Go Fast "Bucarest" - HandId: #16870380-6426-1643812822 - Omaha pot limit (0.01€/0.02€) - 2022/02/02 14:40:22 UTC
Table: 'Bucarest' 6-max (real money) Seat #4 is the button
Seat 1: jelachatte (5.86€)
Seat 2: Yo_Mama (5.79€)
Seat 3: 2143658709 (2.95€)
Seat 4: Talab 07 (1.96€)
*** ANTE/BLINDS ***
jelachatte posts small blind 0.01€
Yo_Mama posts big blind 0.02€
Dealt to jelachatte [2c Jh 6h 2s]
*** PRE-FLOP *** 
2143658709 calls 0.02€
Talab 07 raises 0.07€ to 0.09€
jelachatte folds
Yo_Mama folds
2143658709 raises 0.21€ to 0.30€
Talab 07 calls 0.21€
*** FLOP *** [As 6d 6s]
2143658709 bets 0.42€
Talab 07 raises 1.24€ to 1.66€ and is all-in
2143658709 calls 1.24€
*** TURN *** [As 6d 6s][Qc]
*** RIVER *** [As 6d 6s Qc][5d]
*** SHOW DOWN ***
2143658709 shows [7h Ks 7c Kh] (Two pairs : Kings and 6)
Talab 07 shows [8d 8s 2h Ac] (Two pairs : Aces and 6)
Talab 07 collected 3.55€ from pot
*** SUMMARY ***
Total pot 3.55€ | Rake 0.40€
Board: [As 6d 6s Qc 5d]
Seat 3: 2143658709 showed [7h Ks 7c Kh] and lost with Two pairs : Kings and 6
Seat 4: Talab 07 (button) showed [8d 8s 2h Ac] and won 3.55€ with Two pairs : Aces and 6


Winamax Poker - Go Fast "Bucarest" - HandId: #16870380-6427-1643812871 - Omaha pot limit (0.01€/0.02€) - 2022/02/02 14:41:11 UTC
Table: 'Bucarest' 6-max (real money) Seat #3 is the button
Seat 1: Yo_Mama (5.77€)
Seat 2: jelachatte (5.85€)
Seat 3: Talab 07 (3.55€)
*** ANTE/BLINDS ***
Yo_Mama posts small blind 0.01€
jelachatte posts big blind 0.02€
Dealt to jelachatte [9d 5h 7c 4s]
*** PRE-FLOP *** 
Talab 07 calls 0.02€
Yo_Mama raises 0.06€ to 0.08€
jelachatte folds
Talab 07 calls 0.06€
*** FLOP *** [Jd 3h Ad]
Yo_Mama checks
Talab 07 bets 0.02€
Yo_Mama calls 0.02€
*** TURN *** [Jd 3h Ad][5d]
Yo_Mama checks
Talab 07 bets 0.11€
Yo_Mama folds
Talab 07 collected 0.31€ from pot
*** SUMMARY ***
Total pot 0.31€ | Rake 0.02€
Board: [Jd 3h Ad 5d]
Seat 3: Talab 07 (button) won 0.31€


Winamax Poker - Go Fast "Bucarest" - HandId: #16870380-6428-1643812936 - Omaha pot limit (0.01€/0.02€) - 2022/02/02 14:42:16 UTC
Table: 'Bucarest' 6-max (real money) Seat #3 is the button
Seat 1: jelachatte (5.83€)
Seat 2: Yo_Mama (5.67€)
Seat 3: Talab 07 (3.65€)
*** ANTE/BLINDS ***
jelachatte posts small blind 0.01€
Yo_Mama posts big blind 0.02€
Dealt to jelachatte [2d As 8d Kc]
*** PRE-FLOP *** 
Talab 07 calls 0.02€
jelachatte folds
Yo_Mama checks
*** FLOP *** [Kd 5h Qh]
Yo_Mama checks
Talab 07 bets 0.02€
Yo_Mama calls 0.02€
*** TURN *** [Kd 5h Qh][4h]
Yo_Mama checks
Talab 07 bets 0.02€
Yo_Mama folds
Talab 07 collected 0.10€ from pot
*** SUMMARY ***
Total pot 0.10€ | Rake 0.01€
Board: [Kd 5h Qh 4h]
Seat 3: Talab 07 (button) won 0.10€


Winamax Poker - Go Fast "Bucarest" - HandId: #16870380-6429-1643812981 - Omaha pot limit (0.01€/0.02€) - 2022/02/02 14:43:01 UTC
Table: 'Bucarest' 6-max (real money) Seat #3 is the button
Seat 1: jelachatte (5.82€)
Seat 2: Talab 07 (3.69€)
Seat 3: Yo_Mama (5.63€)
*** ANTE/BLINDS ***
jelachatte posts small blind 0.01€
Talab 07 posts big blind 0.02€
Dealt to jelachatte [5d 9d Jd 4d]
*** PRE-FLOP *** 
Yo_Mama raises 0.04€ to 0.06€
jelachatte folds
Talab 07 folds
Yo_Mama collected 0.09€ from pot
*** SUMMARY ***
Total pot 0.09€ | No rake
Seat 3: Yo_Mama (button) won 0.09€


Winamax Poker - Go Fast "Bucarest" - HandId: #16870380-6430-1643812993 - Omaha pot limit (0.01€/0.02€) - 2022/02/02 14:43:13 UTC
Table: 'Bucarest' 6-max (real money) Seat #3 is the button
Seat 1: Yo_Mama (5.66€)
Seat 2: jelachatte (5.81€)
Seat 3: Talab 07 (3.67€)
*** ANTE/BLINDS ***
Yo_Mama posts small blind 0.01€
jelachatte posts big blind 0.02€
Dealt to jelachatte [5h Ts 2d Jd]
*** PRE-FLOP *** 
Talab 07 raises 0.02€ to 0.04€
Yo_Mama calls 0.03€
jelachatte folds
*** FLOP *** [8d 8c Ad]
Yo_Mama checks
Talab 07 checks
*** TURN *** [8d 8c Ad][Ah]
Yo_Mama checks
Talab 07 bets 0.05€
Yo_Mama folds
Talab 07 collected 0.14€ from pot
*** SUMMARY ***
Total pot 0.14€ | Rake 0.01€
Board: [8d 8c Ad Ah]
Seat 3: Talab 07 (button) won 0.14€


Winamax Poker - Go Fast "Bucarest" - HandId: #16870380-6431-1643813033 - Omaha pot limit (0.01€/0.02€) - 2022/02/02 14:43:53 UTC
Table: 'Bucarest' 6-max (real money) Seat #3 is the button
Seat 1: jelachatte (5.79€)
Seat 2: Yo_Mama (5.62€)
Seat 3: Talab 07 (3.72€)
*** ANTE/BLINDS ***
jelachatte posts small blind 0.01€
Yo_Mama posts big blind 0.02€
Dealt to jelachatte [Td 8s Ad 2s]
*** PRE-FLOP *** 
Talab 07 folds
jelachatte raises 0.04€ to 0.06€
Yo_Mama folds
jelachatte collected 0.08€ from pot
*** SUMMARY ***
Total pot 0.08€ | No rake
Seat 1: jelachatte (small blind) won 0.08€


Winamax Poker - Go Fast "Bucarest" - HandId: #16870380-6432-1643813050 - Omaha pot limit (0.01€/0.02€) - 2022/02/02 14:44:10 UTC
Table: 'Bucarest' 6-max (real money) Seat #3 is the button
Seat 1: Yo_Mama (5.60€)
Seat 2: jelachatte (5.81€)
Seat 3: Talab 07 (3.72€)
*** ANTE/BLINDS ***
Yo_Mama posts small blind 0.01€
jelachatte posts big blind 0.02€
Dealt to jelachatte [3h 2c 6c 6h]
*** PRE-FLOP *** 
Talab 07 calls 0.02€
Yo_Mama calls 0.01€
jelachatte checks
*** FLOP *** [Ts 5c 2d]
Yo_Mama checks
jelachatte checks
Talab 07 checks
*** TURN *** [Ts 5c 2d][Kd]
Yo_Mama checks
jelachatte checks
Talab 07 bets 0.03€
Yo_Mama folds
jelachatte folds
Talab 07 collected 0.08€ from pot
*** SUMMARY ***
Total pot 0.08€ | Rake 0.01€
Board: [Ts 5c 2d Kd]
Seat 3: Talab 07 (button) won 0.08€


Winamax Poker - Go Fast "Bucarest" - HandId: #16870380-6433-1643813092 - Omaha pot limit (0.01€/0.02€) - 2022/02/02 14:44:52 UTC
Table: 'Bucarest' 6-max (real money) Seat #3 is the button
Seat 1: jelachatte (5.79€)
Seat 2: Yo_Mama (5.58€)
Seat 3: Talab 07 (3.75€)
*** ANTE/BLINDS ***
jelachatte posts small blind 0.01€
Yo_Mama posts big blind 0.02€
Dealt to jelachatte [9s Ac Jd 2d]
*** PRE-FLOP *** 
Talab 07 calls 0.02€
jelachatte folds
Yo_Mama checks
*** FLOP *** [2h 4s Ts]
Yo_Mama checks
Talab 07 bets 0.05€
Yo_Mama calls 0.05€
*** TURN *** [2h 4s Ts][5c]
Yo_Mama checks
Talab 07 bets 0.02€
Yo_Mama calls 0.02€
*** RIVER *** [2h 4s Ts 5c][Ah]
Yo_Mama checks
Talab 07 bets 0.13€
Yo_Mama folds
Talab 07 collected 0.30€ from pot
*** SUMMARY ***
Total pot 0.30€ | Rake 0.02€
Board: [2h 4s Ts 5c Ah]
Seat 3: Talab 07 (button) won 0.30€


Winamax Poker - Go Fast "Bucarest" - HandId: #16870380-6434-1643813164 - Omaha pot limit (0.01€/0.02€) - 2022/02/02 14:46:04 UTC
Table: 'Bucarest' 6-max (real money) Seat #3 is the button
Seat 1: Yo_Mama (5.49€)
Seat 2: jelachatte (5.78€)
Seat 3: Talab 07 (3.83€)
*** ANTE/BLINDS ***
Yo_Mama posts small blind 0.01€
jelachatte posts big blind 0.02€
Dealt to jelachatte [2s 2d Qh 6d]
*** PRE-FLOP *** 
Talab 07 raises 0.02€ to 0.04€
Yo_Mama calls 0.03€
jelachatte folds
*** FLOP *** [Td 6c 8s]
Yo_Mama bets 0.08€
Talab 07 calls 0.08€
*** TURN *** [Td 6c 8s][Jc]
Yo_Mama bets 0.20€
Talab 07 calls 0.20€
*** RIVER *** [Td 6c 8s Jc][6h]
Yo_Mama checks
Talab 07 checks
*** SHOW DOWN ***
Talab 07 shows [Kd Qs Ts 5h] (Two pairs : Tens and 6)
Yo_Mama shows [8h Ac 8c 4c] (Full of 8 and 6)
Yo_Mama collected 0.59€ from pot
*** SUMMARY ***
Total pot 0.59€ | Rake 0.07€
Board: [Td 6c 8s Jc 6h]
Seat 1: Yo_Mama (small blind) showed [8h Ac 8c 4c] and won 0.59€ with Full of 8 and 6
Seat 3: Talab 07 (button) showed [Kd Qs Ts 5h] and lost with Two pairs : Tens and 6


Winamax Poker - Go Fast "Bucarest" - HandId: #16870380-6435-1643813220 - Omaha pot limit (0.01€/0.02€) - 2022/02/02 14:47:00 UTC
Table: 'Bucarest' 6-max (real money) Seat #3 is the button
Seat 1: jelachatte (5.76€)
Seat 2: Yo_Mama (5.76€)
Seat 3: Talab 07 (3.51€)
*** ANTE/BLINDS ***
jelachatte posts small blind 0.01€
Yo_Mama posts big blind 0.02€
Dealt to jelachatte [6s As 4d 2d]
*** PRE-FLOP *** 
Talab 07 calls 0.02€
jelachatte raises 0.06€ to 0.08€
Yo_Mama calls 0.06€
Talab 07 folds
*** FLOP *** [Js Ks 9d]
jelachatte bets 0.09€
Yo_Mama calls 0.09€
*** TURN *** [Js Ks 9d][Ad]
jelachatte checks
Yo_Mama bets 0.24€
jelachatte calls 0.24€
*** RIVER *** [Js Ks 9d Ad][Qh]
jelachatte checks
Yo_Mama bets 0.33€
jelachatte folds
Yo_Mama collected 1.09€ from pot
*** SUMMARY ***
Total pot 1.09€ | Rake 0.08€
Board: [Js Ks 9d Ad Qh]
Seat 2: Yo_Mama (big blind) won 1.09€


Winamax Poker - Go Fast "Bucarest" - HandId: #16870380-6436-1643813278 - Omaha pot limit (0.01€/0.02€) - 2022/02/02 14:47:58 UTC
Table: 'Bucarest' 6-max (real money) Seat #3 is the button
Seat 1: jelachatte (5.35€)
Seat 2: Talab 07 (3.49€)
Seat 3: Yo_Mama (6.11€)
*** ANTE/BLINDS ***
jelachatte posts small blind 0.01€
Talab 07 posts big blind 0.02€
Dealt to jelachatte [9s 9h Qs 4c]
*** PRE-FLOP *** 
Yo_Mama calls 0.02€
jelachatte folds
Talab 07 checks
*** FLOP *** [6d Jc Js]
Talab 07 bets 0.02€
Yo_Mama folds
Talab 07 collected 0.06€ from pot
*** SUMMARY ***
Total pot 0.06€ | Rake 0.01€
Board: [6d Jc Js]
Seat 2: Talab 07 (big blind) won 0.06€


Winamax Poker - Go Fast "Bucarest" - HandId: #16870380-6438-1643813556 - Omaha pot limit (0.01€/0.02€) - 2022/02/02 14:52:36 UTC
Table: 'Bucarest' 6-max (real money) Seat #3 is the button
Seat 1: Yo_Mama (6.05€)
Seat 2: jelachatte (5.34€)
Seat 3: Talab 07 (3.56€)
*** ANTE/BLINDS ***
Yo_Mama posts small blind 0.01€
jelachatte posts big blind 0.02€
Dealt to jelachatte [9c Kd Th 4c]
*** PRE-FLOP *** 
Talab 07 calls 0.02€
Yo_Mama calls 0.01€
jelachatte checks
*** FLOP *** [Tc Qd 6c]
Yo_Mama checks
jelachatte checks
Talab 07 checks
*** TURN *** [Tc Qd 6c][4d]
Yo_Mama checks
jelachatte checks
Talab 07 bets 0.02€
Yo_Mama folds
jelachatte calls 0.02€
*** RIVER *** [Tc Qd 6c 4d][8d]
jelachatte checks
Talab 07 bets 0.05€
jelachatte folds
Talab 07 collected 0.14€ from pot
*** SUMMARY ***
Total pot 0.14€ | Rake 0.01€
Board: [Tc Qd 6c 4d 8d]
Seat 3: Talab 07 (button) won 0.14€


Winamax Poker - Go Fast "Bucarest" - HandId: #16870380-6439-1643813615 - Omaha pot limit (0.01€/0.02€) - 2022/02/02 14:53:35 UTC
Table: 'Bucarest' 6-max (real money) Seat #4 is the button
Seat 1: jelachatte (5.30€)
Seat 2: patience1234 (2€)
Seat 3: Yo_Mama (6.03€)
Seat 4: Talab 07 (3.61€)
*** ANTE/BLINDS ***
jelachatte posts small blind 0.01€
patience1234 posts big blind 0.02€
Dealt to jelachatte [2c Kh 7c 5d]
*** PRE-FLOP *** 
Yo_Mama folds
Talab 07 calls 0.02€
jelachatte folds
patience1234 checks
*** FLOP *** [Th 7s Js]
patience1234 bets 0.02€
Talab 07 folds
patience1234 collected 0.06€ from pot
*** SUMMARY ***
Total pot 0.06€ | Rake 0.01€
Board: [Th 7s Js]
Seat 2: patience1234 (big blind) won 0.06€


Winamax Poker - Go Fast "Bucarest" - HandId: #16870380-6440-1643813635 - Omaha pot limit (0.01€/0.02€) - 2022/02/02 14:53:55 UTC
Table: 'Bucarest' 6-max (real money) Seat #5 is the button
Seat 1: patience1234 (2.02€)
Seat 2: Clemclem7231 (2€)
Seat 3: jelachatte (5.29€)
Seat 4: Yo_Mama (6.03€)
Seat 5: Talab 07 (3.59€)
*** ANTE/BLINDS ***
patience1234 posts small blind 0.01€
Clemclem7231 posts big blind 0.02€
Dealt to jelachatte [Ac 8s Kd Jh]
*** PRE-FLOP *** 
jelachatte folds
Yo_Mama calls 0.02€
Talab 07 calls 0.02€
patience1234 calls 0.01€
Clemclem7231 checks
*** FLOP *** [5c 7c Ks]
patience1234 bets 0.02€
Clemclem7231 folds
Yo_Mama calls 0.02€
Talab 07 calls 0.02€
*** TURN *** [5c 7c Ks][6h]
patience1234 bets 0.02€
Yo_Mama calls 0.02€
Talab 07 calls 0.02€
*** RIVER *** [5c 7c Ks 6h][Th]
patience1234 checks
Yo_Mama checks
Talab 07 bets 0.10€
patience1234 folds
Yo_Mama folds
Talab 07 collected 0.28€ from pot
*** SUMMARY ***
Total pot 0.28€ | Rake 0.02€
Board: [5c 7c Ks 6h Th]
Seat 5: Talab 07 (button) won 0.28€


Winamax Poker - Go Fast "Bucarest" - HandId: #16870380-6441-1643813742 - Omaha pot limit (0.01€/0.02€) - 2022/02/02 14:55:42 UTC
Table: 'Bucarest' 6-max (real money) Seat #5 is the button
Seat 1: jelachatte (5.29€)
Seat 2: la volubile (2€)
Seat 3: patience1234 (1.96€)
Seat 4: Yo_Mama (5.97€)
Seat 5: Talab 07 (3.71€)
*** ANTE/BLINDS ***
jelachatte posts small blind 0.01€
la volubile posts big blind 0.02€
Dealt to jelachatte [6d 2d As Jc]
*** PRE-FLOP *** 
patience1234 raises 0.04€ to 0.06€
Yo_Mama calls 0.06€
Talab 07 calls 0.06€
jelachatte folds
la volubile calls 0.04€
*** FLOP *** [7d 3d 4h]
la volubile checks
patience1234 checks
Yo_Mama checks
Talab 07 checks
*** TURN *** [7d 3d 4h][Qd]
la volubile checks
patience1234 checks
Yo_Mama checks
Talab 07 bets 0.13€
la volubile folds
patience1234 calls 0.13€
Yo_Mama folds
*** RIVER *** [7d 3d 4h Qd][2h]
patience1234 checks
Talab 07 bets 0.26€
patience1234 folds
Talab 07 collected 0.72€ from pot
*** SUMMARY ***
Total pot 0.72€ | Rake 0.05€
Board: [7d 3d 4h Qd 2h]
Seat 5: Talab 07 (button) won 0.72€


Winamax Poker - Go Fast "Bucarest" - HandId: #16870380-6442-1643813807 - Omaha pot limit (0.01€/0.02€) - 2022/02/02 14:56:47 UTC
Table: 'Bucarest' 6-max (real money) Seat #5 is the button
Seat 1: la volubile (1.94€)
Seat 2: Yo_Mama (5.91€)
Seat 3: jelachatte (5.28€)
Seat 4: patience1234 (1.77€)
Seat 5: Talab 07 (3.98€)
*** ANTE/BLINDS ***
la volubile posts small blind 0.01€
Yo_Mama posts big blind 0.02€
Dealt to jelachatte [Tc 9h 4s 2d]
*** PRE-FLOP *** 
jelachatte folds
patience1234 raises 0.02€ to 0.04€
Talab 07 calls 0.04€
la volubile calls 0.03€
Yo_Mama calls 0.02€
*** FLOP *** [5d Ks 6c]
la volubile checks
Yo_Mama checks
patience1234 checks
Talab 07 checks
*** TURN *** [5d Ks 6c][7s]
la volubile bets 0.04€
Yo_Mama calls 0.04€
patience1234 calls 0.04€
Talab 07 calls 0.04€
*** RIVER *** [5d Ks 6c 7s][9c]
la volubile bets 0.16€
Yo_Mama folds
patience1234 folds
Talab 07 calls 0.16€
*** SHOW DOWN ***
la volubile shows [8d 3s Kd 7h] (Straight 9 high)
Talab 07 shows [8h 6h 3c Th] (Straight Ten high)
Talab 07 collected 0.58€ from pot
*** SUMMARY ***
Total pot 0.58€ | Rake 0.06€
Board: [5d Ks 6c 7s 9c]
Seat 1: la volubile (small blind) showed [8d 3s Kd 7h] and lost with Straight 9 high
Seat 5: Talab 07 (button) showed [8h 6h 3c Th] and won 0.58€ with Straight Ten high


