Winamax Poker - CashGame - HandId: #17024580-217-1646501040 - Omaha pot limit (0.01€/0.02€) - 2022/03/05 17:24:00 UTC
Table: 'Casablanca 06' 6-max (real money) Seat #4 is the button
Seat 1: marseille85. (2.09€)
Seat 2: garrincha58 (1.93€)
Seat 3: sanslgs (1.96€)
Seat 4: KrysBroke (4.28€)
Seat 5: Jaimiti (2.64€)
Seat 6: jelachatte (2€)
*** ANTE/BLINDS ***
Jaimiti posts small blind 0.01€
jelachatte posts big blind 0.02€
Dealt to jelachatte [4c Ah Ks 3c]
*** PRE-FLOP *** 
marseille85. folds
garrincha58 folds
sanslgs folds
KrysBroke raises 0.04€ to 0.06€
Jaimiti calls 0.05€
jelachatte folds
*** FLOP *** [Tc Kh 2s]
Jaimiti checks
KrysBroke bets 0.04€
Jaimiti calls 0.04€
*** TURN *** [Tc Kh 2s][Kd]
Jaimiti checks
KrysBroke checks
*** RIVER *** [Tc Kh 2s Kd][2d]
Jaimiti bets 0.05€
KrysBroke folds
Jaimiti collected 0.26€ from pot
*** SUMMARY ***
Total pot 0.26€ | Rake 0.01€
Board: [Tc Kh 2s Kd 2d]
Seat 5: Jaimiti (small blind) won 0.26€


Winamax Poker - CashGame - HandId: #17024580-218-1646501102 - Omaha pot limit (0.01€/0.02€) - 2022/03/05 17:25:02 UTC
Table: 'Casablanca 06' 6-max (real money) Seat #5 is the button
Seat 1: marseille85. (2.09€)
Seat 2: garrincha58 (1.93€)
Seat 3: sanslgs (1.96€)
Seat 4: KrysBroke (4.18€)
Seat 5: Jaimiti (2.75€)
Seat 6: jelachatte (2€)
*** ANTE/BLINDS ***
jelachatte posts small blind 0.01€
marseille85. posts big blind 0.02€
Dealt to jelachatte [Tc 4d 7c 3d]
*** PRE-FLOP *** 
garrincha58 folds
sanslgs folds
KrysBroke raises 0.04€ to 0.06€
Jaimiti folds
jelachatte folds
marseille85. folds
KrysBroke collected 0.09€ from pot
*** SUMMARY ***
Total pot 0.09€ | No rake
Seat 4: KrysBroke won 0.09€


Winamax Poker - CashGame - HandId: #17024580-219-1646501138 - Omaha pot limit (0.01€/0.02€) - 2022/03/05 17:25:38 UTC
Table: 'Casablanca 06' 6-max (real money) Seat #6 is the button
Seat 1: marseille85. (2.07€)
Seat 2: garrincha58 (1.93€)
Seat 3: sanslgs (1.96€)
Seat 4: KrysBroke (4.21€)
Seat 5: Jaimiti (2.75€)
Seat 6: jelachatte (2€)
*** ANTE/BLINDS ***
marseille85. posts small blind 0.01€
garrincha58 posts big blind 0.02€
Dealt to jelachatte [5d 3c 9c 2c]
*** PRE-FLOP *** 
sanslgs calls 0.02€
KrysBroke raises 0.06€ to 0.08€
Jaimiti folds
jelachatte folds
marseille85. calls 0.07€
garrincha58 folds
sanslgs folds
*** FLOP *** [3h 8d Kc]
marseille85. checks
KrysBroke checks
*** TURN *** [3h 8d Kc][Qc]
marseille85. checks
KrysBroke bets 0.15€
marseille85. folds
KrysBroke collected 0.34€ from pot
*** SUMMARY ***
Total pot 0.34€ | Rake 0.01€
Board: [3h 8d Kc Qc]
Seat 4: KrysBroke won 0.34€


Winamax Poker - CashGame - HandId: #17024580-220-1646501203 - Omaha pot limit (0.01€/0.02€) - 2022/03/05 17:26:43 UTC
Table: 'Casablanca 06' 6-max (real money) Seat #1 is the button
Seat 1: marseille85. (2€)
Seat 2: garrincha58 (1.91€)
Seat 3: sanslgs (1.94€)
Seat 4: KrysBroke (4.32€)
Seat 5: Jaimiti (2.75€)
Seat 6: jelachatte (2€)
*** ANTE/BLINDS ***
garrincha58 posts small blind 0.01€
sanslgs posts big blind 0.02€
Dealt to jelachatte [6h 8s Qd 8h]
*** PRE-FLOP *** 
KrysBroke raises 0.04€ to 0.06€
Jaimiti folds
jelachatte folds
marseille85. folds
garrincha58 folds
sanslgs calls 0.04€
*** FLOP *** [4s 9s Kd]
sanslgs checks
KrysBroke checks
*** TURN *** [4s 9s Kd][7c]
sanslgs checks
KrysBroke bets 0.09€
sanslgs folds
KrysBroke collected 0.21€ from pot
*** SUMMARY ***
Total pot 0.21€ | Rake 0.01€
Board: [4s 9s Kd 7c]
Seat 4: KrysBroke won 0.21€


Winamax Poker - CashGame - HandId: #17024580-221-1646501292 - Omaha pot limit (0.01€/0.02€) - 2022/03/05 17:28:12 UTC
Table: 'Casablanca 06' 6-max (real money) Seat #2 is the button
Seat 1: marseille85. (2€)
Seat 2: garrincha58 (1.90€)
Seat 3: sanslgs (1.88€)
Seat 4: KrysBroke (4.38€)
Seat 5: Jaimiti (2.75€)
Seat 6: jelachatte (2€)
*** ANTE/BLINDS ***
sanslgs posts small blind 0.01€
KrysBroke posts big blind 0.02€
Dealt to jelachatte [Kc 7d 8h Ad]
*** PRE-FLOP *** 
Jaimiti folds
jelachatte calls 0.02€
marseille85. folds
garrincha58 folds
sanslgs folds
KrysBroke checks
*** FLOP *** [5d Qh 7h]
KrysBroke checks
jelachatte checks
*** TURN *** [5d Qh 7h][8d]
KrysBroke bets 0.04€
jelachatte calls 0.04€
*** RIVER *** [5d Qh 7h 8d][Qc]
KrysBroke checks
jelachatte checks
*** SHOW DOWN ***
KrysBroke shows [7s Jd 8s 6h] (Two pairs : Queens and 8)
jelachatte shows [Kc 7d 8h Ad] (Two pairs : Queens and 8)
jelachatte collected 0.12€ from pot
*** SUMMARY ***
Total pot 0.12€ | Rake 0.01€
Board: [5d Qh 7h 8d Qc]
Seat 4: KrysBroke (big blind) showed [7s Jd 8s 6h] and lost with Two pairs : Queens and 8
Seat 6: jelachatte showed [Kc 7d 8h Ad] and won 0.12€ with Two pairs : Queens and 8


Winamax Poker - CashGame - HandId: #17024580-222-1646501333 - Omaha pot limit (0.01€/0.02€) - 2022/03/05 17:28:53 UTC
Table: 'Casablanca 06' 6-max (real money) Seat #3 is the button
Seat 1: marseille85. (2€)
Seat 2: garrincha58 (1.90€)
Seat 3: sanslgs (1.87€)
Seat 4: KrysBroke (4.32€)
Seat 5: Jaimiti (2.75€)
Seat 6: jelachatte (2.06€)
*** ANTE/BLINDS ***
KrysBroke posts small blind 0.01€
Jaimiti posts big blind 0.02€
Dealt to jelachatte [3s 4h 7h 3h]
*** PRE-FLOP *** 
jelachatte folds
marseille85. folds
garrincha58 folds
sanslgs folds
KrysBroke calls 0.01€
Jaimiti checks
*** FLOP *** [Qc 4c Jc]
KrysBroke checks
Jaimiti bets 0.02€
KrysBroke calls 0.02€
*** TURN *** [Qc 4c Jc][Tc]
KrysBroke checks
Jaimiti bets 0.03€
KrysBroke calls 0.03€
*** RIVER *** [Qc 4c Jc Tc][8s]
KrysBroke checks
Jaimiti bets 0.09€
KrysBroke folds
Jaimiti collected 0.22€ from pot
*** SUMMARY ***
Total pot 0.22€ | Rake 0.01€
Board: [Qc 4c Jc Tc 8s]
Seat 5: Jaimiti (big blind) won 0.22€


Winamax Poker - CashGame - HandId: #17024580-223-1646501388 - Omaha pot limit (0.01€/0.02€) - 2022/03/05 17:29:48 UTC
Table: 'Casablanca 06' 6-max (real money) Seat #4 is the button
Seat 1: marseille85. (2€)
Seat 2: garrincha58 (1.90€)
Seat 3: sanslgs (1.87€)
Seat 4: KrysBroke (4.25€)
Seat 5: Jaimiti (2.81€)
Seat 6: jelachatte (2.06€)
*** ANTE/BLINDS ***
Jaimiti posts small blind 0.01€
jelachatte posts big blind 0.02€
Dealt to jelachatte [9d Qh 6s 3h]
*** PRE-FLOP *** 
marseille85. folds
garrincha58 folds
sanslgs calls 0.02€
KrysBroke folds
Jaimiti folds
jelachatte checks
*** FLOP *** [Kd 3d 9c]
jelachatte checks
sanslgs checks
*** TURN *** [Kd 3d 9c][Ad]
jelachatte checks
sanslgs checks
*** RIVER *** [Kd 3d 9c Ad][Ac]
jelachatte checks
sanslgs checks
*** SHOW DOWN ***
sanslgs shows [3c 7c 5h 5s] (Two pairs : Aces and 5)
jelachatte shows [9d Qh 6s 3h] (Two pairs : Aces and 9)
jelachatte collected 0.05€ from pot
*** SUMMARY ***
Total pot 0.05€ | No rake
Board: [Kd 3d 9c Ad Ac]
Seat 3: sanslgs showed [3c 7c 5h 5s] and lost with Two pairs : Aces and 5
Seat 6: jelachatte (big blind) showed [9d Qh 6s 3h] and won 0.05€ with Two pairs : Aces and 9


Winamax Poker - CashGame - HandId: #17024580-224-1646501473 - Omaha pot limit (0.01€/0.02€) - 2022/03/05 17:31:13 UTC
Table: 'Casablanca 06' 6-max (real money) Seat #5 is the button
Seat 1: marseille85. (2€)
Seat 2: garrincha58 (1.90€)
Seat 3: sanslgs (1.85€)
Seat 4: KrysBroke (4.25€)
Seat 5: Jaimiti (2.80€)
Seat 6: jelachatte (2.09€)
*** ANTE/BLINDS ***
jelachatte posts small blind 0.01€
marseille85. posts big blind 0.02€
Dealt to jelachatte [5c 8s 4h Ad]
*** PRE-FLOP *** 
garrincha58 folds
sanslgs folds
KrysBroke raises 0.04€ to 0.06€
Jaimiti folds
jelachatte folds
marseille85. calls 0.04€
*** FLOP *** [2c 6d 6h]
marseille85. checks
KrysBroke checks
*** TURN *** [2c 6d 6h][4c]
marseille85. bets 0.08€
KrysBroke folds
marseille85. collected 0.20€ from pot
*** SUMMARY ***
Total pot 0.20€ | Rake 0.01€
Board: [2c 6d 6h 4c]
Seat 1: marseille85. (big blind) won 0.20€


Winamax Poker - CashGame - HandId: #17024580-225-1646501529 - Omaha pot limit (0.01€/0.02€) - 2022/03/05 17:32:09 UTC
Table: 'Casablanca 06' 6-max (real money) Seat #6 is the button
Seat 1: marseille85. (2.06€)
Seat 2: garrincha58 (1.90€)
Seat 3: sanslgs (1.85€)
Seat 4: KrysBroke (4.19€)
Seat 5: Jaimiti (2.80€)
Seat 6: jelachatte (2.08€)
*** ANTE/BLINDS ***
marseille85. posts small blind 0.01€
garrincha58 posts big blind 0.02€
Dealt to jelachatte [As 9h 8s 8c]
*** PRE-FLOP *** 
sanslgs calls 0.02€
KrysBroke folds
Jaimiti folds
jelachatte calls 0.02€
marseille85. folds
garrincha58 checks
*** FLOP *** [2s 3c Jh]
garrincha58 checks
sanslgs checks
jelachatte checks
*** TURN *** [2s 3c Jh][Ah]
garrincha58 checks
sanslgs checks
jelachatte checks
*** RIVER *** [2s 3c Jh Ah][4h]
garrincha58 checks
sanslgs checks
jelachatte checks
*** SHOW DOWN ***
sanslgs shows [7d 6c 7c Js] (One pair : Jacks)
jelachatte shows [As 9h 8s 8c] (One pair : Aces)
garrincha58 shows [2h 8h 7s 5s] (Flush Ace high)
garrincha58 collected 0.07€ from pot
*** SUMMARY ***
Total pot 0.07€ | No rake
Board: [2s 3c Jh Ah 4h]
Seat 2: garrincha58 (big blind) showed [2h 8h 7s 5s] and won 0.07€ with Flush Ace high
Seat 3: sanslgs showed [7d 6c 7c Js] and lost with One pair : Jacks
Seat 6: jelachatte (button) showed [As 9h 8s 8c] and lost with One pair : Aces


