PokerStars Hand #230305346325: Tournament #3276145955, €0.23+€0.02 EUR Omaha Pot Limit - Level I (10/20) - 2021/10/02 23:20:17 CET [2021/10/02 17:20:17 ET]
Table '3276145955 1' 3-max Seat #1 is the button
Seat 1: sasoklaus (500 in chips)
Seat 2: rrathon (500 in chips)
Seat 3: jeje_sat (500 in chips)
rrathon: posts small blind 10
jeje_sat: posts big blind 20
*** HOLE CARDS ***
Dealt to jeje_sat [Tc 4c 6h Jh]
sasoklaus: raises 20 to 40
rrathon: calls 30
jeje_sat: calls 20
*** FLOP *** [3h Ah 9s]
rrathon: bets 60
jeje_sat: calls 60
sasoklaus: folds
*** TURN *** [3h Ah 9s] [7s]
rrathon: bets 100
jeje_sat: calls 100
*** RIVER *** [3h Ah 9s 7s] [9c]
rrathon: bets 120
jeje_sat: folds
Uncalled bet (120) returned to rrathon
rrathon collected 440 from pot
rrathon: doesn't show hand
*** SUMMARY ***
Total pot 440 | Rake 0
Board [3h Ah 9s 7s 9c]
Seat 1: sasoklaus (button) folded on the Flop
Seat 2: rrathon (small blind) collected (440)
Seat 3: jeje_sat (big blind) folded on the River


PokerStars Hand #230305363586: Tournament #3276145955, €0.23+€0.02 EUR Omaha Pot Limit - Level I (10/20) - 2021/10/02 23:20:56 CET [2021/10/02 17:20:56 ET]
Table '3276145955 1' 3-max Seat #2 is the button
Seat 1: sasoklaus (460 in chips)
Seat 2: rrathon (740 in chips)
Seat 3: jeje_sat (300 in chips)
jeje_sat: posts small blind 10
sasoklaus: posts big blind 20
*** HOLE CARDS ***
Dealt to jeje_sat [3h Th Jd 4h]
rrathon: calls 20
jeje_sat: calls 10
sasoklaus: raises 60 to 80
rrathon: calls 60
jeje_sat: calls 60
*** FLOP *** [4d 7d 3s]
jeje_sat: bets 220 and is all-in
sasoklaus: raises 160 to 380 and is all-in
rrathon: folds
Uncalled bet (160) returned to sasoklaus
*** TURN *** [4d 7d 3s] [2c]
*** RIVER *** [4d 7d 3s 2c] [9d]
*** SHOW DOWN ***
jeje_sat: shows [3h Th Jd 4h] (two pair, Fours and Threes)
sasoklaus: shows [5c 5d 2s 4s] (two pair, Fours and Deuces)
jeje_sat collected 680 from pot
*** SUMMARY ***
Total pot 680 | Rake 0
Board [4d 7d 3s 2c 9d]
Seat 1: sasoklaus (big blind) showed [5c 5d 2s 4s] and lost with two pair, Fours and Deuces
Seat 2: rrathon (button) folded on the Flop
Seat 3: jeje_sat (small blind) showed [3h Th Jd 4h] and won (680) with two pair, Fours and Threes


PokerStars Hand #230305378189: Tournament #3276145955, €0.23+€0.02 EUR Omaha Pot Limit - Level I (10/20) - 2021/10/02 23:21:30 CET [2021/10/02 17:21:30 ET]
Table '3276145955 1' 3-max Seat #3 is the button
Seat 1: sasoklaus (160 in chips)
Seat 2: rrathon (660 in chips)
Seat 3: jeje_sat (680 in chips)
sasoklaus: posts small blind 10
rrathon: posts big blind 20
*** HOLE CARDS ***
Dealt to jeje_sat [5s 3c 9c Th]
jeje_sat: folds
sasoklaus: raises 40 to 60
rrathon: calls 40
*** FLOP *** [3h Qs 8h]
sasoklaus: bets 100 and is all-in
rrathon: calls 100
*** TURN *** [3h Qs 8h] [3d]
*** RIVER *** [3h Qs 8h 3d] [8s]
*** SHOW DOWN ***
sasoklaus: shows [Ah Jh Td 7s] (a pair of Eights)
rrathon: shows [Jc 5c Qc 4s] (two pair, Queens and Eights)
rrathon collected 320 from pot
sasoklaus finished the tournament in 3rd place
*** SUMMARY ***
Total pot 320 | Rake 0
Board [3h Qs 8h 3d 8s]
Seat 1: sasoklaus (small blind) showed [Ah Jh Td 7s] and lost with a pair of Eights
Seat 2: rrathon (big blind) showed [Jc 5c Qc 4s] and won (320) with two pair, Queens and Eights
Seat 3: jeje_sat (button) folded before Flop (didn't bet)


PokerStars Hand #230305389765: Tournament #3276145955, €0.23+€0.02 EUR Omaha Pot Limit - Level I (10/20) - 2021/10/02 23:21:56 CET [2021/10/02 17:21:56 ET]
Table '3276145955 1' 3-max Seat #2 is the button
Seat 2: rrathon (820 in chips)
Seat 3: jeje_sat (680 in chips)
rrathon: posts small blind 10
jeje_sat: posts big blind 20
*** HOLE CARDS ***
Dealt to jeje_sat [5h Qd 3s 9c]
rrathon: raises 20 to 40
jeje_sat: calls 20
*** FLOP *** [Ad 7c 4d]
jeje_sat: checks
rrathon: bets 80
jeje_sat: calls 80
*** TURN *** [Ad 7c 4d] [9d]
jeje_sat: checks
rrathon: bets 60
jeje_sat: folds
Uncalled bet (60) returned to rrathon
rrathon collected 240 from pot
rrathon: doesn't show hand
*** SUMMARY ***
Total pot 240 | Rake 0
Board [Ad 7c 4d 9d]
Seat 2: rrathon (button) (small blind) collected (240)
Seat 3: jeje_sat (big blind) folded on the Turn


PokerStars Hand #230305401317: Tournament #3276145955, €0.23+€0.02 EUR Omaha Pot Limit - Level I (10/20) - 2021/10/02 23:22:23 CET [2021/10/02 17:22:23 ET]
Table '3276145955 1' 3-max Seat #3 is the button
Seat 2: rrathon (940 in chips)
Seat 3: jeje_sat (560 in chips)
jeje_sat: posts small blind 10
rrathon: posts big blind 20
*** HOLE CARDS ***
Dealt to jeje_sat [5s Kd 3s Qd]
jeje_sat: calls 10
rrathon: checks
*** FLOP *** [8d 3d 4s]
rrathon: bets 20
jeje_sat: raises 80 to 100
rrathon: folds
Uncalled bet (80) returned to jeje_sat
jeje_sat collected 80 from pot
jeje_sat: doesn't show hand
*** SUMMARY ***
Total pot 80 | Rake 0
Board [8d 3d 4s]
Seat 2: rrathon (big blind) folded on the Flop
Seat 3: jeje_sat (button) (small blind) collected (80)


PokerStars Hand #230305409784: Tournament #3276145955, €0.23+€0.02 EUR Omaha Pot Limit - Level I (10/20) - 2021/10/02 23:22:42 CET [2021/10/02 17:22:42 ET]
Table '3276145955 1' 3-max Seat #2 is the button
Seat 2: rrathon (900 in chips)
Seat 3: jeje_sat (600 in chips)
rrathon: posts small blind 10
jeje_sat: posts big blind 20
*** HOLE CARDS ***
Dealt to jeje_sat [Ah 2h 7s 7h]
rrathon: folds
Uncalled bet (10) returned to jeje_sat
jeje_sat collected 20 from pot
jeje_sat: doesn't show hand
*** SUMMARY ***
Total pot 20 | Rake 0
Seat 2: rrathon (button) (small blind) folded before Flop
Seat 3: jeje_sat (big blind) collected (20)


PokerStars Hand #230305412630: Tournament #3276145955, €0.23+€0.02 EUR Omaha Pot Limit - Level I (10/20) - 2021/10/02 23:22:49 CET [2021/10/02 17:22:49 ET]
Table '3276145955 1' 3-max Seat #3 is the button
Seat 2: rrathon (890 in chips)
Seat 3: jeje_sat (610 in chips)
jeje_sat: posts small blind 10
rrathon: posts big blind 20
*** HOLE CARDS ***
Dealt to jeje_sat [Td Qs Qd 6s]
jeje_sat: raises 40 to 60
rrathon: folds
Uncalled bet (40) returned to jeje_sat
jeje_sat collected 40 from pot
jeje_sat: doesn't show hand
*** SUMMARY ***
Total pot 40 | Rake 0
Seat 2: rrathon (big blind) folded before Flop
Seat 3: jeje_sat (button) (small blind) collected (40)


PokerStars Hand #230305416410: Tournament #3276145955, €0.23+€0.02 EUR Omaha Pot Limit - Level I (10/20) - 2021/10/02 23:22:57 CET [2021/10/02 17:22:57 ET]
Table '3276145955 1' 3-max Seat #2 is the button
Seat 2: rrathon (870 in chips)
Seat 3: jeje_sat (630 in chips)
rrathon: posts small blind 10
jeje_sat: posts big blind 20
*** HOLE CARDS ***
Dealt to jeje_sat [Ah Qh 7s Jd]
rrathon: calls 10
jeje_sat: raises 40 to 60
rrathon: calls 40
*** FLOP *** [Th Qd 2s]
jeje_sat: bets 120
rrathon: calls 120
*** TURN *** [Th Qd 2s] [Tc]
jeje_sat: bets 360
rrathon: folds
Uncalled bet (360) returned to jeje_sat
jeje_sat collected 360 from pot
jeje_sat: doesn't show hand
*** SUMMARY ***
Total pot 360 | Rake 0
Board [Th Qd 2s Tc]
Seat 2: rrathon (button) (small blind) folded on the Turn
Seat 3: jeje_sat (big blind) collected (360)


PokerStars Hand #230305437549: Tournament #3276145955, €0.23+€0.02 EUR Omaha Pot Limit - Level II (15/30) - 2021/10/02 23:23:46 CET [2021/10/02 17:23:46 ET]
Table '3276145955 1' 3-max Seat #3 is the button
Seat 2: rrathon (690 in chips)
Seat 3: jeje_sat (810 in chips)
jeje_sat: posts small blind 15
rrathon: posts big blind 30
*** HOLE CARDS ***
Dealt to jeje_sat [Qs 7d Kh Qd]
jeje_sat: raises 60 to 90
rrathon: calls 60
*** FLOP *** [6s Td 7s]
rrathon: bets 90
jeje_sat: calls 90
*** TURN *** [6s Td 7s] [Js]
rrathon: checks
jeje_sat: checks
*** RIVER *** [6s Td 7s Js] [Kc]
rrathon: bets 60
jeje_sat: calls 60
*** SHOW DOWN ***
rrathon: shows [2h 3c Kd 3h] (a pair of Kings)
jeje_sat: shows [Qs 7d Kh Qd] (two pair, Kings and Sevens)
jeje_sat collected 480 from pot
*** SUMMARY ***
Total pot 480 | Rake 0
Board [6s Td 7s Js Kc]
Seat 2: rrathon (big blind) showed [2h 3c Kd 3h] and lost with a pair of Kings
Seat 3: jeje_sat (button) (small blind) showed [Qs 7d Kh Qd] and won (480) with two pair, Kings and Sevens


PokerStars Hand #230305449859: Tournament #3276145955, €0.23+€0.02 EUR Omaha Pot Limit - Level II (15/30) - 2021/10/02 23:24:14 CET [2021/10/02 17:24:14 ET]
Table '3276145955 1' 3-max Seat #2 is the button
Seat 2: rrathon (450 in chips)
Seat 3: jeje_sat (1050 in chips)
rrathon: posts small blind 15
jeje_sat: posts big blind 30
*** HOLE CARDS ***
Dealt to jeje_sat [7h 9s Jh Js]
rrathon: raises 30 to 60
jeje_sat: raises 120 to 180
rrathon: calls 120
*** FLOP *** [4d 7d 4s]
jeje_sat: bets 360
rrathon: folds
Uncalled bet (360) returned to jeje_sat
jeje_sat collected 360 from pot
jeje_sat: doesn't show hand
*** SUMMARY ***
Total pot 360 | Rake 0
Board [4d 7d 4s]
Seat 2: rrathon (button) (small blind) folded on the Flop
Seat 3: jeje_sat (big blind) collected (360)


PokerStars Hand #230305459593: Tournament #3276145955, €0.23+€0.02 EUR Omaha Pot Limit - Level II (15/30) - 2021/10/02 23:24:36 CET [2021/10/02 17:24:36 ET]
Table '3276145955 1' 3-max Seat #3 is the button
Seat 2: rrathon (270 in chips)
Seat 3: jeje_sat (1230 in chips)
jeje_sat: posts small blind 15
rrathon: posts big blind 30
*** HOLE CARDS ***
Dealt to jeje_sat [Qh Kh 5d Js]
jeje_sat: calls 15
rrathon: raises 60 to 90
jeje_sat: calls 60
*** FLOP *** [9s 4c 7d]
rrathon: bets 180 and is all-in
jeje_sat: folds
Uncalled bet (180) returned to rrathon
rrathon collected 180 from pot
rrathon: doesn't show hand
*** SUMMARY ***
Total pot 180 | Rake 0
Board [9s 4c 7d]
Seat 2: rrathon (big blind) collected (180)
Seat 3: jeje_sat (button) (small blind) folded on the Flop


PokerStars Hand #230305467491: Tournament #3276145955, €0.23+€0.02 EUR Omaha Pot Limit - Level II (15/30) - 2021/10/02 23:24:54 CET [2021/10/02 17:24:54 ET]
Table '3276145955 1' 3-max Seat #2 is the button
Seat 2: rrathon (360 in chips)
Seat 3: jeje_sat (1140 in chips)
rrathon: posts small blind 15
jeje_sat: posts big blind 30
*** HOLE CARDS ***
Dealt to jeje_sat [5d 7d Ad Qc]
rrathon: folds
Uncalled bet (15) returned to jeje_sat
jeje_sat collected 30 from pot
jeje_sat: doesn't show hand
*** SUMMARY ***
Total pot 30 | Rake 0
Seat 2: rrathon (button) (small blind) folded before Flop
Seat 3: jeje_sat (big blind) collected (30)


PokerStars Hand #230305470685: Tournament #3276145955, €0.23+€0.02 EUR Omaha Pot Limit - Level II (15/30) - 2021/10/02 23:25:02 CET [2021/10/02 17:25:02 ET]
Table '3276145955 1' 3-max Seat #3 is the button
Seat 2: rrathon (345 in chips)
Seat 3: jeje_sat (1155 in chips)
jeje_sat: posts small blind 15
rrathon: posts big blind 30
*** HOLE CARDS ***
Dealt to jeje_sat [Jc 8h 6d 5c]
jeje_sat: calls 15
rrathon: checks
*** FLOP *** [4d 7h 5h]
rrathon: bets 60
jeje_sat: raises 180 to 240
rrathon: calls 180
*** TURN *** [4d 7h 5h] [Tc]
rrathon: bets 75 and is all-in
jeje_sat: calls 75
*** RIVER *** [4d 7h 5h Tc] [6h]
*** SHOW DOWN ***
rrathon: shows [8d 8c Kd 8s] (a pair of Eights)
jeje_sat: shows [Jc 8h 6d 5c] (a straight, Four to Eight)
jeje_sat collected 690 from pot
*** SUMMARY ***
Total pot 690 | Rake 0
Board [4d 7h 5h Tc 6h]
Seat 2: rrathon (big blind) showed [8d 8c Kd 8s] and lost with a pair of Eights
Seat 3: jeje_sat (button) (small blind) showed [Jc 8h 6d 5c] and won (690) with a straight, Four to Eight


