PokerStars Hand #230025516332: Tournament #3269808612, €0.93+€0.07 EUR Omaha Pot Limit - Level I (10/20) - 2021/09/21 17:07:51 CET [2021/09/21 11:07:51 ET]
Table '3269808612 1' 3-max Seat #1 is the button
Seat 1: jeje_sat (500 in chips)
Seat 2: Kroma2021 (500 in chips)
Seat 3: touzay (500 in chips)
Kroma2021: posts small blind 10
touzay: posts big blind 20
*** HOLE CARDS ***
Dealt to jeje_sat [Qs 9d Th Kd]
jeje_sat: raises 50 to 70
Kroma2021: folds
touzay: calls 50
*** FLOP *** [8s 6h 2h]
touzay: checks
jeje_sat: checks
*** TURN *** [8s 6h 2h] [2s]
touzay: checks
jeje_sat: checks
*** RIVER *** [8s 6h 2h 2s] [7c]
touzay: checks
jeje_sat: checks
*** SHOW DOWN ***
touzay: shows [Tc Ac 8h 4d] (two pair, Eights and Deuces)
jeje_sat: shows [Qs 9d Th Kd] (a straight, Six to Ten)
jeje_sat collected 150 from pot
*** SUMMARY ***
Total pot 150 | Rake 0
Board [8s 6h 2h 2s 7c]
Seat 1: jeje_sat (button) showed [Qs 9d Th Kd] and won (150) with a straight, Six to Ten
Seat 2: Kroma2021 (small blind) folded before Flop
Seat 3: touzay (big blind) showed [Tc Ac 8h 4d] and lost with two pair, Eights and Deuces


PokerStars Hand #230025527605: Tournament #3269808612, €0.93+€0.07 EUR Omaha Pot Limit - Level I (10/20) - 2021/09/21 17:08:24 CET [2021/09/21 11:08:24 ET]
Table '3269808612 1' 3-max Seat #2 is the button
Seat 1: jeje_sat (580 in chips)
Seat 2: Kroma2021 (490 in chips)
Seat 3: touzay (430 in chips)
touzay: posts small blind 10
jeje_sat: posts big blind 20
*** HOLE CARDS ***
Dealt to jeje_sat [6d 8h 9s 7d]
Kroma2021: folds
touzay: calls 10
jeje_sat: checks
*** FLOP *** [5c 6c Qh]
touzay: checks
jeje_sat: bets 20
touzay: calls 20
*** TURN *** [5c 6c Qh] [7c]
touzay: checks
jeje_sat: checks
*** RIVER *** [5c 6c Qh 7c] [9d]
touzay: checks
jeje_sat: checks
*** SHOW DOWN ***
touzay: shows [5d Qd 2d 2h] (two pair, Queens and Fives)
jeje_sat: shows [6d 8h 9s 7d] (a straight, Five to Nine)
jeje_sat collected 80 from pot
*** SUMMARY ***
Total pot 80 | Rake 0
Board [5c 6c Qh 7c 9d]
Seat 1: jeje_sat (big blind) showed [6d 8h 9s 7d] and won (80) with a straight, Five to Nine
Seat 2: Kroma2021 (button) folded before Flop (didn't bet)
Seat 3: touzay (small blind) showed [5d Qd 2d 2h] and lost with two pair, Queens and Fives


PokerStars Hand #230025538442: Tournament #3269808612, €0.93+€0.07 EUR Omaha Pot Limit - Level I (10/20) - 2021/09/21 17:08:56 CET [2021/09/21 11:08:56 ET]
Table '3269808612 1' 3-max Seat #3 is the button
Seat 1: jeje_sat (620 in chips)
Seat 2: Kroma2021 (490 in chips)
Seat 3: touzay (390 in chips)
jeje_sat: posts small blind 10
Kroma2021: posts big blind 20
*** HOLE CARDS ***
Dealt to jeje_sat [Kd 7s 5s 7d]
touzay: calls 20
jeje_sat: calls 10
Kroma2021: raises 20 to 40
touzay: calls 20
jeje_sat: calls 20
*** FLOP *** [5d 7h Jd]
jeje_sat: checks
Kroma2021: checks
touzay: checks
*** TURN *** [5d 7h Jd] [6d]
jeje_sat: checks
Kroma2021: checks
touzay: bets 60
jeje_sat: raises 240 to 300
Kroma2021: folds
touzay: raises 50 to 350 and is all-in
jeje_sat: calls 50
*** RIVER *** [5d 7h Jd 6d] [Tc]
*** SHOW DOWN ***
jeje_sat: shows [Kd 7s 5s 7d] (a flush, King high)
touzay: shows [3d 9s 8s Kh] (a straight, Seven to Jack)
jeje_sat collected 820 from pot
touzay finished the tournament in 3rd place
*** SUMMARY ***
Total pot 820 | Rake 0
Board [5d 7h Jd 6d Tc]
Seat 1: jeje_sat (small blind) showed [Kd 7s 5s 7d] and won (820) with a flush, King high
Seat 2: Kroma2021 (big blind) folded on the Turn
Seat 3: touzay (button) showed [3d 9s 8s Kh] and lost with a straight, Seven to Jack


PokerStars Hand #230025557871: Tournament #3269808612, €0.93+€0.07 EUR Omaha Pot Limit - Level I (10/20) - 2021/09/21 17:09:52 CET [2021/09/21 11:09:52 ET]
Table '3269808612 1' 3-max Seat #2 is the button
Seat 1: jeje_sat (1050 in chips)
Seat 2: Kroma2021 (450 in chips)
Kroma2021: posts small blind 10
jeje_sat: posts big blind 20
*** HOLE CARDS ***
Dealt to jeje_sat [Th 4s Qc 7c]
Kroma2021: calls 10
jeje_sat: checks
*** FLOP *** [Ah 5h Ks]
jeje_sat: checks
Kroma2021: checks
*** TURN *** [Ah 5h Ks] [2s]
jeje_sat: checks
Kroma2021: bets 20
jeje_sat: calls 20
*** RIVER *** [Ah 5h Ks 2s] [As]
jeje_sat: checks
Kroma2021: bets 20
jeje_sat: folds
Uncalled bet (20) returned to Kroma2021
Kroma2021 collected 80 from pot
Kroma2021: doesn't show hand
*** SUMMARY ***
Total pot 80 | Rake 0
Board [Ah 5h Ks 2s As]
Seat 1: jeje_sat (big blind) folded on the River
Seat 2: Kroma2021 (button) (small blind) collected (80)


PokerStars Hand #230025567400: Tournament #3269808612, €0.93+€0.07 EUR Omaha Pot Limit - Level I (10/20) - 2021/09/21 17:10:20 CET [2021/09/21 11:10:20 ET]
Table '3269808612 1' 3-max Seat #1 is the button
Seat 1: jeje_sat (1010 in chips)
Seat 2: Kroma2021 (490 in chips)
jeje_sat: posts small blind 10
Kroma2021: posts big blind 20
*** HOLE CARDS ***
Dealt to jeje_sat [9h 7h 6h 4d]
jeje_sat: calls 10
Kroma2021: checks
*** FLOP *** [Tc Qc 6s]
Kroma2021: checks
jeje_sat: checks
*** TURN *** [Tc Qc 6s] [7d]
Kroma2021: checks
jeje_sat: bets 20
Kroma2021: calls 20
*** RIVER *** [Tc Qc 6s 7d] [8s]
Kroma2021: checks
jeje_sat: checks
*** SHOW DOWN ***
Kroma2021: shows [8h Jc 3d 5c] (a pair of Eights)
jeje_sat: shows [9h 7h 6h 4d] (a straight, Six to Ten)
jeje_sat collected 80 from pot
*** SUMMARY ***
Total pot 80 | Rake 0
Board [Tc Qc 6s 7d 8s]
Seat 1: jeje_sat (button) (small blind) showed [9h 7h 6h 4d] and won (80) with a straight, Six to Ten
Seat 2: Kroma2021 (big blind) showed [8h Jc 3d 5c] and lost with a pair of Eights


PokerStars Hand #230025589670: Tournament #3269808612, €0.93+€0.07 EUR Omaha Pot Limit - Level II (15/30) - 2021/09/21 17:10:58 CET [2021/09/21 11:10:58 ET]
Table '3269808612 1' 3-max Seat #2 is the button
Seat 1: jeje_sat (1050 in chips)
Seat 2: Kroma2021 (450 in chips)
Kroma2021: posts small blind 15
jeje_sat: posts big blind 30
*** HOLE CARDS ***
Dealt to jeje_sat [6c Jc 9s Qc]
Kroma2021: calls 15
jeje_sat: checks
*** FLOP *** [Ts 9h Kc]
jeje_sat: bets 60
Kroma2021: calls 60
*** TURN *** [Ts 9h Kc] [7h]
jeje_sat: bets 180
Kroma2021: folds
Uncalled bet (180) returned to jeje_sat
jeje_sat collected 180 from pot
jeje_sat: doesn't show hand
*** SUMMARY ***
Total pot 180 | Rake 0
Board [Ts 9h Kc 7h]
Seat 1: jeje_sat (big blind) collected (180)
Seat 2: Kroma2021 (button) (small blind) folded on the Turn


PokerStars Hand #230025604104: Tournament #3269808612, €0.93+€0.07 EUR Omaha Pot Limit - Level II (15/30) - 2021/09/21 17:11:39 CET [2021/09/21 11:11:39 ET]
Table '3269808612 1' 3-max Seat #1 is the button
Seat 1: jeje_sat (1140 in chips)
Seat 2: Kroma2021 (360 in chips)
jeje_sat: posts small blind 15
Kroma2021: posts big blind 30
*** HOLE CARDS ***
Dealt to jeje_sat [8s 6d Kc 7s]
jeje_sat: calls 15
Kroma2021: raises 60 to 90
jeje_sat: calls 60
*** FLOP *** [2h Qh Qc]
Kroma2021: checks
jeje_sat: checks
*** TURN *** [2h Qh Qc] [4s]
Kroma2021: checks
jeje_sat: checks
*** RIVER *** [2h Qh Qc 4s] [Tc]
Kroma2021: checks
jeje_sat: checks
*** SHOW DOWN ***
Kroma2021: shows [3s 2s Js Jd] (two pair, Queens and Jacks)
jeje_sat: mucks hand
Kroma2021 collected 180 from pot
*** SUMMARY ***
Total pot 180 | Rake 0
Board [2h Qh Qc 4s Tc]
Seat 1: jeje_sat (button) (small blind) mucked [8s 6d Kc 7s]
Seat 2: Kroma2021 (big blind) showed [3s 2s Js Jd] and won (180) with two pair, Queens and Jacks


PokerStars Hand #230025621383: Tournament #3269808612, €0.93+€0.07 EUR Omaha Pot Limit - Level II (15/30) - 2021/09/21 17:12:29 CET [2021/09/21 11:12:29 ET]
Table '3269808612 1' 3-max Seat #2 is the button
Seat 1: jeje_sat (1050 in chips)
Seat 2: Kroma2021 (450 in chips)
Kroma2021: posts small blind 15
jeje_sat: posts big blind 30
*** HOLE CARDS ***
Dealt to jeje_sat [Kc Jd 4h 7s]
Kroma2021: calls 15
jeje_sat: checks
*** FLOP *** [Qh 7d 8h]
jeje_sat: checks
Kroma2021: checks
*** TURN *** [Qh 7d 8h] [6s]
jeje_sat: checks
Kroma2021: checks
*** RIVER *** [Qh 7d 8h 6s] [5s]
jeje_sat: bets 60
Kroma2021: calls 60
*** SHOW DOWN ***
jeje_sat: shows [Kc Jd 4h 7s] (a straight, Four to Eight)
Kroma2021: mucks hand
jeje_sat collected 180 from pot
*** SUMMARY ***
Total pot 180 | Rake 0
Board [Qh 7d 8h 6s 5s]
Seat 1: jeje_sat (big blind) showed [Kc Jd 4h 7s] and won (180) with a straight, Four to Eight
Seat 2: Kroma2021 (button) (small blind) mucked [2h 8c 6h 7c]


PokerStars Hand #230025631978: Tournament #3269808612, €0.93+€0.07 EUR Omaha Pot Limit - Level II (15/30) - 2021/09/21 17:12:59 CET [2021/09/21 11:12:59 ET]
Table '3269808612 1' 3-max Seat #1 is the button
Seat 1: jeje_sat (1140 in chips)
Seat 2: Kroma2021 (360 in chips)
jeje_sat: posts small blind 15
Kroma2021: posts big blind 30
*** HOLE CARDS ***
Dealt to jeje_sat [Ac Kh 9d 8s]
jeje_sat: calls 15
Kroma2021: checks
*** FLOP *** [4s 7c As]
Kroma2021: checks
jeje_sat: bets 30
Kroma2021: calls 30
*** TURN *** [4s 7c As] [4h]
Kroma2021: checks
jeje_sat: bets 60
Kroma2021: calls 60
*** RIVER *** [4s 7c As 4h] [5d]
Kroma2021: checks
jeje_sat: checks
*** SHOW DOWN ***
Kroma2021: shows [Th 5h 9c 7s] (two pair, Sevens and Fives)
jeje_sat: shows [Ac Kh 9d 8s] (two pair, Aces and Fours)
jeje_sat collected 240 from pot
*** SUMMARY ***
Total pot 240 | Rake 0
Board [4s 7c As 4h 5d]
Seat 1: jeje_sat (button) (small blind) showed [Ac Kh 9d 8s] and won (240) with two pair, Aces and Fours
Seat 2: Kroma2021 (big blind) showed [Th 5h 9c 7s] and lost with two pair, Sevens and Fives


PokerStars Hand #230025648341: Tournament #3269808612, €0.93+€0.07 EUR Omaha Pot Limit - Level II (15/30) - 2021/09/21 17:13:46 CET [2021/09/21 11:13:46 ET]
Table '3269808612 1' 3-max Seat #2 is the button
Seat 1: jeje_sat (1260 in chips)
Seat 2: Kroma2021 (240 in chips)
Kroma2021: posts small blind 15
jeje_sat: posts big blind 30
*** HOLE CARDS ***
Dealt to jeje_sat [7c Kh Ah 8d]
Kroma2021: calls 15
jeje_sat: raises 60 to 90
Kroma2021: calls 60
*** FLOP *** [5d 5h 7s]
jeje_sat: bets 90
Kroma2021: calls 90
*** TURN *** [5d 5h 7s] [6h]
jeje_sat: bets 360
Kroma2021: calls 60 and is all-in
Uncalled bet (300) returned to jeje_sat
*** RIVER *** [5d 5h 7s 6h] [Td]
*** SHOW DOWN ***
jeje_sat: shows [7c Kh Ah 8d] (two pair, Sevens and Fives)
Kroma2021: shows [7h 6s 4s 9c] (two pair, Sevens and Sixes)
Kroma2021 collected 480 from pot
*** SUMMARY ***
Total pot 480 | Rake 0
Board [5d 5h 7s 6h Td]
Seat 1: jeje_sat (big blind) showed [7c Kh Ah 8d] and lost with two pair, Sevens and Fives
Seat 2: Kroma2021 (button) (small blind) showed [7h 6s 4s 9c] and won (480) with two pair, Sevens and Sixes


PokerStars Hand #230025663436: Tournament #3269808612, €0.93+€0.07 EUR Omaha Pot Limit - Level III (20/40) - 2021/09/21 17:14:29 CET [2021/09/21 11:14:29 ET]
Table '3269808612 1' 3-max Seat #1 is the button
Seat 1: jeje_sat (1020 in chips)
Seat 2: Kroma2021 (480 in chips)
jeje_sat: posts small blind 20
Kroma2021: posts big blind 40
*** HOLE CARDS ***
Dealt to jeje_sat [Th Jd 5c 5d]
jeje_sat: raises 80 to 120
Kroma2021: folds
Uncalled bet (80) returned to jeje_sat
jeje_sat collected 80 from pot
jeje_sat: doesn't show hand
*** SUMMARY ***
Total pot 80 | Rake 0
Seat 1: jeje_sat (button) (small blind) collected (80)
Seat 2: Kroma2021 (big blind) folded before Flop


PokerStars Hand #230025667901: Tournament #3269808612, €0.93+€0.07 EUR Omaha Pot Limit - Level III (20/40) - 2021/09/21 17:14:42 CET [2021/09/21 11:14:42 ET]
Table '3269808612 1' 3-max Seat #2 is the button
Seat 1: jeje_sat (1060 in chips)
Seat 2: Kroma2021 (440 in chips)
Kroma2021: posts small blind 20
jeje_sat: posts big blind 40
*** HOLE CARDS ***
Dealt to jeje_sat [8c 6s 4s 9c]
Kroma2021: folds
Uncalled bet (20) returned to jeje_sat
jeje_sat collected 40 from pot
jeje_sat: doesn't show hand
*** SUMMARY ***
Total pot 40 | Rake 0
Seat 1: jeje_sat (big blind) collected (40)
Seat 2: Kroma2021 (button) (small blind) folded before Flop


PokerStars Hand #230025671076: Tournament #3269808612, €0.93+€0.07 EUR Omaha Pot Limit - Level III (20/40) - 2021/09/21 17:14:51 CET [2021/09/21 11:14:51 ET]
Table '3269808612 1' 3-max Seat #1 is the button
Seat 1: jeje_sat (1080 in chips)
Seat 2: Kroma2021 (420 in chips)
jeje_sat: posts small blind 20
Kroma2021: posts big blind 40
*** HOLE CARDS ***
Dealt to jeje_sat [8h 2c 4h Ah]
jeje_sat: raises 80 to 120
Kroma2021: calls 80
*** FLOP *** [Qc Jd 3h]
Kroma2021: bets 240
jeje_sat: folds
Uncalled bet (240) returned to Kroma2021
Kroma2021 collected 240 from pot
Kroma2021: doesn't show hand
*** SUMMARY ***
Total pot 240 | Rake 0
Board [Qc Jd 3h]
Seat 1: jeje_sat (button) (small blind) folded on the Flop
Seat 2: Kroma2021 (big blind) collected (240)


PokerStars Hand #230025680287: Tournament #3269808612, €0.93+€0.07 EUR Omaha Pot Limit - Level III (20/40) - 2021/09/21 17:15:17 CET [2021/09/21 11:15:17 ET]
Table '3269808612 1' 3-max Seat #2 is the button
Seat 1: jeje_sat (960 in chips)
Seat 2: Kroma2021 (540 in chips)
Kroma2021: posts small blind 20
jeje_sat: posts big blind 40
*** HOLE CARDS ***
Dealt to jeje_sat [6d 7h 3c Qc]
Kroma2021: calls 20
jeje_sat: checks
*** FLOP *** [Qs 6c 6h]
jeje_sat: bets 80
Kroma2021: folds
Uncalled bet (80) returned to jeje_sat
jeje_sat collected 80 from pot
jeje_sat: doesn't show hand
*** SUMMARY ***
Total pot 80 | Rake 0
Board [Qs 6c 6h]
Seat 1: jeje_sat (big blind) collected (80)
Seat 2: Kroma2021 (button) (small blind) folded on the Flop


PokerStars Hand #230025689167: Tournament #3269808612, €0.93+€0.07 EUR Omaha Pot Limit - Level III (20/40) - 2021/09/21 17:15:43 CET [2021/09/21 11:15:43 ET]
Table '3269808612 1' 3-max Seat #1 is the button
Seat 1: jeje_sat (1000 in chips)
Seat 2: Kroma2021 (500 in chips)
jeje_sat: posts small blind 20
Kroma2021: posts big blind 40
*** HOLE CARDS ***
Dealt to jeje_sat [9s 8s Ac 4s]
jeje_sat: calls 20
Kroma2021: checks
*** FLOP *** [6h Kh 2h]
Kroma2021: checks
jeje_sat: checks
*** TURN *** [6h Kh 2h] [7c]
Kroma2021: checks
jeje_sat: checks
*** RIVER *** [6h Kh 2h 7c] [Qc]
Kroma2021: checks
jeje_sat: checks
*** SHOW DOWN ***
Kroma2021: shows [4h Ts 8d Jc] (high card King)
jeje_sat: shows [9s 8s Ac 4s] (high card Ace)
jeje_sat collected 80 from pot
*** SUMMARY ***
Total pot 80 | Rake 0
Board [6h Kh 2h 7c Qc]
Seat 1: jeje_sat (button) (small blind) showed [9s 8s Ac 4s] and won (80) with high card Ace
Seat 2: Kroma2021 (big blind) showed [4h Ts 8d Jc] and lost with high card King


PokerStars Hand #230025702520: Tournament #3269808612, €0.93+€0.07 EUR Omaha Pot Limit - Level III (20/40) - 2021/09/21 17:16:21 CET [2021/09/21 11:16:21 ET]
Table '3269808612 1' 3-max Seat #2 is the button
Seat 1: jeje_sat (1040 in chips)
Seat 2: Kroma2021 (460 in chips)
Kroma2021: posts small blind 20
jeje_sat: posts big blind 40
*** HOLE CARDS ***
Dealt to jeje_sat [2d 7c Kd Td]
Kroma2021: folds
Uncalled bet (20) returned to jeje_sat
jeje_sat collected 40 from pot
jeje_sat: doesn't show hand
*** SUMMARY ***
Total pot 40 | Rake 0
Seat 1: jeje_sat (big blind) collected (40)
Seat 2: Kroma2021 (button) (small blind) folded before Flop


PokerStars Hand #230025705453: Tournament #3269808612, €0.93+€0.07 EUR Omaha Pot Limit - Level III (20/40) - 2021/09/21 17:16:30 CET [2021/09/21 11:16:30 ET]
Table '3269808612 1' 3-max Seat #1 is the button
Seat 1: jeje_sat (1060 in chips)
Seat 2: Kroma2021 (440 in chips)
jeje_sat: posts small blind 20
Kroma2021: posts big blind 40
*** HOLE CARDS ***
Dealt to jeje_sat [Qd 2c Ts 8h]
jeje_sat: calls 20
Kroma2021: checks
*** FLOP *** [Qh 2s 9c]
Kroma2021: checks
jeje_sat: bets 80
Kroma2021: calls 80
*** TURN *** [Qh 2s 9c] [3d]
Kroma2021: checks
jeje_sat: bets 240
Kroma2021: raises 80 to 320 and is all-in
jeje_sat: calls 80
*** RIVER *** [Qh 2s 9c 3d] [4c]
*** SHOW DOWN ***
Kroma2021: shows [9d Qs 6d Jh] (two pair, Queens and Nines)
jeje_sat: shows [Qd 2c Ts 8h] (two pair, Queens and Deuces)
Kroma2021 collected 880 from pot
*** SUMMARY ***
Total pot 880 | Rake 0
Board [Qh 2s 9c 3d 4c]
Seat 1: jeje_sat (button) (small blind) showed [Qd 2c Ts 8h] and lost with two pair, Queens and Deuces
Seat 2: Kroma2021 (big blind) showed [9d Qs 6d Jh] and won (880) with two pair, Queens and Nines


PokerStars Hand #230025721302: Tournament #3269808612, €0.93+€0.07 EUR Omaha Pot Limit - Level IV (30/60) - 2021/09/21 17:17:15 CET [2021/09/21 11:17:15 ET]
Table '3269808612 1' 3-max Seat #2 is the button
Seat 1: jeje_sat (620 in chips)
Seat 2: Kroma2021 (880 in chips)
Kroma2021: posts small blind 30
jeje_sat: posts big blind 60
*** HOLE CARDS ***
Dealt to jeje_sat [7d Qd Jc 2s]
Kroma2021: folds
Uncalled bet (30) returned to jeje_sat
jeje_sat collected 60 from pot
jeje_sat: doesn't show hand
*** SUMMARY ***
Total pot 60 | Rake 0
Seat 1: jeje_sat (big blind) collected (60)
Seat 2: Kroma2021 (button) (small blind) folded before Flop


PokerStars Hand #230025725720: Tournament #3269808612, €0.93+€0.07 EUR Omaha Pot Limit - Level IV (30/60) - 2021/09/21 17:17:27 CET [2021/09/21 11:17:27 ET]
Table '3269808612 1' 3-max Seat #1 is the button
Seat 1: jeje_sat (650 in chips)
Seat 2: Kroma2021 (850 in chips)
jeje_sat: posts small blind 30
Kroma2021: posts big blind 60
*** HOLE CARDS ***
Dealt to jeje_sat [Ks Td Qh Qd]
jeje_sat: raises 120 to 180
Kroma2021: folds
Uncalled bet (120) returned to jeje_sat
jeje_sat collected 120 from pot
jeje_sat: doesn't show hand
*** SUMMARY ***
Total pot 120 | Rake 0
Seat 1: jeje_sat (button) (small blind) collected (120)
Seat 2: Kroma2021 (big blind) folded before Flop


PokerStars Hand #230025728650: Tournament #3269808612, €0.93+€0.07 EUR Omaha Pot Limit - Level IV (30/60) - 2021/09/21 17:17:36 CET [2021/09/21 11:17:36 ET]
Table '3269808612 1' 3-max Seat #2 is the button
Seat 1: jeje_sat (710 in chips)
Seat 2: Kroma2021 (790 in chips)
Kroma2021: posts small blind 30
jeje_sat: posts big blind 60
*** HOLE CARDS ***
Dealt to jeje_sat [2d 7d 2c 8s]
Kroma2021: calls 30
jeje_sat: checks
*** FLOP *** [Jd Ks 5c]
jeje_sat: checks
Kroma2021: checks
*** TURN *** [Jd Ks 5c] [5s]
jeje_sat: bets 60
Kroma2021: calls 60
*** RIVER *** [Jd Ks 5c 5s] [Ac]
jeje_sat: bets 120
Kroma2021: raises 480 to 600
jeje_sat: folds
Uncalled bet (480) returned to Kroma2021
Kroma2021 collected 480 from pot
Kroma2021: doesn't show hand
*** SUMMARY ***
Total pot 480 | Rake 0
Board [Jd Ks 5c 5s Ac]
Seat 1: jeje_sat (big blind) folded on the River
Seat 2: Kroma2021 (button) (small blind) collected (480)


PokerStars Hand #230025739124: Tournament #3269808612, €0.93+€0.07 EUR Omaha Pot Limit - Level IV (30/60) - 2021/09/21 17:18:05 CET [2021/09/21 11:18:05 ET]
Table '3269808612 1' 3-max Seat #1 is the button
Seat 1: jeje_sat (470 in chips)
Seat 2: Kroma2021 (1030 in chips)
jeje_sat: posts small blind 30
Kroma2021: posts big blind 60
*** HOLE CARDS ***
Dealt to jeje_sat [5h 6s 8d Tc]
jeje_sat: raises 120 to 180
Kroma2021: calls 120
*** FLOP *** [8h 6c 3h]
Kroma2021: checks
jeje_sat: bets 290 and is all-in
Kroma2021: calls 290
*** TURN *** [8h 6c 3h] [4s]
*** RIVER *** [8h 6c 3h 4s] [2d]
*** SHOW DOWN ***
Kroma2021: shows [As 5d Ad Ks] (a straight, Ace to Five)
jeje_sat: shows [5h 6s 8d Tc] (a straight, Deuce to Six)
jeje_sat collected 940 from pot
*** SUMMARY ***
Total pot 940 | Rake 0
Board [8h 6c 3h 4s 2d]
Seat 1: jeje_sat (button) (small blind) showed [5h 6s 8d Tc] and won (940) with a straight, Deuce to Six
Seat 2: Kroma2021 (big blind) showed [As 5d Ad Ks] and lost with a straight, Ace to Five


PokerStars Hand #230025750636: Tournament #3269808612, €0.93+€0.07 EUR Omaha Pot Limit - Level IV (30/60) - 2021/09/21 17:18:38 CET [2021/09/21 11:18:38 ET]
Table '3269808612 1' 3-max Seat #2 is the button
Seat 1: jeje_sat (940 in chips)
Seat 2: Kroma2021 (560 in chips)
Kroma2021: posts small blind 30
jeje_sat: posts big blind 60
*** HOLE CARDS ***
Dealt to jeje_sat [4d Jd Qd Kc]
Kroma2021: calls 30
jeje_sat: raises 120 to 180
Kroma2021: calls 120
*** FLOP *** [6h Td 8c]
jeje_sat: bets 360
Kroma2021: folds
Uncalled bet (360) returned to jeje_sat
jeje_sat collected 360 from pot
jeje_sat: doesn't show hand
*** SUMMARY ***
Total pot 360 | Rake 0
Board [6h Td 8c]
Seat 1: jeje_sat (big blind) collected (360)
Seat 2: Kroma2021 (button) (small blind) folded on the Flop


PokerStars Hand #230025760927: Tournament #3269808612, €0.93+€0.07 EUR Omaha Pot Limit - Level IV (30/60) - 2021/09/21 17:19:07 CET [2021/09/21 11:19:07 ET]
Table '3269808612 1' 3-max Seat #1 is the button
Seat 1: jeje_sat (1120 in chips)
Seat 2: Kroma2021 (380 in chips)
jeje_sat: posts small blind 30
Kroma2021: posts big blind 60
*** HOLE CARDS ***
Dealt to jeje_sat [Ad 8c Qh Qs]
jeje_sat: raises 120 to 180
Kroma2021: calls 120
*** FLOP *** [8s Th Qd]
Kroma2021: checks
jeje_sat: bets 360
Kroma2021: calls 200 and is all-in
Uncalled bet (160) returned to jeje_sat
*** TURN *** [8s Th Qd] [Js]
*** RIVER *** [8s Th Qd Js] [5d]
*** SHOW DOWN ***
Kroma2021: shows [6c 9s 9c 9h] (a pair of Nines)
jeje_sat: shows [Ad 8c Qh Qs] (three of a kind, Queens)
jeje_sat collected 760 from pot
*** SUMMARY ***
Total pot 760 | Rake 0
Board [8s Th Qd Js 5d]
Seat 1: jeje_sat (button) (small blind) showed [Ad 8c Qh Qs] and won (760) with three of a kind, Queens
Seat 2: Kroma2021 (big blind) showed [6c 9s 9c 9h] and lost with a pair of Nines


