PokerStars Hand #229773984722: Tournament #3264233502, €0.93+€0.07 EUR Omaha Pot Limit - Level I (10/20) - 2021/09/11 21:59:40 CET [2021/09/11 15:59:40 ET]
Table '3264233502 1' 3-max Seat #1 is the button
Seat 1: jeje_sat (500 in chips)
Seat 2: Badabamax (500 in chips)
Seat 3: Antoine69ant (500 in chips)
Badabamax: posts small blind 10
Antoine69ant: posts big blind 20
*** HOLE CARDS ***
Dealt to jeje_sat [5d 2h 7c Kh]
jeje_sat: folds
Badabamax: calls 10
Antoine69ant: checks
*** FLOP *** [4h 5h 2s]
Badabamax: checks
Antoine69ant: checks
*** TURN *** [4h 5h 2s] [8s]
Badabamax: checks
Antoine69ant: bets 20
Badabamax: calls 20
*** RIVER *** [4h 5h 2s 8s] [6h]
Badabamax: checks
Antoine69ant: checks
*** SHOW DOWN ***
Badabamax: shows [Ts Js 4c 2d] (two pair, Fours and Deuces)
Antoine69ant: mucks hand
Badabamax collected 80 from pot
*** SUMMARY ***
Total pot 80 | Rake 0
Board [4h 5h 2s 8s 6h]
Seat 1: jeje_sat (button) folded before Flop (didn't bet)
Seat 2: Badabamax (small blind) showed [Ts Js 4c 2d] and won (80) with two pair, Fours and Deuces
Seat 3: Antoine69ant (big blind) mucked [As 4s Qh Ks]


PokerStars Hand #229773992131: Tournament #3264233502, €0.93+€0.07 EUR Omaha Pot Limit - Level I (10/20) - 2021/09/11 22:00:02 CET [2021/09/11 16:00:02 ET]
Table '3264233502 1' 3-max Seat #2 is the button
Seat 1: jeje_sat (500 in chips)
Seat 2: Badabamax (540 in chips)
Seat 3: Antoine69ant (460 in chips)
Antoine69ant: posts small blind 10
jeje_sat: posts big blind 20
*** HOLE CARDS ***
Dealt to jeje_sat [Qh 2h 8d Ac]
Badabamax: calls 20
Antoine69ant: calls 10
jeje_sat: checks
*** FLOP *** [Jh 3d 3h]
Antoine69ant: checks
jeje_sat: checks
Badabamax: checks
*** TURN *** [Jh 3d 3h] [4d]
Antoine69ant: checks
jeje_sat: checks
Badabamax: checks
*** RIVER *** [Jh 3d 3h 4d] [Ts]
Antoine69ant: checks
jeje_sat: checks
Badabamax: checks
*** SHOW DOWN ***
Antoine69ant: shows [6h As 9c 9s] (two pair, Nines and Threes)
jeje_sat: mucks hand
Badabamax: shows [8s Jd Kh 7d] (two pair, Jacks and Threes)
Badabamax collected 60 from pot
*** SUMMARY ***
Total pot 60 | Rake 0
Board [Jh 3d 3h 4d Ts]
Seat 1: jeje_sat (big blind) mucked [Qh 2h 8d Ac]
Seat 2: Badabamax (button) showed [8s Jd Kh 7d] and won (60) with two pair, Jacks and Threes
Seat 3: Antoine69ant (small blind) showed [6h As 9c 9s] and lost with two pair, Nines and Threes


PokerStars Hand #229774003664: Tournament #3264233502, €0.93+€0.07 EUR Omaha Pot Limit - Level I (10/20) - 2021/09/11 22:00:35 CET [2021/09/11 16:00:35 ET]
Table '3264233502 1' 3-max Seat #3 is the button
Seat 1: jeje_sat (480 in chips)
Seat 2: Badabamax (580 in chips)
Seat 3: Antoine69ant (440 in chips)
jeje_sat: posts small blind 10
Badabamax: posts big blind 20
*** HOLE CARDS ***
Dealt to jeje_sat [Qc 4s 4c Jd]
Antoine69ant: calls 20
jeje_sat: folds
Badabamax: checks
*** FLOP *** [6c 7c 9s]
Badabamax: checks
Antoine69ant: checks
*** TURN *** [6c 7c 9s] [Js]
Badabamax: checks
Antoine69ant: bets 25
Badabamax: calls 25
*** RIVER *** [6c 7c 9s Js] [8h]
Badabamax: checks
Antoine69ant: bets 100
Badabamax: folds
Uncalled bet (100) returned to Antoine69ant
Antoine69ant collected 100 from pot
Antoine69ant: doesn't show hand
*** SUMMARY ***
Total pot 100 | Rake 0
Board [6c 7c 9s Js 8h]
Seat 1: jeje_sat (small blind) folded before Flop
Seat 2: Badabamax (big blind) folded on the River
Seat 3: Antoine69ant (button) collected (100)


PokerStars Hand #229774018875: Tournament #3264233502, €0.93+€0.07 EUR Omaha Pot Limit - Level I (10/20) - 2021/09/11 22:01:15 CET [2021/09/11 16:01:15 ET]
Table '3264233502 1' 3-max Seat #1 is the button
Seat 1: jeje_sat (470 in chips)
Seat 2: Badabamax (535 in chips)
Seat 3: Antoine69ant (495 in chips)
Badabamax: posts small blind 10
Antoine69ant: posts big blind 20
*** HOLE CARDS ***
Dealt to jeje_sat [7s 8d 3h 6d]
jeje_sat: folds
Badabamax: calls 10
Antoine69ant: checks
*** FLOP *** [Ac 2c 3d]
Badabamax: checks
Antoine69ant: checks
*** TURN *** [Ac 2c 3d] [As]
Badabamax: checks
Antoine69ant: checks
*** RIVER *** [Ac 2c 3d As] [Kd]
Badabamax: checks
Antoine69ant: checks
*** SHOW DOWN ***
Badabamax: shows [Kc Js 4s Qc] (two pair, Aces and Kings)
Antoine69ant: mucks hand
Badabamax collected 40 from pot
*** SUMMARY ***
Total pot 40 | Rake 0
Board [Ac 2c 3d As Kd]
Seat 1: jeje_sat (button) folded before Flop (didn't bet)
Seat 2: Badabamax (small blind) showed [Kc Js 4s Qc] and won (40) with two pair, Aces and Kings
Seat 3: Antoine69ant (big blind) mucked [8c Jd 4h 9h]


PokerStars Hand #229774029068: Tournament #3264233502, €0.93+€0.07 EUR Omaha Pot Limit - Level I (10/20) - 2021/09/11 22:01:40 CET [2021/09/11 16:01:40 ET]
Table '3264233502 1' 3-max Seat #2 is the button
Seat 1: jeje_sat (470 in chips)
Seat 2: Badabamax (555 in chips)
Seat 3: Antoine69ant (475 in chips)
Antoine69ant: posts small blind 10
jeje_sat: posts big blind 20
*** HOLE CARDS ***
Dealt to jeje_sat [7c Kd 7s Qs]
Badabamax: folds
Antoine69ant: calls 10
jeje_sat: checks
*** FLOP *** [Jd Th 3c]
Antoine69ant: checks
jeje_sat: bets 40
Antoine69ant: folds
Uncalled bet (40) returned to jeje_sat
jeje_sat collected 40 from pot
jeje_sat: doesn't show hand
*** SUMMARY ***
Total pot 40 | Rake 0
Board [Jd Th 3c]
Seat 1: jeje_sat (big blind) collected (40)
Seat 2: Badabamax (button) folded before Flop (didn't bet)
Seat 3: Antoine69ant (small blind) folded on the Flop


PokerStars Hand #229774035204: Tournament #3264233502, €0.93+€0.07 EUR Omaha Pot Limit - Level I (10/20) - 2021/09/11 22:01:54 CET [2021/09/11 16:01:54 ET]
Table '3264233502 1' 3-max Seat #3 is the button
Seat 1: jeje_sat (490 in chips)
Seat 2: Badabamax (555 in chips)
Seat 3: Antoine69ant (455 in chips)
jeje_sat: posts small blind 10
Badabamax: posts big blind 20
*** HOLE CARDS ***
Dealt to jeje_sat [Jh 4h 2c Kd]
Antoine69ant: calls 20
jeje_sat: folds
Badabamax: checks
*** FLOP *** [Qs 6s Qh]
Badabamax: checks
Antoine69ant: bets 20
Badabamax: folds
Uncalled bet (20) returned to Antoine69ant
Antoine69ant collected 50 from pot
Antoine69ant: doesn't show hand
*** SUMMARY ***
Total pot 50 | Rake 0
Board [Qs 6s Qh]
Seat 1: jeje_sat (small blind) folded before Flop
Seat 2: Badabamax (big blind) folded on the Flop
Seat 3: Antoine69ant (button) collected (50)


PokerStars Hand #229774045986: Tournament #3264233502, €0.93+€0.07 EUR Omaha Pot Limit - Level I (10/20) - 2021/09/11 22:02:14 CET [2021/09/11 16:02:14 ET]
Table '3264233502 1' 3-max Seat #1 is the button
Seat 1: jeje_sat (480 in chips)
Seat 2: Badabamax (535 in chips)
Seat 3: Antoine69ant (485 in chips)
Badabamax: posts small blind 10
Antoine69ant: posts big blind 20
*** HOLE CARDS ***
Dealt to jeje_sat [Ks 7s 7h 5d]
jeje_sat: folds
Badabamax: raises 40 to 60
Antoine69ant: calls 40
*** FLOP *** [Td 5h 4h]
Badabamax: checks
Antoine69ant: bets 40
Badabamax: calls 40
*** TURN *** [Td 5h 4h] [2h]
Badabamax: bets 200
Antoine69ant: raises 185 to 385 and is all-in
Badabamax: calls 185
*** RIVER *** [Td 5h 4h 2h] [9s]
*** SHOW DOWN ***
Badabamax: shows [Kd Jc 3c As] (a straight, Ace to Five)
Antoine69ant: shows [Jd 7c 5c 5s] (three of a kind, Fives)
Badabamax collected 970 from pot
Antoine69ant finished the tournament in 3rd place
*** SUMMARY ***
Total pot 970 | Rake 0
Board [Td 5h 4h 2h 9s]
Seat 1: jeje_sat (button) folded before Flop (didn't bet)
Seat 2: Badabamax (small blind) showed [Kd Jc 3c As] and won (970) with a straight, Ace to Five
Seat 3: Antoine69ant (big blind) showed [Jd 7c 5c 5s] and lost with three of a kind, Fives


PokerStars Hand #229774060224: Tournament #3264233502, €0.93+€0.07 EUR Omaha Pot Limit - Level I (10/20) - 2021/09/11 22:02:43 CET [2021/09/11 16:02:43 ET]
Table '3264233502 1' 3-max Seat #2 is the button
Seat 1: jeje_sat (480 in chips)
Seat 2: Badabamax (1020 in chips)
Badabamax: posts small blind 10
jeje_sat: posts big blind 20
*** HOLE CARDS ***
Dealt to jeje_sat [8h Td Js Ah]
Badabamax: calls 10
jeje_sat: raises 40 to 60
Badabamax: calls 40
*** FLOP *** [8c Ac Kh]
jeje_sat: bets 120
Badabamax: raises 120 to 240
jeje_sat: raises 180 to 420 and is all-in
Badabamax: calls 180
*** TURN *** [8c Ac Kh] [4h]
*** RIVER *** [8c Ac Kh 4h] [7d]
*** SHOW DOWN ***
jeje_sat: shows [8h Td Js Ah] (two pair, Aces and Eights)
Badabamax: shows [Tc Jc As 9c] (a pair of Aces)
jeje_sat collected 960 from pot
*** SUMMARY ***
Total pot 960 | Rake 0
Board [8c Ac Kh 4h 7d]
Seat 1: jeje_sat (big blind) showed [8h Td Js Ah] and won (960) with two pair, Aces and Eights
Seat 2: Badabamax (button) (small blind) showed [Tc Jc As 9c] and lost with a pair of Aces


PokerStars Hand #229774074111: Tournament #3264233502, €0.93+€0.07 EUR Omaha Pot Limit - Level II (15/30) - 2021/09/11 22:03:11 CET [2021/09/11 16:03:11 ET]
Table '3264233502 1' 3-max Seat #1 is the button
Seat 1: jeje_sat (960 in chips)
Seat 2: Badabamax (540 in chips)
jeje_sat: posts small blind 15
Badabamax: posts big blind 30
*** HOLE CARDS ***
Dealt to jeje_sat [Th 9d 6d Jc]
jeje_sat: calls 15
Badabamax: raises 60 to 90
jeje_sat: calls 60
*** FLOP *** [9c Qd 6c]
Badabamax: checks
jeje_sat: bets 90
Badabamax: calls 90
*** TURN *** [9c Qd 6c] [Ks]
Badabamax: bets 360 and is all-in
jeje_sat: calls 360
*** RIVER *** [9c Qd 6c Ks] [7h]
*** SHOW DOWN ***
Badabamax: shows [Ts Kd 6h 5h] (two pair, Kings and Sixes)
jeje_sat: shows [Th 9d 6d Jc] (a straight, Nine to King)
jeje_sat collected 1080 from pot
*** SUMMARY ***
Total pot 1080 | Rake 0
Board [9c Qd 6c Ks 7h]
Seat 1: jeje_sat (button) (small blind) showed [Th 9d 6d Jc] and won (1080) with a straight, Nine to King
Seat 2: Badabamax (big blind) showed [Ts Kd 6h 5h] and lost with two pair, Kings and Sixes


