PokerStars Hand #229773178616: Tournament #3264215195, €0.93+€0.07 EUR Omaha Pot Limit - Level I (10/20) - 2021/09/11 21:32:53 CET [2021/09/11 15:32:53 ET]
Table '3264215195 1' 3-max Seat #1 is the button
Seat 1: Badabamax (500 in chips)
Seat 2: jeje_sat (500 in chips)
Seat 3: JaqueHghar (500 in chips)
jeje_sat: posts small blind 10
JaqueHghar: posts big blind 20
*** HOLE CARDS ***
Dealt to jeje_sat [Qs 3h Th Ts]
Badabamax: folds
jeje_sat: calls 10
JaqueHghar: checks
*** FLOP *** [6h 9c 7c]
jeje_sat: checks
JaqueHghar: bets 20
jeje_sat: folds
Uncalled bet (20) returned to JaqueHghar
JaqueHghar collected 40 from pot
JaqueHghar: doesn't show hand
*** SUMMARY ***
Total pot 40 | Rake 0
Board [6h 9c 7c]
Seat 1: Badabamax (button) folded before Flop (didn't bet)
Seat 2: jeje_sat (small blind) folded on the Flop
Seat 3: JaqueHghar (big blind) collected (40)


PokerStars Hand #229773202809: Tournament #3264215195, €0.93+€0.07 EUR Omaha Pot Limit - Level I (10/20) - 2021/09/11 21:33:38 CET [2021/09/11 15:33:38 ET]
Table '3264215195 1' 3-max Seat #2 is the button
Seat 1: Badabamax (500 in chips)
Seat 2: jeje_sat (480 in chips)
Seat 3: JaqueHghar (520 in chips)
JaqueHghar: posts small blind 10
Badabamax: posts big blind 20
*** HOLE CARDS ***
Dealt to jeje_sat [5h 4s Qs 2c]
jeje_sat: folds
JaqueHghar: calls 10
Badabamax: checks
*** FLOP *** [6s As Js]
JaqueHghar: checks
Badabamax: bets 20
JaqueHghar: calls 20
*** TURN *** [6s As Js] [2d]
JaqueHghar: checks
Badabamax: bets 20
JaqueHghar: calls 20
*** RIVER *** [6s As Js 2d] [Td]
JaqueHghar: checks
Badabamax: checks
*** SHOW DOWN ***
JaqueHghar: shows [Ac Qh 5s 6d] (two pair, Aces and Sixes)
Badabamax: mucks hand
JaqueHghar collected 120 from pot
*** SUMMARY ***
Total pot 120 | Rake 0
Board [6s As Js 2d Td]
Seat 1: Badabamax (big blind) mucked [7h Ad 3h Ks]
Seat 2: jeje_sat (button) folded before Flop (didn't bet)
Seat 3: JaqueHghar (small blind) showed [Ac Qh 5s 6d] and won (120) with two pair, Aces and Sixes


PokerStars Hand #229773221482: Tournament #3264215195, €0.93+€0.07 EUR Omaha Pot Limit - Level I (10/20) - 2021/09/11 21:34:12 CET [2021/09/11 15:34:12 ET]
Table '3264215195 1' 3-max Seat #3 is the button
Seat 1: Badabamax (440 in chips)
Seat 2: jeje_sat (480 in chips)
Seat 3: JaqueHghar (580 in chips)
Badabamax: posts small blind 10
jeje_sat: posts big blind 20
*** HOLE CARDS ***
Dealt to jeje_sat [7h Tc Jc 2s]
JaqueHghar: calls 20
Badabamax: calls 10
jeje_sat: checks
*** FLOP *** [7c 5d Td]
Badabamax: bets 60
jeje_sat: raises 180 to 240
JaqueHghar: folds
Badabamax: raises 180 to 420 and is all-in
jeje_sat: calls 180
*** TURN *** [7c 5d Td] [Ah]
*** RIVER *** [7c 5d Td Ah] [5s]
*** SHOW DOWN ***
Badabamax: shows [Th 7d Js 4h] (two pair, Tens and Sevens)
jeje_sat: shows [7h Tc Jc 2s] (two pair, Tens and Sevens)
Badabamax collected 450 from pot
jeje_sat collected 450 from pot
*** SUMMARY ***
Total pot 900 | Rake 0
Board [7c 5d Td Ah 5s]
Seat 1: Badabamax (small blind) showed [Th 7d Js 4h] and won (450) with two pair, Tens and Sevens
Seat 2: jeje_sat (big blind) showed [7h Tc Jc 2s] and won (450) with two pair, Tens and Sevens
Seat 3: JaqueHghar (button) folded on the Flop


PokerStars Hand #229773242789: Tournament #3264215195, €0.93+€0.07 EUR Omaha Pot Limit - Level I (10/20) - 2021/09/11 21:34:50 CET [2021/09/11 15:34:50 ET]
Table '3264215195 1' 3-max Seat #1 is the button
Seat 1: Badabamax (450 in chips)
Seat 2: jeje_sat (490 in chips)
Seat 3: JaqueHghar (560 in chips)
jeje_sat: posts small blind 10
JaqueHghar: posts big blind 20
*** HOLE CARDS ***
Dealt to jeje_sat [Kc 8h 5h Ac]
Badabamax: calls 20
jeje_sat: calls 10
JaqueHghar: checks
*** FLOP *** [5s 2d 2s]
jeje_sat: checks
JaqueHghar: checks
Badabamax: bets 20
jeje_sat: folds
JaqueHghar: folds
Uncalled bet (20) returned to Badabamax
Badabamax collected 60 from pot
Badabamax: doesn't show hand
*** SUMMARY ***
Total pot 60 | Rake 0
Board [5s 2d 2s]
Seat 1: Badabamax (button) collected (60)
Seat 2: jeje_sat (small blind) folded on the Flop
Seat 3: JaqueHghar (big blind) folded on the Flop


PokerStars Hand #229773257914: Tournament #3264215195, €0.93+€0.07 EUR Omaha Pot Limit - Level I (10/20) - 2021/09/11 21:35:18 CET [2021/09/11 15:35:18 ET]
Table '3264215195 1' 3-max Seat #2 is the button
Seat 1: Badabamax (490 in chips)
Seat 2: jeje_sat (470 in chips)
Seat 3: JaqueHghar (540 in chips)
JaqueHghar: posts small blind 10
Badabamax: posts big blind 20
*** HOLE CARDS ***
Dealt to jeje_sat [9h 8d 6d 2s]
jeje_sat: folds
JaqueHghar: raises 20 to 40
Badabamax: raises 80 to 120
JaqueHghar: calls 80
*** FLOP *** [Jd Tc Js]
JaqueHghar: checks
Badabamax: bets 240
JaqueHghar: folds
Uncalled bet (240) returned to Badabamax
Badabamax collected 240 from pot
Badabamax: doesn't show hand
*** SUMMARY ***
Total pot 240 | Rake 0
Board [Jd Tc Js]
Seat 1: Badabamax (big blind) collected (240)
Seat 2: jeje_sat (button) folded before Flop (didn't bet)
Seat 3: JaqueHghar (small blind) folded on the Flop


PokerStars Hand #229773271609: Tournament #3264215195, €0.93+€0.07 EUR Omaha Pot Limit - Level I (10/20) - 2021/09/11 21:35:43 CET [2021/09/11 15:35:43 ET]
Table '3264215195 1' 3-max Seat #3 is the button
Seat 1: Badabamax (610 in chips)
Seat 2: jeje_sat (470 in chips)
Seat 3: JaqueHghar (420 in chips)
Badabamax: posts small blind 10
jeje_sat: posts big blind 20
*** HOLE CARDS ***
Dealt to jeje_sat [3d Js 9h 6c]
JaqueHghar: folds
Badabamax: calls 10
jeje_sat: checks
*** FLOP *** [3h 9d Ac]
Badabamax: checks
jeje_sat: bets 20
Badabamax: calls 20
*** TURN *** [3h 9d Ac] [8h]
Badabamax: checks
jeje_sat: bets 20
Badabamax: calls 20
*** RIVER *** [3h 9d Ac 8h] [3s]
Badabamax: checks
jeje_sat: bets 120
Badabamax: calls 120
*** SHOW DOWN ***
jeje_sat: shows [3d Js 9h 6c] (a full house, Threes full of Nines)
Badabamax: mucks hand
jeje_sat collected 360 from pot
*** SUMMARY ***
Total pot 360 | Rake 0
Board [3h 9d Ac 8h 3s]
Seat 1: Badabamax (small blind) mucked [Ad Jh Jc Qh]
Seat 2: jeje_sat (big blind) showed [3d Js 9h 6c] and won (360) with a full house, Threes full of Nines
Seat 3: JaqueHghar (button) folded before Flop (didn't bet)


PokerStars Hand #229773289019: Tournament #3264215195, €0.93+€0.07 EUR Omaha Pot Limit - Level II (15/30) - 2021/09/11 21:36:16 CET [2021/09/11 15:36:16 ET]
Table '3264215195 1' 3-max Seat #1 is the button
Seat 1: Badabamax (430 in chips)
Seat 2: jeje_sat (650 in chips)
Seat 3: JaqueHghar (420 in chips)
jeje_sat: posts small blind 15
JaqueHghar: posts big blind 30
*** HOLE CARDS ***
Dealt to jeje_sat [7c 4h 5d 6h]
Badabamax: raises 30 to 60
jeje_sat: calls 45
JaqueHghar: calls 30
*** FLOP *** [Kd Kc 2s]
jeje_sat: checks
JaqueHghar: checks
Badabamax: checks
*** TURN *** [Kd Kc 2s] [4d]
jeje_sat: checks
JaqueHghar: checks
Badabamax: bets 30
jeje_sat: folds
JaqueHghar: folds
Uncalled bet (30) returned to Badabamax
Badabamax collected 180 from pot
Badabamax: doesn't show hand
*** SUMMARY ***
Total pot 180 | Rake 0
Board [Kd Kc 2s 4d]
Seat 1: Badabamax (button) collected (180)
Seat 2: jeje_sat (small blind) folded on the Turn
Seat 3: JaqueHghar (big blind) folded on the Turn


PokerStars Hand #229773304131: Tournament #3264215195, €0.93+€0.07 EUR Omaha Pot Limit - Level II (15/30) - 2021/09/11 21:36:43 CET [2021/09/11 15:36:43 ET]
Table '3264215195 1' 3-max Seat #2 is the button
Seat 1: Badabamax (550 in chips)
Seat 2: jeje_sat (590 in chips)
Seat 3: JaqueHghar (360 in chips)
JaqueHghar: posts small blind 15
Badabamax: posts big blind 30
*** HOLE CARDS ***
Dealt to jeje_sat [Qc 8c Ks Js]
jeje_sat: raises 75 to 105
JaqueHghar: calls 90
Badabamax: folds
*** FLOP *** [6h 5s 2h]
JaqueHghar: checks
jeje_sat: checks
*** TURN *** [6h 5s 2h] [2s]
JaqueHghar: checks
jeje_sat: bets 120
JaqueHghar: calls 120
*** RIVER *** [6h 5s 2h 2s] [Td]
JaqueHghar: bets 135 and is all-in
jeje_sat: folds
Uncalled bet (135) returned to JaqueHghar
JaqueHghar collected 480 from pot
JaqueHghar: doesn't show hand
*** SUMMARY ***
Total pot 480 | Rake 0
Board [6h 5s 2h 2s Td]
Seat 1: Badabamax (big blind) folded before Flop
Seat 2: jeje_sat (button) folded on the River
Seat 3: JaqueHghar (small blind) collected (480)


PokerStars Hand #229773324876: Tournament #3264215195, €0.93+€0.07 EUR Omaha Pot Limit - Level II (15/30) - 2021/09/11 21:37:21 CET [2021/09/11 15:37:21 ET]
Table '3264215195 1' 3-max Seat #3 is the button
Seat 1: Badabamax (520 in chips)
Seat 2: jeje_sat (365 in chips)
Seat 3: JaqueHghar (615 in chips)
Badabamax: posts small blind 15
jeje_sat: posts big blind 30
*** HOLE CARDS ***
Dealt to jeje_sat [4h Kc 7h Tc]
JaqueHghar: folds
Badabamax: calls 15
jeje_sat: checks
*** FLOP *** [Qh 2s Th]
Badabamax: checks
jeje_sat: checks
*** TURN *** [Qh 2s Th] [6h]
Badabamax: checks
jeje_sat: bets 30
Badabamax: folds
Uncalled bet (30) returned to jeje_sat
jeje_sat collected 60 from pot
jeje_sat: doesn't show hand
*** SUMMARY ***
Total pot 60 | Rake 0
Board [Qh 2s Th 6h]
Seat 1: Badabamax (small blind) folded on the Turn
Seat 2: jeje_sat (big blind) collected (60)
Seat 3: JaqueHghar (button) folded before Flop (didn't bet)


PokerStars Hand #229773338082: Tournament #3264215195, €0.93+€0.07 EUR Omaha Pot Limit - Level II (15/30) - 2021/09/11 21:37:46 CET [2021/09/11 15:37:46 ET]
Table '3264215195 1' 3-max Seat #1 is the button
Seat 1: Badabamax (490 in chips)
Seat 2: jeje_sat (395 in chips)
Seat 3: JaqueHghar (615 in chips)
jeje_sat: posts small blind 15
JaqueHghar: posts big blind 30
*** HOLE CARDS ***
Dealt to jeje_sat [Qs 8c 7h 7c]
Badabamax: calls 30
jeje_sat: calls 15
JaqueHghar: checks
*** FLOP *** [5c Kh 7d]
jeje_sat: bets 90
JaqueHghar: calls 90
Badabamax: folds
*** TURN *** [5c Kh 7d] [9s]
jeje_sat: bets 270
JaqueHghar: calls 270
*** RIVER *** [5c Kh 7d 9s] [Th]
jeje_sat: bets 5 and is all-in
JaqueHghar: calls 5
*** SHOW DOWN ***
jeje_sat: shows [Qs 8c 7h 7c] (three of a kind, Sevens)
JaqueHghar: shows [Ts 8s Ks 6c] (a straight, Six to Ten)
JaqueHghar collected 820 from pot
*** SUMMARY ***
Total pot 820 | Rake 0
Board [5c Kh 7d 9s Th]
Seat 1: Badabamax (button) folded on the Flop
Seat 2: jeje_sat (small blind) showed [Qs 8c 7h 7c] and lost with three of a kind, Sevens
Seat 3: JaqueHghar (big blind) showed [Ts 8s Ks 6c] and won (820) with a straight, Six to Ten


