PokerStars Hand #229721806305: Tournament #3263055222, €0.23+€0.02 EUR Omaha Pot Limit - Level I (10/20) - 2021/09/09 22:04:06 CET [2021/09/09 16:04:06 ET]
Table '3263055222 1' 3-max Seat #1 is the button
Seat 1: Kalif97 (500 in chips)
Seat 2: jeje_sat (500 in chips)
Seat 3: danye tukuma (500 in chips)
jeje_sat: posts small blind 10
danye tukuma: posts big blind 20
*** HOLE CARDS ***
Dealt to jeje_sat [As Ac 3d 2c]
Kalif97: raises 50 to 70
jeje_sat: raises 160 to 230
danye tukuma: folds
Kalif97: calls 160
*** FLOP *** [Qd Jd Kh]
jeje_sat: checks
Kalif97: checks
*** TURN *** [Qd Jd Kh] [8s]
jeje_sat: checks
Kalif97: checks
*** RIVER *** [Qd Jd Kh 8s] [Ad]
jeje_sat: checks
Kalif97: checks
*** SHOW DOWN ***
jeje_sat: shows [As Ac 3d 2c] (three of a kind, Aces)
Kalif97: mucks hand
jeje_sat collected 480 from pot
*** SUMMARY ***
Total pot 480 | Rake 0
Board [Qd Jd Kh 8s Ad]
Seat 1: Kalif97 (button) mucked [4d 4h Jh 7h]
Seat 2: jeje_sat (small blind) showed [As Ac 3d 2c] and won (480) with three of a kind, Aces
Seat 3: danye tukuma (big blind) folded before Flop


PokerStars Hand #229721830449: Tournament #3263055222, €0.23+€0.02 EUR Omaha Pot Limit - Level I (10/20) - 2021/09/09 22:04:52 CET [2021/09/09 16:04:52 ET]
Table '3263055222 1' 3-max Seat #2 is the button
Seat 1: Kalif97 (270 in chips)
Seat 2: jeje_sat (750 in chips)
Seat 3: danye tukuma (480 in chips)
danye tukuma: posts small blind 10
Kalif97: posts big blind 20
*** HOLE CARDS ***
Dealt to jeje_sat [Ts Ah 2d 4h]
jeje_sat: calls 20
danye tukuma: calls 10
Kalif97: raises 60 to 80
jeje_sat: calls 60
danye tukuma: calls 60
*** FLOP *** [7s 8c Qh]
danye tukuma: checks
Kalif97: checks
jeje_sat: checks
*** TURN *** [7s 8c Qh] [Th]
danye tukuma: checks
Kalif97: checks
jeje_sat: checks
*** RIVER *** [7s 8c Qh Th] [5d]
danye tukuma: bets 40
Kalif97: folds
jeje_sat: calls 40
*** SHOW DOWN ***
danye tukuma: shows [4d Js 6h Qc] (a straight, Four to Eight)
jeje_sat: mucks hand
danye tukuma collected 320 from pot
*** SUMMARY ***
Total pot 320 | Rake 0
Board [7s 8c Qh Th 5d]
Seat 1: Kalif97 (big blind) folded on the River
Seat 2: jeje_sat (button) mucked [Ts Ah 2d 4h]
Seat 3: danye tukuma (small blind) showed [4d Js 6h Qc] and won (320) with a straight, Four to Eight


PokerStars Hand #229721880460: Tournament #3263055222, €0.23+€0.02 EUR Omaha Pot Limit - Level I (10/20) - 2021/09/09 22:06:25 CET [2021/09/09 16:06:25 ET]
Table '3263055222 1' 3-max Seat #3 is the button
Seat 1: Kalif97 (190 in chips)
Seat 2: jeje_sat (630 in chips)
Seat 3: danye tukuma (680 in chips)
Kalif97: posts small blind 10
jeje_sat: posts big blind 20
*** HOLE CARDS ***
Dealt to jeje_sat [2d Ah 6s 3s]
danye tukuma: raises 40 to 60
Kalif97: raises 130 to 190 and is all-in
jeje_sat: folds
danye tukuma is disconnected
danye tukuma is connected
danye tukuma: calls 130
*** FLOP *** [2s 8h 6h]
*** TURN *** [2s 8h 6h] [5c]
*** RIVER *** [2s 8h 6h 5c] [7d]
*** SHOW DOWN ***
Kalif97: shows [9c Jh 5h Jc] (a straight, Five to Nine)
danye tukuma: shows [Qc 7c 7s Ad] (three of a kind, Sevens)
Kalif97 collected 400 from pot
*** SUMMARY ***
Total pot 400 | Rake 0
Board [2s 8h 6h 5c 7d]
Seat 1: Kalif97 (small blind) showed [9c Jh 5h Jc] and won (400) with a straight, Five to Nine
Seat 2: jeje_sat (big blind) folded before Flop
Seat 3: danye tukuma (button) showed [Qc 7c 7s Ad] and lost with three of a kind, Sevens


PokerStars Hand #229721901915: Tournament #3263055222, €0.23+€0.02 EUR Omaha Pot Limit - Level I (10/20) - 2021/09/09 22:07:05 CET [2021/09/09 16:07:05 ET]
Table '3263055222 1' 3-max Seat #1 is the button
Seat 1: Kalif97 (400 in chips)
Seat 2: jeje_sat (610 in chips)
Seat 3: danye tukuma (490 in chips)
jeje_sat: posts small blind 10
danye tukuma: posts big blind 20
*** HOLE CARDS ***
Dealt to jeje_sat [3h Ts Qs Js]
Kalif97 has timed out
Kalif97: folds
Kalif97 is sitting out
Kalif97 has returned
jeje_sat: raises 40 to 60
danye tukuma: calls 40
*** FLOP *** [4d Jd 5d]
jeje_sat: checks
danye tukuma: bets 60
jeje_sat: folds
Uncalled bet (60) returned to danye tukuma
danye tukuma collected 120 from pot
danye tukuma: doesn't show hand
*** SUMMARY ***
Total pot 120 | Rake 0
Board [4d Jd 5d]
Seat 1: Kalif97 (button) folded before Flop (didn't bet)
Seat 2: jeje_sat (small blind) folded on the Flop
Seat 3: danye tukuma (big blind) collected (120)


PokerStars Hand #229721928856: Tournament #3263055222, €0.23+€0.02 EUR Omaha Pot Limit - Level II (15/30) - 2021/09/09 22:07:54 CET [2021/09/09 16:07:54 ET]
Table '3263055222 1' 3-max Seat #2 is the button
Seat 1: Kalif97 (400 in chips)
Seat 2: jeje_sat (550 in chips)
Seat 3: danye tukuma (550 in chips)
danye tukuma: posts small blind 15
Kalif97: posts big blind 30
*** HOLE CARDS ***
Dealt to jeje_sat [Ah 5d 6d Ts]
jeje_sat: folds
danye tukuma: raises 30 to 60
Kalif97: calls 30
*** FLOP *** [4s 9c 7d]
danye tukuma: checks
Kalif97: bets 120
danye tukuma: calls 120
*** TURN *** [4s 9c 7d] [3s]
danye tukuma: checks
Kalif97: bets 220 and is all-in
danye tukuma: calls 220
*** RIVER *** [4s 9c 7d 3s] [Qs]
*** SHOW DOWN ***
danye tukuma: shows [3c Jh 2s As] (a flush, Ace high)
Kalif97: shows [9d 8s Th 9h] (three of a kind, Nines)
danye tukuma collected 800 from pot
Kalif97 finished the tournament in 3rd place
*** SUMMARY ***
Total pot 800 | Rake 0
Board [4s 9c 7d 3s Qs]
Seat 1: Kalif97 (big blind) showed [9d 8s Th 9h] and lost with three of a kind, Nines
Seat 2: jeje_sat (button) folded before Flop (didn't bet)
Seat 3: danye tukuma (small blind) showed [3c Jh 2s As] and won (800) with a flush, Ace high


PokerStars Hand #229721949365: Tournament #3263055222, €0.23+€0.02 EUR Omaha Pot Limit - Level II (15/30) - 2021/09/09 22:08:33 CET [2021/09/09 16:08:33 ET]
Table '3263055222 1' 3-max Seat #3 is the button
Seat 2: jeje_sat (550 in chips)
Seat 3: danye tukuma (950 in chips)
danye tukuma: posts small blind 15
jeje_sat: posts big blind 30
*** HOLE CARDS ***
Dealt to jeje_sat [2c 3d As Ah]
danye tukuma: raises 60 to 90
jeje_sat: raises 180 to 270
danye tukuma: raises 540 to 810
jeje_sat: calls 280 and is all-in
Uncalled bet (260) returned to danye tukuma
*** FLOP *** [5c Th 3h]
*** TURN *** [5c Th 3h] [Kd]
*** RIVER *** [5c Th 3h Kd] [4d]
*** SHOW DOWN ***
jeje_sat: shows [2c 3d As Ah] (a straight, Ace to Five)
danye tukuma: shows [9d Ad Jh 8s] (high card Ace)
jeje_sat collected 1100 from pot
*** SUMMARY ***
Total pot 1100 | Rake 0
Board [5c Th 3h Kd 4d]
Seat 2: jeje_sat (big blind) showed [2c 3d As Ah] and won (1100) with a straight, Ace to Five
Seat 3: danye tukuma (button) (small blind) showed [9d Ad Jh 8s] and lost with high card Ace


PokerStars Hand #229721959901: Tournament #3263055222, €0.23+€0.02 EUR Omaha Pot Limit - Level II (15/30) - 2021/09/09 22:08:52 CET [2021/09/09 16:08:52 ET]
Table '3263055222 1' 3-max Seat #2 is the button
Seat 2: jeje_sat (1100 in chips)
Seat 3: danye tukuma (400 in chips)
jeje_sat: posts small blind 15
danye tukuma: posts big blind 30
*** HOLE CARDS ***
Dealt to jeje_sat [7c Qs Tc 4h]
jeje_sat: folds
Uncalled bet (15) returned to danye tukuma
danye tukuma collected 30 from pot
danye tukuma: doesn't show hand
*** SUMMARY ***
Total pot 30 | Rake 0
Seat 2: jeje_sat (button) (small blind) folded before Flop
Seat 3: danye tukuma (big blind) collected (30)


PokerStars Hand #229721964105: Tournament #3263055222, €0.23+€0.02 EUR Omaha Pot Limit - Level II (15/30) - 2021/09/09 22:09:00 CET [2021/09/09 16:09:00 ET]
Table '3263055222 1' 3-max Seat #3 is the button
Seat 2: jeje_sat (1085 in chips)
Seat 3: danye tukuma (415 in chips)
danye tukuma: posts small blind 15
jeje_sat: posts big blind 30
*** HOLE CARDS ***
Dealt to jeje_sat [Js 4h 9s Jd]
danye tukuma: raises 60 to 90
jeje_sat: calls 60
*** FLOP *** [As 2h Ks]
jeje_sat: checks
danye tukuma: bets 90
jeje_sat: calls 90
*** TURN *** [As 2h Ks] [Kh]
jeje_sat: bets 360
danye tukuma: calls 235 and is all-in
Uncalled bet (125) returned to jeje_sat
*** RIVER *** [As 2h Ks Kh] [4c]
*** SHOW DOWN ***
jeje_sat: shows [Js 4h 9s Jd] (two pair, Kings and Jacks)
danye tukuma: shows [5h Ah Ad 8c] (a full house, Aces full of Kings)
danye tukuma collected 830 from pot
*** SUMMARY ***
Total pot 830 | Rake 0
Board [As 2h Ks Kh 4c]
Seat 2: jeje_sat (big blind) showed [Js 4h 9s Jd] and lost with two pair, Kings and Jacks
Seat 3: danye tukuma (button) (small blind) showed [5h Ah Ad 8c] and won (830) with a full house, Aces full of Kings


PokerStars Hand #229721981975: Tournament #3263055222, €0.23+€0.02 EUR Omaha Pot Limit - Level II (15/30) - 2021/09/09 22:09:33 CET [2021/09/09 16:09:33 ET]
Table '3263055222 1' 3-max Seat #2 is the button
Seat 2: jeje_sat (670 in chips)
Seat 3: danye tukuma (830 in chips)
jeje_sat: posts small blind 15
danye tukuma: posts big blind 30
*** HOLE CARDS ***
Dealt to jeje_sat [Ac 4c 8h 8c]
jeje_sat: raises 60 to 90
danye tukuma: calls 60
*** FLOP *** [7h 5c Td]
danye tukuma: checks
jeje_sat: checks
*** TURN *** [7h 5c Td] [4h]
danye tukuma: bets 60
jeje_sat: folds
Uncalled bet (60) returned to danye tukuma
danye tukuma collected 180 from pot
danye tukuma: doesn't show hand
*** SUMMARY ***
Total pot 180 | Rake 0
Board [7h 5c Td 4h]
Seat 2: jeje_sat (button) (small blind) folded on the Turn
Seat 3: danye tukuma (big blind) collected (180)


PokerStars Hand #229721995605: Tournament #3263055222, €0.23+€0.02 EUR Omaha Pot Limit - Level II (15/30) - 2021/09/09 22:09:58 CET [2021/09/09 16:09:58 ET]
Table '3263055222 1' 3-max Seat #3 is the button
Seat 2: jeje_sat (580 in chips)
Seat 3: danye tukuma (920 in chips)
danye tukuma: posts small blind 15
jeje_sat: posts big blind 30
*** HOLE CARDS ***
Dealt to jeje_sat [Tc 6d Qh 9h]
danye tukuma: raises 60 to 90
jeje_sat: calls 60
*** FLOP *** [Qd Td 8c]
jeje_sat: bets 180
danye tukuma: raises 540 to 720
jeje_sat: calls 310 and is all-in
Uncalled bet (230) returned to danye tukuma
*** TURN *** [Qd Td 8c] [7s]
*** RIVER *** [Qd Td 8c 7s] [5h]
*** SHOW DOWN ***
jeje_sat: shows [Tc 6d Qh 9h] (a straight, Six to Ten)
danye tukuma: shows [2c Kc Qs 8h] (two pair, Queens and Eights)
jeje_sat collected 1160 from pot
*** SUMMARY ***
Total pot 1160 | Rake 0
Board [Qd Td 8c 7s 5h]
Seat 2: jeje_sat (big blind) showed [Tc 6d Qh 9h] and won (1160) with a straight, Six to Ten
Seat 3: danye tukuma (button) (small blind) showed [2c Kc Qs 8h] and lost with two pair, Queens and Eights


PokerStars Hand #229722013066: Tournament #3263055222, €0.23+€0.02 EUR Omaha Pot Limit - Level III (20/40) - 2021/09/09 22:10:30 CET [2021/09/09 16:10:30 ET]
Table '3263055222 1' 3-max Seat #2 is the button
Seat 2: jeje_sat (1160 in chips)
Seat 3: danye tukuma (340 in chips)
jeje_sat: posts small blind 20
danye tukuma: posts big blind 40
*** HOLE CARDS ***
Dealt to jeje_sat [Td As Th 7h]
jeje_sat: calls 20
danye tukuma: checks
*** FLOP *** [5h Kc 8h]
danye tukuma: checks
jeje_sat: bets 80
danye tukuma: folds
Uncalled bet (80) returned to jeje_sat
jeje_sat collected 80 from pot
jeje_sat: doesn't show hand
*** SUMMARY ***
Total pot 80 | Rake 0
Board [5h Kc 8h]
Seat 2: jeje_sat (button) (small blind) collected (80)
Seat 3: danye tukuma (big blind) folded on the Flop


PokerStars Hand #229722022339: Tournament #3263055222, €0.23+€0.02 EUR Omaha Pot Limit - Level III (20/40) - 2021/09/09 22:10:48 CET [2021/09/09 16:10:48 ET]
Table '3263055222 1' 3-max Seat #3 is the button
Seat 2: jeje_sat (1200 in chips)
Seat 3: danye tukuma (300 in chips)
danye tukuma: posts small blind 20
jeje_sat: posts big blind 40
*** HOLE CARDS ***
Dealt to jeje_sat [Qs Kh 8s Qd]
danye tukuma: folds
Uncalled bet (20) returned to jeje_sat
jeje_sat collected 40 from pot
jeje_sat: doesn't show hand
*** SUMMARY ***
Total pot 40 | Rake 0
Seat 2: jeje_sat (big blind) collected (40)
Seat 3: danye tukuma (button) (small blind) folded before Flop


PokerStars Hand #229722025557: Tournament #3263055222, €0.23+€0.02 EUR Omaha Pot Limit - Level III (20/40) - 2021/09/09 22:10:53 CET [2021/09/09 16:10:53 ET]
Table '3263055222 1' 3-max Seat #2 is the button
Seat 2: jeje_sat (1220 in chips)
Seat 3: danye tukuma (280 in chips)
jeje_sat: posts small blind 20
danye tukuma: posts big blind 40
*** HOLE CARDS ***
Dealt to jeje_sat [Tc Js Jh Ah]
jeje_sat: raises 80 to 120
danye tukuma: raises 160 to 280 and is all-in
jeje_sat: calls 160
*** FLOP *** [8c 2c 8h]
*** TURN *** [8c 2c 8h] [7s]
*** RIVER *** [8c 2c 8h 7s] [3c]
*** SHOW DOWN ***
danye tukuma: shows [9d 5s Kd Ac] (a pair of Eights)
jeje_sat: shows [Tc Js Jh Ah] (two pair, Jacks and Eights)
jeje_sat collected 560 from pot
*** SUMMARY ***
Total pot 560 | Rake 0
Board [8c 2c 8h 7s 3c]
Seat 2: jeje_sat (button) (small blind) showed [Tc Js Jh Ah] and won (560) with two pair, Jacks and Eights
Seat 3: danye tukuma (big blind) showed [9d 5s Kd Ac] and lost with a pair of Eights


