PokerStars Hand #229774212029: Tournament #3264234359, €0.93+€0.07 EUR Omaha Pot Limit - Level I (10/20) - 2021/09/11 22:07:30 CET [2021/09/11 16:07:30 ET]
Table '3264234359 1' 3-max Seat #1 is the button
Seat 1: jeje_sat (500 in chips)
Seat 2: mborghese (500 in chips)
Seat 3: beuzegbudog (500 in chips)
mborghese: posts small blind 10
beuzegbudog: posts big blind 20
*** HOLE CARDS ***
Dealt to jeje_sat [4c 8s 7s 5h]
jeje_sat: folds
mborghese: calls 10
beuzegbudog: checks
*** FLOP *** [6d 6s Kd]
mborghese: checks
beuzegbudog: checks
*** TURN *** [6d 6s Kd] [5c]
mborghese: bets 20
beuzegbudog: calls 20
*** RIVER *** [6d 6s Kd 5c] [9s]
mborghese: checks
beuzegbudog: checks
*** SHOW DOWN ***
mborghese: shows [5s 5d Ts 7d] (a full house, Fives full of Sixes)
beuzegbudog: mucks hand
mborghese collected 80 from pot
*** SUMMARY ***
Total pot 80 | Rake 0
Board [6d 6s Kd 5c 9s]
Seat 1: jeje_sat (button) folded before Flop (didn't bet)
Seat 2: mborghese (small blind) showed [5s 5d Ts 7d] and won (80) with a full house, Fives full of Sixes
Seat 3: beuzegbudog (big blind) mucked [2h Tc 8d 9c]


PokerStars Hand #229774236625: Tournament #3264234359, €0.93+€0.07 EUR Omaha Pot Limit - Level I (10/20) - 2021/09/11 22:08:17 CET [2021/09/11 16:08:17 ET]
Table '3264234359 1' 3-max Seat #2 is the button
Seat 1: jeje_sat (500 in chips)
Seat 2: mborghese (540 in chips)
Seat 3: beuzegbudog (460 in chips)
beuzegbudog: posts small blind 10
jeje_sat: posts big blind 20
*** HOLE CARDS ***
Dealt to jeje_sat [Qh Kh 6d 3s]
mborghese: calls 20
beuzegbudog: calls 10
jeje_sat: checks
*** FLOP *** [8h Td Ts]
beuzegbudog: checks
jeje_sat: checks
mborghese: checks
*** TURN *** [8h Td Ts] [Kc]
beuzegbudog: bets 48
jeje_sat: folds
mborghese: calls 48
*** RIVER *** [8h Td Ts Kc] [4c]
beuzegbudog: bets 62
mborghese: calls 62
*** SHOW DOWN ***
beuzegbudog: shows [Ah Ad Qs As] (two pair, Aces and Tens)
mborghese: shows [2s Tc Kd 5h] (a full house, Tens full of Kings)
mborghese collected 280 from pot
*** SUMMARY ***
Total pot 280 | Rake 0
Board [8h Td Ts Kc 4c]
Seat 1: jeje_sat (big blind) folded on the Turn
Seat 2: mborghese (button) showed [2s Tc Kd 5h] and won (280) with a full house, Tens full of Kings
Seat 3: beuzegbudog (small blind) showed [Ah Ad Qs As] and lost with two pair, Aces and Tens


PokerStars Hand #229774259428: Tournament #3264234359, €0.93+€0.07 EUR Omaha Pot Limit - Level I (10/20) - 2021/09/11 22:09:01 CET [2021/09/11 16:09:01 ET]
Table '3264234359 1' 3-max Seat #3 is the button
Seat 1: jeje_sat (480 in chips)
Seat 2: mborghese (690 in chips)
Seat 3: beuzegbudog (330 in chips)
jeje_sat: posts small blind 10
mborghese: posts big blind 20
*** HOLE CARDS ***
Dealt to jeje_sat [Ts Tc 2s 9d]
beuzegbudog: folds
jeje_sat: folds
Uncalled bet (10) returned to mborghese
mborghese collected 20 from pot
mborghese: doesn't show hand
*** SUMMARY ***
Total pot 20 | Rake 0
Seat 1: jeje_sat (small blind) folded before Flop
Seat 2: mborghese (big blind) collected (20)
Seat 3: beuzegbudog (button) folded before Flop (didn't bet)


PokerStars Hand #229774266564: Tournament #3264234359, €0.93+€0.07 EUR Omaha Pot Limit - Level I (10/20) - 2021/09/11 22:09:14 CET [2021/09/11 16:09:14 ET]
Table '3264234359 1' 3-max Seat #1 is the button
Seat 1: jeje_sat (470 in chips)
Seat 2: mborghese (700 in chips)
Seat 3: beuzegbudog (330 in chips)
mborghese: posts small blind 10
beuzegbudog: posts big blind 20
*** HOLE CARDS ***
Dealt to jeje_sat [As Ah 7s 8d]
jeje_sat: raises 50 to 70
mborghese: calls 60
beuzegbudog: calls 50
*** FLOP *** [Ac 2d Jd]
mborghese: checks
beuzegbudog: checks
jeje_sat: bets 210
mborghese: folds
beuzegbudog: folds
Uncalled bet (210) returned to jeje_sat
jeje_sat collected 210 from pot
jeje_sat: doesn't show hand
*** SUMMARY ***
Total pot 210 | Rake 0
Board [Ac 2d Jd]
Seat 1: jeje_sat (button) collected (210)
Seat 2: mborghese (small blind) folded on the Flop
Seat 3: beuzegbudog (big blind) folded on the Flop


PokerStars Hand #229774282536: Tournament #3264234359, €0.93+€0.07 EUR Omaha Pot Limit - Level I (10/20) - 2021/09/11 22:09:44 CET [2021/09/11 16:09:44 ET]
Table '3264234359 1' 3-max Seat #2 is the button
Seat 1: jeje_sat (610 in chips)
Seat 2: mborghese (630 in chips)
Seat 3: beuzegbudog (260 in chips)
beuzegbudog: posts small blind 10
jeje_sat: posts big blind 20
*** HOLE CARDS ***
Dealt to jeje_sat [3h Ts 5h Kh]
mborghese: calls 20
beuzegbudog: calls 10
jeje_sat: checks
*** FLOP *** [7d 6c 8h]
beuzegbudog: checks
jeje_sat: checks
mborghese: checks
*** TURN *** [7d 6c 8h] [As]
beuzegbudog: bets 48
jeje_sat: folds
mborghese: calls 48
*** RIVER *** [7d 6c 8h As] [4s]
beuzegbudog: bets 78
mborghese: calls 78
*** SHOW DOWN ***
beuzegbudog: shows [Qc 5d Jd 9s] (a straight, Five to Nine)
mborghese: mucks hand
beuzegbudog collected 312 from pot
*** SUMMARY ***
Total pot 312 | Rake 0
Board [7d 6c 8h As 4s]
Seat 1: jeje_sat (big blind) folded on the Turn
Seat 2: mborghese (button) mucked [Qs Qh 7s Ks]
Seat 3: beuzegbudog (small blind) showed [Qc 5d Jd 9s] and won (312) with a straight, Five to Nine


PokerStars Hand #229774302306: Tournament #3264234359, €0.93+€0.07 EUR Omaha Pot Limit - Level I (10/20) - 2021/09/11 22:10:22 CET [2021/09/11 16:10:22 ET]
Table '3264234359 1' 3-max Seat #3 is the button
Seat 1: jeje_sat (590 in chips)
Seat 2: mborghese (484 in chips)
Seat 3: beuzegbudog (426 in chips)
jeje_sat: posts small blind 10
mborghese: posts big blind 20
*** HOLE CARDS ***
Dealt to jeje_sat [3c 7s Jd Td]
beuzegbudog: raises 20 to 40
jeje_sat: folds
mborghese: calls 20
*** FLOP *** [Qs Ts 5d]
mborghese: checks
beuzegbudog: checks
*** TURN *** [Qs Ts 5d] [6h]
mborghese: checks
beuzegbudog: bets 90
mborghese: folds
Uncalled bet (90) returned to beuzegbudog
beuzegbudog collected 90 from pot
beuzegbudog: doesn't show hand
*** SUMMARY ***
Total pot 90 | Rake 0
Board [Qs Ts 5d 6h]
Seat 1: jeje_sat (small blind) folded before Flop
Seat 2: mborghese (big blind) folded on the Turn
Seat 3: beuzegbudog (button) collected (90)


PokerStars Hand #229774326547: Tournament #3264234359, €0.93+€0.07 EUR Omaha Pot Limit - Level II (15/30) - 2021/09/11 22:11:08 CET [2021/09/11 16:11:08 ET]
Table '3264234359 1' 3-max Seat #1 is the button
Seat 1: jeje_sat (580 in chips)
Seat 2: mborghese (444 in chips)
Seat 3: beuzegbudog (476 in chips)
mborghese: posts small blind 15
beuzegbudog: posts big blind 30
*** HOLE CARDS ***
Dealt to jeje_sat [Qc 3d 7d Tc]
jeje_sat: calls 30
mborghese: calls 15
beuzegbudog: checks
*** FLOP *** [4h Ks 4d]
mborghese: checks
beuzegbudog: checks
jeje_sat: checks
*** TURN *** [4h Ks 4d] [Jd]
mborghese: checks
beuzegbudog: bets 72
jeje_sat: folds
mborghese: folds
Uncalled bet (72) returned to beuzegbudog
beuzegbudog collected 90 from pot
*** SUMMARY ***
Total pot 90 | Rake 0
Board [4h Ks 4d Jd]
Seat 1: jeje_sat (button) folded on the Turn
Seat 2: mborghese (small blind) folded on the Turn
Seat 3: beuzegbudog (big blind) collected (90)


PokerStars Hand #229774346097: Tournament #3264234359, €0.93+€0.07 EUR Omaha Pot Limit - Level II (15/30) - 2021/09/11 22:11:46 CET [2021/09/11 16:11:46 ET]
Table '3264234359 1' 3-max Seat #2 is the button
Seat 1: jeje_sat (550 in chips)
Seat 2: mborghese (414 in chips)
Seat 3: beuzegbudog (536 in chips)
beuzegbudog: posts small blind 15
jeje_sat: posts big blind 30
*** HOLE CARDS ***
Dealt to jeje_sat [Js Ac 6h 2d]
mborghese: calls 30
beuzegbudog: calls 15
jeje_sat: checks
*** FLOP *** [Ts 4h 7d]
beuzegbudog: checks
jeje_sat: checks
mborghese: checks
*** TURN *** [Ts 4h 7d] [4s]
beuzegbudog: checks
jeje_sat: checks
mborghese: checks
*** RIVER *** [Ts 4h 7d 4s] [3c]
beuzegbudog: bets 30
jeje_sat: folds
mborghese: raises 30 to 60
beuzegbudog: folds
Uncalled bet (30) returned to mborghese
mborghese collected 150 from pot
mborghese: doesn't show hand
*** SUMMARY ***
Total pot 150 | Rake 0
Board [Ts 4h 7d 4s 3c]
Seat 1: jeje_sat (big blind) folded on the River
Seat 2: mborghese (button) collected (150)
Seat 3: beuzegbudog (small blind) folded on the River


PokerStars Hand #229774384540: Tournament #3264234359, €0.93+€0.07 EUR Omaha Pot Limit - Level II (15/30) - 2021/09/11 22:13:00 CET [2021/09/11 16:13:00 ET]
Table '3264234359 1' 3-max Seat #3 is the button
Seat 1: jeje_sat (520 in chips)
Seat 2: mborghese (504 in chips)
Seat 3: beuzegbudog (476 in chips)
jeje_sat: posts small blind 15
mborghese: posts big blind 30
*** HOLE CARDS ***
Dealt to jeje_sat [4d 6h Kd 8d]
beuzegbudog: raises 30 to 60
jeje_sat: folds
mborghese: calls 30
*** FLOP *** [4h Ts Jd]
mborghese: checks
beuzegbudog: checks
*** TURN *** [4h Ts Jd] [8s]
mborghese: checks
beuzegbudog: checks
*** RIVER *** [4h Ts Jd 8s] [Ac]
mborghese: checks
beuzegbudog: bets 54
mborghese: folds
Uncalled bet (54) returned to beuzegbudog
beuzegbudog collected 135 from pot
*** SUMMARY ***
Total pot 135 | Rake 0
Board [4h Ts Jd 8s Ac]
Seat 1: jeje_sat (small blind) folded before Flop
Seat 2: mborghese (big blind) folded on the River
Seat 3: beuzegbudog (button) collected (135)


PokerStars Hand #229774407874: Tournament #3264234359, €0.93+€0.07 EUR Omaha Pot Limit - Level III (20/40) - 2021/09/11 22:13:44 CET [2021/09/11 16:13:44 ET]
Table '3264234359 1' 3-max Seat #1 is the button
Seat 1: jeje_sat (505 in chips)
Seat 2: mborghese (444 in chips)
Seat 3: beuzegbudog (551 in chips)
mborghese: posts small blind 20
beuzegbudog: posts big blind 40
*** HOLE CARDS ***
Dealt to jeje_sat [Tc 3s 4d 5s]
jeje_sat: folds
mborghese: calls 20
beuzegbudog: checks
*** FLOP *** [6h Th As]
mborghese: checks
beuzegbudog: checks
*** TURN *** [6h Th As] [Ac]
mborghese: checks
beuzegbudog: bets 80
mborghese: calls 80
*** RIVER *** [6h Th As Ac] [Js]
mborghese: bets 40
beuzegbudog: calls 40
*** SHOW DOWN ***
mborghese: shows [Td Kc Jc 5h] (two pair, Aces and Jacks)
beuzegbudog: shows [Qc 4s 3d Ah] (three of a kind, Aces)
beuzegbudog collected 320 from pot
*** SUMMARY ***
Total pot 320 | Rake 0
Board [6h Th As Ac Js]
Seat 1: jeje_sat (button) folded before Flop (didn't bet)
Seat 2: mborghese (small blind) showed [Td Kc Jc 5h] and lost with two pair, Aces and Jacks
Seat 3: beuzegbudog (big blind) showed [Qc 4s 3d Ah] and won (320) with three of a kind, Aces


PokerStars Hand #229774434969: Tournament #3264234359, €0.93+€0.07 EUR Omaha Pot Limit - Level III (20/40) - 2021/09/11 22:14:20 CET [2021/09/11 16:14:20 ET]
Table '3264234359 1' 3-max Seat #2 is the button
Seat 1: jeje_sat (505 in chips)
Seat 2: mborghese (284 in chips)
Seat 3: beuzegbudog (711 in chips)
beuzegbudog: posts small blind 20
jeje_sat: posts big blind 40
*** HOLE CARDS ***
Dealt to jeje_sat [9d Ah Kd 5s]
mborghese: calls 40
beuzegbudog: calls 20
jeje_sat: checks
*** FLOP *** [5d Js As]
beuzegbudog: checks
jeje_sat: bets 120
mborghese: calls 120
beuzegbudog: folds
*** TURN *** [5d Js As] [9h]
jeje_sat: bets 345 and is all-in
mborghese: calls 124 and is all-in
Uncalled bet (221) returned to jeje_sat
*** RIVER *** [5d Js As 9h] [8d]
*** SHOW DOWN ***
jeje_sat: shows [9d Ah Kd 5s] (two pair, Aces and Nines)
mborghese: shows [3c 2d 6d Td] (high card Ace)
jeje_sat collected 608 from pot
mborghese finished the tournament in 3rd place
*** SUMMARY ***
Total pot 608 | Rake 0
Board [5d Js As 9h 8d]
Seat 1: jeje_sat (big blind) showed [9d Ah Kd 5s] and won (608) with two pair, Aces and Nines
Seat 2: mborghese (button) showed [3c 2d 6d Td] and lost with high card Ace
Seat 3: beuzegbudog (small blind) folded on the Flop


PokerStars Hand #229774465657: Tournament #3264234359, €0.93+€0.07 EUR Omaha Pot Limit - Level III (20/40) - 2021/09/11 22:15:02 CET [2021/09/11 16:15:02 ET]
Table '3264234359 1' 3-max Seat #1 is the button
Seat 1: jeje_sat (829 in chips)
Seat 3: beuzegbudog (671 in chips)
jeje_sat: posts small blind 20
beuzegbudog: posts big blind 40
*** HOLE CARDS ***
Dealt to jeje_sat [3c 4c 9d 5s]
jeje_sat: folds
Uncalled bet (20) returned to beuzegbudog
beuzegbudog collected 40 from pot
beuzegbudog: doesn't show hand
*** SUMMARY ***
Total pot 40 | Rake 0
Seat 1: jeje_sat (button) (small blind) folded before Flop
Seat 3: beuzegbudog (big blind) collected (40)


PokerStars Hand #229774468941: Tournament #3264234359, €0.93+€0.07 EUR Omaha Pot Limit - Level III (20/40) - 2021/09/11 22:15:08 CET [2021/09/11 16:15:08 ET]
Table '3264234359 1' 3-max Seat #3 is the button
Seat 1: jeje_sat (809 in chips)
Seat 3: beuzegbudog (691 in chips)
beuzegbudog: posts small blind 20
jeje_sat: posts big blind 40
*** HOLE CARDS ***
Dealt to jeje_sat [5c 9s 3d 4c]
beuzegbudog: folds
Uncalled bet (20) returned to jeje_sat
jeje_sat collected 40 from pot
jeje_sat: doesn't show hand
*** SUMMARY ***
Total pot 40 | Rake 0
Seat 1: jeje_sat (big blind) collected (40)
Seat 3: beuzegbudog (button) (small blind) folded before Flop


PokerStars Hand #229774473901: Tournament #3264234359, €0.93+€0.07 EUR Omaha Pot Limit - Level III (20/40) - 2021/09/11 22:15:17 CET [2021/09/11 16:15:17 ET]
Table '3264234359 1' 3-max Seat #1 is the button
Seat 1: jeje_sat (829 in chips)
Seat 3: beuzegbudog (671 in chips)
jeje_sat: posts small blind 20
beuzegbudog: posts big blind 40
*** HOLE CARDS ***
Dealt to jeje_sat [Ks Th Ah Td]
jeje_sat: raises 80 to 120
beuzegbudog: calls 80
*** FLOP *** [5d 4d Jd]
beuzegbudog: checks
jeje_sat: checks
*** TURN *** [5d 4d Jd] [5c]
beuzegbudog: checks
jeje_sat: bets 120
beuzegbudog: folds
Uncalled bet (120) returned to jeje_sat
jeje_sat collected 240 from pot
jeje_sat: doesn't show hand
*** SUMMARY ***
Total pot 240 | Rake 0
Board [5d 4d Jd 5c]
Seat 1: jeje_sat (button) (small blind) collected (240)
Seat 3: beuzegbudog (big blind) folded on the Turn


PokerStars Hand #229774488948: Tournament #3264234359, €0.93+€0.07 EUR Omaha Pot Limit - Level III (20/40) - 2021/09/11 22:15:45 CET [2021/09/11 16:15:45 ET]
Table '3264234359 1' 3-max Seat #3 is the button
Seat 1: jeje_sat (949 in chips)
Seat 3: beuzegbudog (551 in chips)
beuzegbudog: posts small blind 20
jeje_sat: posts big blind 40
*** HOLE CARDS ***
Dealt to jeje_sat [3h Jc 6s 9d]
beuzegbudog: raises 40 to 80
jeje_sat: folds
Uncalled bet (40) returned to beuzegbudog
beuzegbudog collected 80 from pot
beuzegbudog: doesn't show hand
*** SUMMARY ***
Total pot 80 | Rake 0
Seat 1: jeje_sat (big blind) folded before Flop
Seat 3: beuzegbudog (button) (small blind) collected (80)


PokerStars Hand #229774493344: Tournament #3264234359, €0.93+€0.07 EUR Omaha Pot Limit - Level III (20/40) - 2021/09/11 22:15:53 CET [2021/09/11 16:15:53 ET]
Table '3264234359 1' 3-max Seat #1 is the button
Seat 1: jeje_sat (909 in chips)
Seat 3: beuzegbudog (591 in chips)
jeje_sat: posts small blind 20
beuzegbudog: posts big blind 40
*** HOLE CARDS ***
Dealt to jeje_sat [Kh 2h 4s 6c]
jeje_sat: folds
Uncalled bet (20) returned to beuzegbudog
beuzegbudog collected 40 from pot
beuzegbudog: doesn't show hand
*** SUMMARY ***
Total pot 40 | Rake 0
Seat 1: jeje_sat (button) (small blind) folded before Flop
Seat 3: beuzegbudog (big blind) collected (40)


PokerStars Hand #229774496373: Tournament #3264234359, €0.93+€0.07 EUR Omaha Pot Limit - Level III (20/40) - 2021/09/11 22:15:59 CET [2021/09/11 16:15:59 ET]
Table '3264234359 1' 3-max Seat #3 is the button
Seat 1: jeje_sat (889 in chips)
Seat 3: beuzegbudog (611 in chips)
beuzegbudog: posts small blind 20
jeje_sat: posts big blind 40
*** HOLE CARDS ***
Dealt to jeje_sat [Qs 5s 4s 8h]
beuzegbudog: folds
Uncalled bet (20) returned to jeje_sat
jeje_sat collected 40 from pot
jeje_sat: doesn't show hand
*** SUMMARY ***
Total pot 40 | Rake 0
Seat 1: jeje_sat (big blind) collected (40)
Seat 3: beuzegbudog (button) (small blind) folded before Flop


PokerStars Hand #229774499014: Tournament #3264234359, €0.93+€0.07 EUR Omaha Pot Limit - Level III (20/40) - 2021/09/11 22:16:04 CET [2021/09/11 16:16:04 ET]
Table '3264234359 1' 3-max Seat #1 is the button
Seat 1: jeje_sat (909 in chips)
Seat 3: beuzegbudog (591 in chips)
jeje_sat: posts small blind 20
beuzegbudog: posts big blind 40
*** HOLE CARDS ***
Dealt to jeje_sat [Ts 2s Jh 9s]
jeje_sat: raises 80 to 120
beuzegbudog: raises 240 to 360
jeje_sat: calls 240
*** FLOP *** [Qh 6h 8s]
beuzegbudog: bets 231 and is all-in
jeje_sat: calls 231
*** TURN *** [Qh 6h 8s] [6c]
*** RIVER *** [Qh 6h 8s 6c] [Ad]
*** SHOW DOWN ***
beuzegbudog: shows [Ah Qc 4c 9h] (two pair, Aces and Queens)
jeje_sat: shows [Ts 2s Jh 9s] (a pair of Sixes)
beuzegbudog collected 1182 from pot
*** SUMMARY ***
Total pot 1182 | Rake 0
Board [Qh 6h 8s 6c Ad]
Seat 1: jeje_sat (button) (small blind) showed [Ts 2s Jh 9s] and lost with a pair of Sixes
Seat 3: beuzegbudog (big blind) showed [Ah Qc 4c 9h] and won (1182) with two pair, Aces and Queens


PokerStars Hand #229774513167: Tournament #3264234359, €0.93+€0.07 EUR Omaha Pot Limit - Level III (20/40) - 2021/09/11 22:16:30 CET [2021/09/11 16:16:30 ET]
Table '3264234359 1' 3-max Seat #3 is the button
Seat 1: jeje_sat (318 in chips)
Seat 3: beuzegbudog (1182 in chips)
beuzegbudog: posts small blind 20
jeje_sat: posts big blind 40
*** HOLE CARDS ***
Dealt to jeje_sat [Ah 7s 9d Qd]
beuzegbudog: folds
Uncalled bet (20) returned to jeje_sat
jeje_sat collected 40 from pot
jeje_sat: doesn't show hand
*** SUMMARY ***
Total pot 40 | Rake 0
Seat 1: jeje_sat (big blind) collected (40)
Seat 3: beuzegbudog (button) (small blind) folded before Flop


PokerStars Hand #229774518129: Tournament #3264234359, €0.93+€0.07 EUR Omaha Pot Limit - Level IV (30/60) - 2021/09/11 22:16:39 CET [2021/09/11 16:16:39 ET]
Table '3264234359 1' 3-max Seat #1 is the button
Seat 1: jeje_sat (338 in chips)
Seat 3: beuzegbudog (1162 in chips)
jeje_sat: posts small blind 30
beuzegbudog: posts big blind 60
*** HOLE CARDS ***
Dealt to jeje_sat [5h 8c Ah 6d]
jeje_sat: raises 120 to 180
beuzegbudog: raises 120 to 300
jeje_sat: raises 38 to 338 and is all-in
beuzegbudog: calls 38
*** FLOP *** [3c 2c Qc]
*** TURN *** [3c 2c Qc] [5c]
*** RIVER *** [3c 2c Qc 5c] [Jc]
*** SHOW DOWN ***
beuzegbudog: shows [7h 8d 8s 9s] (a pair of Eights)
jeje_sat: shows [5h 8c Ah 6d] (a pair of Fives)
beuzegbudog collected 676 from pot
*** SUMMARY ***
Total pot 676 | Rake 0
Board [3c 2c Qc 5c Jc]
Seat 1: jeje_sat (button) (small blind) showed [5h 8c Ah 6d] and lost with a pair of Fives
Seat 3: beuzegbudog (big blind) showed [7h 8d 8s 9s] and won (676) with a pair of Eights


