PokerStars Hand #229772584255: Tournament #3255385918, Freeroll  Hold'em No Limit - Level I (10/20) - 2021/09/11 21:15:11 CET [2021/09/11 15:15:11 ET]
Table '3255385918 432' 9-max Seat #1 is the button
Seat 1: jeje_sat (15000 in chips)
Seat 2: mo1012 (15000 in chips)
Seat 3: Wolfhall (15000 in chips) is sitting out
Seat 4: Blackmamba1878 (15000 in chips) is sitting out
Seat 5: Devilhead68 (15000 in chips) is sitting out
Seat 6: Alfil58 (15000 in chips)
Seat 7: pennsylvanius (15000 in chips) is sitting out
Seat 8: kato2011974 (15000 in chips)
Seat 9: Mmgoncalo (15000 in chips)
mo1012: posts small blind 10
Wolfhall: posts big blind 20
*** HOLE CARDS ***
Dealt to jeje_sat [Ad 4s]
Blackmamba1878: folds
Devilhead68: folds
Alfil58: calls 20
pennsylvanius: folds
kato2011974: folds
Mmgoncalo has timed out
Mmgoncalo: folds
Mmgoncalo is sitting out
jeje_sat: raises 40 to 60
Mmgoncalo has returned
mo1012: calls 50
Wolfhall: folds
Alfil58: calls 40
*** FLOP *** [8h 3c Qh]
mo1012: checks
Alfil58: checks
jeje_sat: checks
*** TURN *** [8h 3c Qh] [3d]
mo1012: checks
Alfil58: checks
jeje_sat: bets 100
mo1012: folds
Alfil58: folds
Uncalled bet (100) returned to jeje_sat
jeje_sat collected 200 from pot
jeje_sat: doesn't show hand
*** SUMMARY ***
Total pot 200 | Rake 0
Board [8h 3c Qh 3d]
Seat 1: jeje_sat (button) collected (200)
Seat 2: mo1012 (small blind) folded on the Turn
Seat 3: Wolfhall (big blind) folded before Flop
Seat 4: Blackmamba1878 folded before Flop (didn't bet)
Seat 5: Devilhead68 folded before Flop (didn't bet)
Seat 6: Alfil58 folded on the Turn
Seat 7: pennsylvanius folded before Flop (didn't bet)
Seat 8: kato2011974 folded before Flop (didn't bet)
Seat 9: Mmgoncalo folded before Flop (didn't bet)


PokerStars Hand #229772632703: Tournament #3255385918, Freeroll  Hold'em No Limit - Level I (10/20) - 2021/09/11 21:16:39 CET [2021/09/11 15:16:39 ET]
Table '3255385918 432' 9-max Seat #2 is the button
Seat 1: jeje_sat (15140 in chips)
Seat 2: mo1012 (14940 in chips)
Seat 3: Wolfhall (14980 in chips) is sitting out
Seat 4: Blackmamba1878 (15000 in chips) is sitting out
Seat 5: Devilhead68 (15000 in chips) is sitting out
Seat 6: Alfil58 (14940 in chips)
Seat 7: pennsylvanius (15000 in chips) is sitting out
Seat 8: kato2011974 (15000 in chips)
Seat 9: Mmgoncalo (15000 in chips)
Wolfhall: posts small blind 10
Blackmamba1878: posts big blind 20
*** HOLE CARDS ***
Dealt to jeje_sat [Qh Kh]
Devilhead68: folds
Alfil58 has timed out
Alfil58: folds
Alfil58 is sitting out
pennsylvanius: folds
Alfil58 is disconnected
kato2011974 has timed out
kato2011974: folds
kato2011974 is sitting out
Mmgoncalo: folds
jeje_sat: raises 40 to 60
kato2011974 has returned
mo1012: calls 60
Wolfhall: folds
Blackmamba1878: folds
*** FLOP *** [9s 9h 9c]
jeje_sat: bets 75
mo1012: calls 75
*** TURN *** [9s 9h 9c] [Jd]
jeje_sat: bets 150
mo1012: calls 150
*** RIVER *** [9s 9h 9c Jd] [8c]
jeje_sat: bets 300
mo1012: calls 300
*** SHOW DOWN ***
jeje_sat: shows [Qh Kh] (three of a kind, Nines)
mo1012: shows [8h Td] (a full house, Nines full of Eights)
mo1012 collected 1200 from pot
*** SUMMARY ***
Total pot 1200 | Rake 0
Board [9s 9h 9c Jd 8c]
Seat 1: jeje_sat showed [Qh Kh] and lost with three of a kind, Nines
Seat 2: mo1012 (button) showed [8h Td] and won (1200) with a full house, Nines full of Eights
Seat 3: Wolfhall (small blind) folded before Flop
Seat 4: Blackmamba1878 (big blind) folded before Flop
Seat 5: Devilhead68 folded before Flop (didn't bet)
Seat 6: Alfil58 folded before Flop (didn't bet)
Seat 7: pennsylvanius folded before Flop (didn't bet)
Seat 8: kato2011974 folded before Flop (didn't bet)
Seat 9: Mmgoncalo folded before Flop (didn't bet)


PokerStars Hand #229772661079: Tournament #3255385918, Freeroll  Hold'em No Limit - Level I (10/20) - 2021/09/11 21:17:31 CET [2021/09/11 15:17:31 ET]
Table '3255385918 432' 9-max Seat #3 is the button
Seat 1: jeje_sat (14555 in chips)
Seat 2: mo1012 (15555 in chips)
Seat 3: Wolfhall (14970 in chips) is sitting out
Seat 4: Blackmamba1878 (14980 in chips) is sitting out
Seat 5: Devilhead68 (15000 in chips) is sitting out
Seat 6: Alfil58 (14940 in chips) is sitting out
Seat 7: pennsylvanius (15000 in chips) is sitting out
Seat 8: kato2011974 (15000 in chips)
Seat 9: Mmgoncalo (15000 in chips)
Blackmamba1878: posts small blind 10
Devilhead68: posts big blind 20
*** HOLE CARDS ***
Dealt to jeje_sat [3s 4d]
Alfil58: folds
pennsylvanius: folds
kato2011974: folds
Mmgoncalo: folds
jeje_sat: folds
mo1012: calls 20
Wolfhall: folds
Blackmamba1878: folds
Devilhead68: folds
mo1012 collected 50 from pot
mo1012: doesn't show hand
*** SUMMARY ***
Total pot 50 | Rake 0
Seat 1: jeje_sat folded before Flop (didn't bet)
Seat 2: mo1012 collected (50)
Seat 3: Wolfhall (button) folded before Flop (didn't bet)
Seat 4: Blackmamba1878 (small blind) folded before Flop
Seat 5: Devilhead68 (big blind) folded before Flop
Seat 6: Alfil58 folded before Flop (didn't bet)
Seat 7: pennsylvanius folded before Flop (didn't bet)
Seat 8: kato2011974 folded before Flop (didn't bet)
Seat 9: Mmgoncalo folded before Flop (didn't bet)


PokerStars Hand #229772667137: Tournament #3255385918, Freeroll  Hold'em No Limit - Level I (10/20) - 2021/09/11 21:17:42 CET [2021/09/11 15:17:42 ET]
Table '3255385918 432' 9-max Seat #4 is the button
Seat 1: jeje_sat (14555 in chips)
Seat 2: mo1012 (15585 in chips)
Seat 3: Wolfhall (14970 in chips) is sitting out
Seat 4: Blackmamba1878 (14970 in chips) is sitting out
Seat 5: Devilhead68 (14980 in chips) is sitting out
Seat 6: Alfil58 (14940 in chips) is sitting out
Seat 7: pennsylvanius (15000 in chips) is sitting out
Seat 8: kato2011974 (15000 in chips)
Seat 9: Mmgoncalo (15000 in chips)
Devilhead68: posts small blind 10
Alfil58: posts big blind 20
*** HOLE CARDS ***
Dealt to jeje_sat [Th 3d]
pennsylvanius: folds
pennsylvanius has returned
kato2011974: raises 20 to 40
Mmgoncalo: calls 40
jeje_sat: folds
mo1012: calls 40
Wolfhall: folds
Blackmamba1878: folds
Devilhead68: folds
Alfil58: folds
*** FLOP *** [5c Qs Kc]
kato2011974: bets 75
Mmgoncalo: calls 75
Alfil58 has returned
mo1012: calls 75
*** TURN *** [5c Qs Kc] [Kd]
kato2011974: checks
Mmgoncalo: checks
mo1012: checks
*** RIVER *** [5c Qs Kc Kd] [2c]
kato2011974: checks
Mmgoncalo: checks
mo1012: checks
*** SHOW DOWN ***
kato2011974: shows [Td Qc] (two pair, Kings and Queens)
Mmgoncalo: mucks hand
mo1012: mucks hand
kato2011974 collected 375 from pot
*** SUMMARY ***
Total pot 375 | Rake 0
Board [5c Qs Kc Kd 2c]
Seat 1: jeje_sat folded before Flop (didn't bet)
Seat 2: mo1012 mucked [As 3h]
Seat 3: Wolfhall folded before Flop (didn't bet)
Seat 4: Blackmamba1878 (button) folded before Flop (didn't bet)
Seat 5: Devilhead68 (small blind) folded before Flop
Seat 6: Alfil58 (big blind) folded before Flop
Seat 7: pennsylvanius folded before Flop (didn't bet)
Seat 8: kato2011974 showed [Td Qc] and won (375) with two pair, Kings and Queens
Seat 9: Mmgoncalo mucked [Jh 9c]


PokerStars Hand #229772702084: Tournament #3255385918, Freeroll  Hold'em No Limit - Level II (15/30) - 2021/09/11 21:18:46 CET [2021/09/11 15:18:46 ET]
Table '3255385918 432' 9-max Seat #5 is the button
Seat 1: jeje_sat (14555 in chips)
Seat 2: mo1012 (15470 in chips)
Seat 3: Wolfhall (14970 in chips) is sitting out
Seat 4: Blackmamba1878 (14970 in chips) is sitting out
Seat 5: Devilhead68 (14970 in chips) is sitting out
Seat 6: Alfil58 (14920 in chips)
Seat 7: pennsylvanius (15000 in chips)
Seat 8: kato2011974 (15260 in chips)
Seat 9: Mmgoncalo (14885 in chips)
Alfil58: posts small blind 15
pennsylvanius: posts big blind 30
*** HOLE CARDS ***
Dealt to jeje_sat [6h Ac]
kato2011974: folds
Mmgoncalo: calls 30
jeje_sat: raises 60 to 90
mo1012: calls 90
Wolfhall: folds
Blackmamba1878: folds
Devilhead68: folds
Alfil58: calls 75
pennsylvanius: calls 60
Mmgoncalo: calls 60
*** FLOP *** [6c 3s Jc]
Alfil58: bets 30
pennsylvanius: calls 30
Mmgoncalo: calls 30
jeje_sat: calls 30
mo1012: raises 30 to 60
Alfil58: calls 30
pennsylvanius: calls 30
Mmgoncalo: folds
jeje_sat: calls 30
*** TURN *** [6c 3s Jc] [8d]
Alfil58: checks
pennsylvanius: checks
jeje_sat: checks
mo1012: bets 60
Alfil58: calls 60
pennsylvanius: calls 60
jeje_sat: calls 60
*** RIVER *** [6c 3s Jc 8d] [Jd]
Alfil58: checks
pennsylvanius: checks
jeje_sat: checks
mo1012: bets 60
Alfil58: calls 60
pennsylvanius: folds
jeje_sat: calls 60
*** SHOW DOWN ***
mo1012: shows [7h 7c] (two pair, Jacks and Sevens)
Alfil58: mucks hand
jeje_sat: mucks hand
mo1012 collected 1140 from pot
*** SUMMARY ***
Total pot 1140 | Rake 0
Board [6c 3s Jc 8d Jd]
Seat 1: jeje_sat mucked [6h Ac]
Seat 2: mo1012 showed [7h 7c] and won (1140) with two pair, Jacks and Sevens
Seat 3: Wolfhall folded before Flop (didn't bet)
Seat 4: Blackmamba1878 folded before Flop (didn't bet)
Seat 5: Devilhead68 (button) folded before Flop (didn't bet)
Seat 6: Alfil58 (small blind) mucked [5d 5s]
Seat 7: pennsylvanius (big blind) folded on the River
Seat 8: kato2011974 folded before Flop (didn't bet)
Seat 9: Mmgoncalo folded on the Flop


PokerStars Hand #229772789508: Tournament #3255385918, Freeroll  Hold'em No Limit - Level III (20/40) - 2021/09/11 21:21:25 CET [2021/09/11 15:21:25 ET]
Table '3255385918 432' 9-max Seat #6 is the button
Seat 1: jeje_sat (14285 in chips)
Seat 2: mo1012 (16340 in chips)
Seat 3: Wolfhall (14970 in chips) is sitting out
Seat 4: Blackmamba1878 (14970 in chips) is sitting out
Seat 5: Devilhead68 (14970 in chips) is sitting out
Seat 6: Alfil58 (14650 in chips)
Seat 7: pennsylvanius (14790 in chips)
Seat 8: kato2011974 (15260 in chips)
Seat 9: Mmgoncalo (14765 in chips)
pennsylvanius: posts small blind 20
kato2011974: posts big blind 40
*** HOLE CARDS ***
Dealt to jeje_sat [Tc 7h]
Mmgoncalo: raises 280 to 320
jeje_sat: calls 320
mo1012: folds
Wolfhall: folds
Blackmamba1878: folds
Devilhead68: folds
Alfil58: calls 320
pennsylvanius: calls 300
kato2011974: folds
*** FLOP *** [Jd 4h 3c]
pennsylvanius: bets 40
Blackmamba1878 has returned
Mmgoncalo: raises 1400 to 1440
jeje_sat: folds
Alfil58: folds
pennsylvanius: folds
Uncalled bet (1400) returned to Mmgoncalo
Mmgoncalo collected 1400 from pot
Mmgoncalo: doesn't show hand
*** SUMMARY ***
Total pot 1400 | Rake 0
Board [Jd 4h 3c]
Seat 1: jeje_sat folded on the Flop
Seat 2: mo1012 folded before Flop (didn't bet)
Seat 3: Wolfhall folded before Flop (didn't bet)
Seat 4: Blackmamba1878 folded before Flop (didn't bet)
Seat 5: Devilhead68 folded before Flop (didn't bet)
Seat 6: Alfil58 (button) folded on the Flop
Seat 7: pennsylvanius (small blind) folded on the Flop
Seat 8: kato2011974 (big blind) folded before Flop
Seat 9: Mmgoncalo collected (1400)


PokerStars Hand #229772809739: Tournament #3255385918, Freeroll  Hold'em No Limit - Level III (20/40) - 2021/09/11 21:22:02 CET [2021/09/11 15:22:02 ET]
Table '3255385918 432' 9-max Seat #7 is the button
Seat 1: jeje_sat (13965 in chips)
Seat 2: mo1012 (16340 in chips)
Seat 3: Wolfhall (14970 in chips) is sitting out
Seat 4: Blackmamba1878 (14970 in chips)
Seat 5: Devilhead68 (14970 in chips) is sitting out
Seat 6: Alfil58 (14330 in chips)
Seat 7: pennsylvanius (14430 in chips)
Seat 8: kato2011974 (15220 in chips)
Seat 9: Mmgoncalo (15805 in chips)
kato2011974: posts small blind 20
Mmgoncalo: posts big blind 40
*** HOLE CARDS ***
Dealt to jeje_sat [2s Qd]
Devilhead68 has returned
jeje_sat: folds
mo1012: calls 40
Wolfhall: folds
Blackmamba1878 has timed out
Blackmamba1878: folds
Blackmamba1878 is sitting out
Devilhead68: calls 40
Alfil58: calls 40
pennsylvanius: calls 40
kato2011974: calls 20
Mmgoncalo: checks
*** FLOP *** [6h Jc 7h]
kato2011974: checks
Mmgoncalo: checks
mo1012: checks
Blackmamba1878 is disconnected
Devilhead68: checks
Alfil58: checks
pennsylvanius: checks
*** TURN *** [6h Jc 7h] [4h]
kato2011974: bets 240
Mmgoncalo: calls 240
mo1012: folds
Devilhead68: folds
Alfil58: calls 240
pennsylvanius: calls 240
*** RIVER *** [6h Jc 7h 4h] [8s]
kato2011974: checks
Mmgoncalo: checks
Alfil58: checks
pennsylvanius: bets 200
kato2011974: calls 200
Mmgoncalo: raises 2560 to 2760
Alfil58: folds
pennsylvanius: calls 2560
kato2011974: folds
*** SHOW DOWN ***
Mmgoncalo: shows [Jh 3h] (a flush, Jack high)
pennsylvanius: mucks hand
Mmgoncalo collected 6920 from pot
*** SUMMARY ***
Total pot 6920 | Rake 0
Board [6h Jc 7h 4h 8s]
Seat 1: jeje_sat folded before Flop (didn't bet)
Seat 2: mo1012 folded on the Turn
Seat 3: Wolfhall folded before Flop (didn't bet)
Seat 4: Blackmamba1878 folded before Flop (didn't bet)
Seat 5: Devilhead68 folded on the Turn
Seat 6: Alfil58 folded on the River
Seat 7: pennsylvanius (button) mucked [5c 2h]
Seat 8: kato2011974 (small blind) folded on the River
Seat 9: Mmgoncalo (big blind) showed [Jh 3h] and won (6920) with a flush, Jack high


PokerStars Hand #229772885673: Tournament #3255385918, Freeroll  Hold'em No Limit - Level IV (25/50) - 2021/09/11 21:24:21 CET [2021/09/11 15:24:21 ET]
Table '3255385918 432' 9-max Seat #8 is the button
Seat 1: jeje_sat (13965 in chips)
Seat 2: mo1012 (16300 in chips)
Seat 3: Wolfhall (14970 in chips) is sitting out
Seat 4: Blackmamba1878 (14970 in chips) is sitting out
Seat 5: Devilhead68 (14930 in chips)
Seat 6: Alfil58 (14050 in chips)
Seat 7: pennsylvanius (11390 in chips)
Seat 8: kato2011974 (14740 in chips)
Seat 9: Mmgoncalo (19685 in chips)
Mmgoncalo: posts small blind 25
jeje_sat: posts big blind 50
*** HOLE CARDS ***
Dealt to jeje_sat [Ac 3s]
mo1012: calls 50
Wolfhall: folds
Blackmamba1878: folds
Devilhead68: folds
Alfil58: raises 50 to 100
pennsylvanius: raises 11290 to 11390 and is all-in
kato2011974: folds
Mmgoncalo: folds
jeje_sat: folds
mo1012: folds
Alfil58: folds
Uncalled bet (11290) returned to pennsylvanius
pennsylvanius collected 325 from pot
pennsylvanius: doesn't show hand
*** SUMMARY ***
Total pot 325 | Rake 0
Seat 1: jeje_sat (big blind) folded before Flop
Seat 2: mo1012 folded before Flop
Seat 3: Wolfhall folded before Flop (didn't bet)
Seat 4: Blackmamba1878 folded before Flop (didn't bet)
Seat 5: Devilhead68 folded before Flop (didn't bet)
Seat 6: Alfil58 folded before Flop
Seat 7: pennsylvanius collected (325)
Seat 8: kato2011974 (button) folded before Flop (didn't bet)
Seat 9: Mmgoncalo (small blind) folded before Flop


PokerStars Hand #229772904362: Tournament #3255385918, Freeroll  Hold'em No Limit - Level IV (25/50) - 2021/09/11 21:24:55 CET [2021/09/11 15:24:55 ET]
Table '3255385918 432' 9-max Seat #9 is the button
Seat 1: jeje_sat (13915 in chips)
Seat 2: mo1012 (16250 in chips)
Seat 3: Wolfhall (14970 in chips) is sitting out
Seat 4: Blackmamba1878 (14970 in chips) is sitting out
Seat 5: Devilhead68 (14930 in chips)
Seat 6: Alfil58 (13950 in chips)
Seat 7: pennsylvanius (11615 in chips)
Seat 8: kato2011974 (14740 in chips)
Seat 9: Mmgoncalo (19660 in chips)
jeje_sat: posts small blind 25
mo1012: posts big blind 50
*** HOLE CARDS ***
Dealt to jeje_sat [9c 5c]
Wolfhall: folds
Blackmamba1878: folds
Devilhead68: folds
Alfil58: calls 50
pennsylvanius: raises 11565 to 11615 and is all-in
kato2011974: folds
Mmgoncalo: folds
jeje_sat: folds
mo1012: folds
Alfil58: folds
Uncalled bet (11565) returned to pennsylvanius
pennsylvanius collected 175 from pot
pennsylvanius: doesn't show hand
*** SUMMARY ***
Total pot 175 | Rake 0
Seat 1: jeje_sat (small blind) folded before Flop
Seat 2: mo1012 (big blind) folded before Flop
Seat 3: Wolfhall folded before Flop (didn't bet)
Seat 4: Blackmamba1878 folded before Flop (didn't bet)
Seat 5: Devilhead68 folded before Flop (didn't bet)
Seat 6: Alfil58 folded before Flop
Seat 7: pennsylvanius collected (175)
Seat 8: kato2011974 folded before Flop (didn't bet)
Seat 9: Mmgoncalo (button) folded before Flop (didn't bet)


PokerStars Hand #229772930895: Tournament #3255385918, Freeroll  Hold'em No Limit - Level IV (25/50) - 2021/09/11 21:25:34 CET [2021/09/11 15:25:34 ET]
Table '3255385918 432' 9-max Seat #1 is the button
Seat 1: jeje_sat (13890 in chips)
Seat 2: mo1012 (16200 in chips)
Seat 3: Wolfhall (14970 in chips) is sitting out
Seat 4: Blackmamba1878 (14970 in chips) is sitting out
Seat 5: Devilhead68 (14930 in chips)
Seat 6: Alfil58 (13900 in chips)
Seat 7: pennsylvanius (11740 in chips)
Seat 8: kato2011974 (14740 in chips)
Seat 9: Mmgoncalo (19660 in chips)
mo1012: posts small blind 25
Wolfhall: posts big blind 50
*** HOLE CARDS ***
Dealt to jeje_sat [Ad 5c]
Blackmamba1878: folds
Devilhead68: calls 50
Alfil58: folds
pennsylvanius: calls 50
kato2011974: folds
Mmgoncalo: folds
jeje_sat: raises 100 to 150
mo1012: folds
Wolfhall: folds
Devilhead68: calls 100
Blackmamba1878 is disconnected
pennsylvanius: calls 100
*** FLOP *** [Kd Qh 3d]
Devilhead68: checks
pennsylvanius: checks
jeje_sat: checks
*** TURN *** [Kd Qh 3d] [9d]
Devilhead68: checks
pennsylvanius: bets 50
jeje_sat: calls 50
Devilhead68: calls 50
*** RIVER *** [Kd Qh 3d 9d] [2c]
Devilhead68: checks
Blackmamba1878 has returned
pennsylvanius is disconnected
pennsylvanius has timed out while disconnected
pennsylvanius: checks
jeje_sat: bets 338
Devilhead68: calls 338
pennsylvanius has timed out while disconnected
pennsylvanius: folds
pennsylvanius is sitting out
*** SHOW DOWN ***
jeje_sat: shows [Ad 5c] (high card Ace)
Devilhead68: shows [Jc Qc] (a pair of Queens)
Devilhead68 collected 1351 from pot
*** SUMMARY ***
Total pot 1351 | Rake 0
Board [Kd Qh 3d 9d 2c]
Seat 1: jeje_sat (button) showed [Ad 5c] and lost with high card Ace
Seat 2: mo1012 (small blind) folded before Flop
Seat 3: Wolfhall (big blind) folded before Flop
Seat 4: Blackmamba1878 folded before Flop (didn't bet)
Seat 5: Devilhead68 showed [Jc Qc] and won (1351) with a pair of Queens
Seat 6: Alfil58 folded before Flop (didn't bet)
Seat 7: pennsylvanius folded on the River
Seat 8: kato2011974 folded before Flop (didn't bet)
Seat 9: Mmgoncalo folded before Flop (didn't bet)


PokerStars Hand #229773019322: Tournament #3255385918, Freeroll  Hold'em No Limit - Level V (30/60) - 2021/09/11 21:28:18 CET [2021/09/11 15:28:18 ET]
Table '3255385918 432' 9-max Seat #2 is the button
Seat 1: jeje_sat (13352 in chips)
Seat 2: mo1012 (16175 in chips)
Seat 3: Wolfhall (14920 in chips) is sitting out
Seat 4: Blackmamba1878 (14970 in chips)
Seat 5: Devilhead68 (15743 in chips)
Seat 6: Alfil58 (13900 in chips)
Seat 7: pennsylvanius (11540 in chips) is sitting out
Seat 8: kato2011974 (14740 in chips)
Seat 9: Mmgoncalo (19660 in chips)
jeje_sat: posts the ante 5
mo1012: posts the ante 5
Wolfhall: posts the ante 5
Blackmamba1878: posts the ante 5
Devilhead68: posts the ante 5
Alfil58: posts the ante 5
pennsylvanius: posts the ante 5
kato2011974: posts the ante 5
Mmgoncalo: posts the ante 5
Wolfhall: posts small blind 30
Blackmamba1878: posts big blind 60
*** HOLE CARDS ***
Dealt to jeje_sat [6s 7c]
Devilhead68: folds
Alfil58: calls 60
pennsylvanius: folds
kato2011974: folds
Mmgoncalo: raises 600 to 660
jeje_sat: folds
pennsylvanius has returned
mo1012: folds
Wolfhall: folds
Blackmamba1878: raises 1560 to 2220
Alfil58: folds
Mmgoncalo: calls 1560
*** FLOP *** [Js 3d Jd]
Blackmamba1878: bets 2820
Mmgoncalo: folds
Uncalled bet (2820) returned to Blackmamba1878
Blackmamba1878 collected 4575 from pot
Blackmamba1878: doesn't show hand
*** SUMMARY ***
Total pot 4575 | Rake 0
Board [Js 3d Jd]
Seat 1: jeje_sat folded before Flop (didn't bet)
Seat 2: mo1012 (button) folded before Flop (didn't bet)
Seat 3: Wolfhall (small blind) folded before Flop
Seat 4: Blackmamba1878 (big blind) collected (4575)
Seat 5: Devilhead68 folded before Flop (didn't bet)
Seat 6: Alfil58 folded before Flop
Seat 7: pennsylvanius folded before Flop (didn't bet)
Seat 8: kato2011974 folded before Flop (didn't bet)
Seat 9: Mmgoncalo folded on the Flop


PokerStars Hand #229773048489: Tournament #3255385918, Freeroll  Hold'em No Limit - Level V (30/60) - 2021/09/11 21:29:12 CET [2021/09/11 15:29:12 ET]
Table '3255385918 432' 9-max Seat #3 is the button
Seat 1: jeje_sat (13347 in chips)
Seat 2: mo1012 (16170 in chips)
Seat 3: Wolfhall (14885 in chips) is sitting out
Seat 4: Blackmamba1878 (17320 in chips)
Seat 5: Devilhead68 (15738 in chips)
Seat 6: Alfil58 (13835 in chips)
Seat 7: pennsylvanius (11535 in chips)
Seat 8: kato2011974 (14735 in chips)
Seat 9: Mmgoncalo (17435 in chips)
jeje_sat: posts the ante 5
mo1012: posts the ante 5
Wolfhall: posts the ante 5
Blackmamba1878: posts the ante 5
Devilhead68: posts the ante 5
Alfil58: posts the ante 5
pennsylvanius: posts the ante 5
kato2011974: posts the ante 5
Mmgoncalo: posts the ante 5
Blackmamba1878: posts small blind 30
Devilhead68: posts big blind 60
*** HOLE CARDS ***
Dealt to jeje_sat [2s 9d]
Alfil58: calls 60
pennsylvanius: raises 11470 to 11530 and is all-in
kato2011974: folds
Mmgoncalo: calls 11530
jeje_sat: folds
mo1012: folds
Wolfhall: folds
Blackmamba1878: folds
Devilhead68: folds
Alfil58: folds
*** FLOP *** [3h 4d 6c]
*** TURN *** [3h 4d 6c] [Qh]
*** RIVER *** [3h 4d 6c Qh] [Th]
*** SHOW DOWN ***
pennsylvanius: shows [As 8s] (high card Ace)
Mmgoncalo: shows [Tc Ts] (three of a kind, Tens)
Mmgoncalo collected 23255 from pot
pennsylvanius finished the tournament
*** SUMMARY ***
Total pot 23255 | Rake 0
Board [3h 4d 6c Qh Th]
Seat 1: jeje_sat folded before Flop (didn't bet)
Seat 2: mo1012 folded before Flop (didn't bet)
Seat 3: Wolfhall (button) folded before Flop (didn't bet)
Seat 4: Blackmamba1878 (small blind) folded before Flop
Seat 5: Devilhead68 (big blind) folded before Flop
Seat 6: Alfil58 folded before Flop
Seat 7: pennsylvanius showed [As 8s] and lost with high card Ace
Seat 8: kato2011974 folded before Flop (didn't bet)
Seat 9: Mmgoncalo showed [Tc Ts] and won (23255) with three of a kind, Tens


PokerStars Hand #229773072887: Tournament #3255385918, Freeroll  Hold'em No Limit - Level V (30/60) - 2021/09/11 21:29:57 CET [2021/09/11 15:29:57 ET]
Table '3255385918 432' 9-max Seat #4 is the button
Seat 1: jeje_sat (13342 in chips)
Seat 2: mo1012 (16165 in chips)
Seat 3: Wolfhall (14880 in chips) is sitting out
Seat 4: Blackmamba1878 (17285 in chips)
Seat 5: Devilhead68 (15673 in chips)
Seat 6: Alfil58 (13770 in chips)
Seat 8: kato2011974 (14730 in chips)
Seat 9: Mmgoncalo (29155 in chips)
jeje_sat: posts the ante 5
mo1012: posts the ante 5
Wolfhall: posts the ante 5
Blackmamba1878: posts the ante 5
Devilhead68: posts the ante 5
Alfil58: posts the ante 5
kato2011974: posts the ante 5
Mmgoncalo: posts the ante 5
Devilhead68: posts small blind 30
Alfil58: posts big blind 60
*** HOLE CARDS ***
Dealt to jeje_sat [Kd Ah]
kato2011974: raises 60 to 120
Mmgoncalo: folds
jeje_sat: raises 240 to 360
mo1012: folds
Wolfhall: folds
Blackmamba1878: folds
Devilhead68: folds
Alfil58: folds
kato2011974: folds
Uncalled bet (240) returned to jeje_sat
jeje_sat collected 370 from pot
jeje_sat: doesn't show hand
*** SUMMARY ***
Total pot 370 | Rake 0
Seat 1: jeje_sat collected (370)
Seat 2: mo1012 folded before Flop (didn't bet)
Seat 3: Wolfhall folded before Flop (didn't bet)
Seat 4: Blackmamba1878 (button) folded before Flop (didn't bet)
Seat 5: Devilhead68 (small blind) folded before Flop
Seat 6: Alfil58 (big blind) folded before Flop
Seat 8: kato2011974 folded before Flop
Seat 9: Mmgoncalo folded before Flop (didn't bet)


PokerStars Hand #229773098837: Tournament #3255385918, Freeroll  Hold'em No Limit - Level VI (40/80) - 2021/09/11 21:30:44 CET [2021/09/11 15:30:44 ET]
Table '3255385918 432' 9-max Seat #5 is the button
Seat 1: jeje_sat (13587 in chips)
Seat 2: mo1012 (16160 in chips)
Seat 3: Wolfhall (14875 in chips) is sitting out
Seat 4: Blackmamba1878 (17280 in chips)
Seat 5: Devilhead68 (15638 in chips)
Seat 6: Alfil58 (13705 in chips)
Seat 7: titi_titel88 (15000 in chips)
Seat 8: kato2011974 (14605 in chips)
Seat 9: Mmgoncalo (29150 in chips)
jeje_sat: posts the ante 10
mo1012: posts the ante 10
Wolfhall: posts the ante 10
Blackmamba1878: posts the ante 10
Devilhead68: posts the ante 10
Alfil58: posts the ante 10
titi_titel88: posts the ante 10
kato2011974: posts the ante 10
Mmgoncalo: posts the ante 10
Alfil58: posts small blind 40
titi_titel88: posts big blind 80
*** HOLE CARDS ***
Dealt to jeje_sat [Qc As]
kato2011974: raises 80 to 160
Mmgoncalo: folds
jeje_sat: raises 320 to 480
mo1012: folds
Wolfhall: folds
Blackmamba1878: folds
Devilhead68: folds
Alfil58: calls 440
titi_titel88: raises 5600 to 6080
kato2011974: raises 8515 to 14595 and is all-in
jeje_sat: calls 13097 and is all-in
Alfil58: folds
titi_titel88: calls 8515
*** FLOP *** [Jh 4s Qd]
*** TURN *** [Jh 4s Qd] [9c]
*** RIVER *** [Jh 4s Qd 9c] [7d]
*** SHOW DOWN ***
titi_titel88: shows [Kh Kd] (a pair of Kings)
kato2011974: shows [Th Ts] (a pair of Tens)
titi_titel88 collected 2036 from side pot
jeje_sat: shows [Qc As] (a pair of Queens)
titi_titel88 collected 41301 from main pot
*** SUMMARY ***
Total pot 43337 Main pot 41301. Side pot 2036. | Rake 0
Board [Jh 4s Qd 9c 7d]
Seat 1: jeje_sat showed [Qc As] and lost with a pair of Queens
Seat 2: mo1012 folded before Flop (didn't bet)
Seat 3: Wolfhall folded before Flop (didn't bet)
Seat 4: Blackmamba1878 folded before Flop (didn't bet)
Seat 5: Devilhead68 (button) folded before Flop (didn't bet)
Seat 6: Alfil58 (small blind) folded before Flop
Seat 7: titi_titel88 (big blind) showed [Kh Kd] and won (43337) with a pair of Kings
Seat 8: kato2011974 showed [Th Ts] and lost with a pair of Tens
Seat 9: Mmgoncalo folded before Flop (didn't bet)


