PokerStars Hand #229694113779: Tournament #3253260637, €4.50+€4.50+€1.00 EUR Hold'em No Limit - Level III (75/150) - 2021/09/08 21:03:02 CET [2021/09/08 15:03:02 ET]
Table '3253260637 211' 9-max Seat #1 is the button
Seat 1: rogernu7 (19417 in chips, €6.75 bounty)
Seat 2: Aymeric 6186 (20619 in chips, €6.75 bounty)
Seat 3: Troll-In1990 (10435 in chips, €4.50 bounty)
Seat 4: saperevedere (18140 in chips, €4.50 bounty)
Seat 5: mateuss771 (10000 in chips, €4.50 bounty)
Seat 6: savin.hsp (8364 in chips, €4.50 bounty)
Seat 7: RafaPradoQJ (10000 in chips, €4.50 bounty)
Seat 8: jeje_sat (10000 in chips, €4.50 bounty)
Seat 9: CHIPSCRAZYYY (10000 in chips, €4.50 bounty)
rogernu7: posts the ante 20
Aymeric 6186: posts the ante 20
Troll-In1990: posts the ante 20
saperevedere: posts the ante 20
mateuss771: posts the ante 20
savin.hsp: posts the ante 20
RafaPradoQJ: posts the ante 20
jeje_sat: posts the ante 20
CHIPSCRAZYYY: posts the ante 20
Aymeric 6186: posts small blind 75
Troll-In1990: posts big blind 150
*** HOLE CARDS ***
Dealt to jeje_sat [Th 7h]
saperevedere: folds
mateuss771: folds
savin.hsp: folds
RafaPradoQJ: raises 150 to 300
jeje_sat: folds
CHIPSCRAZYYY: folds
rogernu7: folds
Aymeric 6186: folds
Troll-In1990: calls 150
*** FLOP *** [Ac 6d Jc]
Troll-In1990: checks
RafaPradoQJ: bets 282
Troll-In1990: calls 282
*** TURN *** [Ac 6d Jc] [Td]
Troll-In1990: checks
RafaPradoQJ: checks
*** RIVER *** [Ac 6d Jc Td] [Qd]
Troll-In1990: bets 710
RafaPradoQJ: folds
Uncalled bet (710) returned to Troll-In1990
Troll-In1990 collected 1419 from pot
Troll-In1990: doesn't show hand
*** SUMMARY ***
Total pot 1419 | Rake 0
Board [Ac 6d Jc Td Qd]
Seat 1: rogernu7 (button) folded before Flop (didn't bet)
Seat 2: Aymeric 6186 (small blind) folded before Flop
Seat 3: Troll-In1990 (big blind) collected (1419)
Seat 4: saperevedere folded before Flop (didn't bet)
Seat 5: mateuss771 folded before Flop (didn't bet)
Seat 6: savin.hsp folded before Flop (didn't bet)
Seat 7: RafaPradoQJ folded on the River
Seat 8: jeje_sat folded before Flop (didn't bet)
Seat 9: CHIPSCRAZYYY folded before Flop (didn't bet)


PokerStars Hand #229694155044: Tournament #3253260637, €4.50+€4.50+€1.00 EUR Hold'em No Limit - Level IV (100/200) - 2021/09/08 21:04:30 CET [2021/09/08 15:04:30 ET]
Table '3253260637 211' 9-max Seat #2 is the button
Seat 1: rogernu7 (19397 in chips, €6.75 bounty)
Seat 2: Aymeric 6186 (20524 in chips, €6.75 bounty)
Seat 3: Troll-In1990 (11252 in chips, €4.50 bounty)
Seat 4: saperevedere (18120 in chips, €4.50 bounty)
Seat 5: mateuss771 (9980 in chips, €4.50 bounty)
Seat 6: savin.hsp (8344 in chips, €4.50 bounty)
Seat 7: RafaPradoQJ (9398 in chips, €4.50 bounty)
Seat 8: jeje_sat (9980 in chips, €4.50 bounty)
Seat 9: CHIPSCRAZYYY (9980 in chips, €4.50 bounty)
rogernu7: posts the ante 25
Aymeric 6186: posts the ante 25
Troll-In1990: posts the ante 25
saperevedere: posts the ante 25
mateuss771: posts the ante 25
savin.hsp: posts the ante 25
RafaPradoQJ: posts the ante 25
jeje_sat: posts the ante 25
CHIPSCRAZYYY: posts the ante 25
Troll-In1990: posts small blind 100
saperevedere: posts big blind 200
*** HOLE CARDS ***
Dealt to jeje_sat [2s 5d]
mateuss771: folds
savin.hsp: folds
RafaPradoQJ: raises 200 to 400
jeje_sat: folds
CHIPSCRAZYYY: folds
rogernu7: calls 400
Aymeric 6186: folds
Troll-In1990: folds
saperevedere: calls 200
*** FLOP *** [9h 4d 9s]
saperevedere: checks
RafaPradoQJ: checks
rogernu7: checks
*** TURN *** [9h 4d 9s] [2d]
saperevedere: bets 200
RafaPradoQJ: calls 200
rogernu7: raises 638 to 838
saperevedere: folds
RafaPradoQJ: folds
Uncalled bet (638) returned to rogernu7
rogernu7 collected 2125 from pot
*** SUMMARY ***
Total pot 2125 | Rake 0
Board [9h 4d 9s 2d]
Seat 1: rogernu7 collected (2125)
Seat 2: Aymeric 6186 (button) folded before Flop (didn't bet)
Seat 3: Troll-In1990 (small blind) folded before Flop
Seat 4: saperevedere (big blind) folded on the Turn
Seat 5: mateuss771 folded before Flop (didn't bet)
Seat 6: savin.hsp folded before Flop (didn't bet)
Seat 7: RafaPradoQJ folded on the Turn
Seat 8: jeje_sat folded before Flop (didn't bet)
Seat 9: CHIPSCRAZYYY folded before Flop (didn't bet)


PokerStars Hand #229694194505: Tournament #3253260637, €4.50+€4.50+€1.00 EUR Hold'em No Limit - Level IV (100/200) - 2021/09/08 21:05:52 CET [2021/09/08 15:05:52 ET]
Table '3253260637 211' 9-max Seat #3 is the button
Seat 1: rogernu7 (20897 in chips, €6.75 bounty)
Seat 2: Aymeric 6186 (20499 in chips, €6.75 bounty)
Seat 3: Troll-In1990 (11127 in chips, €4.50 bounty)
Seat 4: saperevedere (17495 in chips, €4.50 bounty)
Seat 5: mateuss771 (9955 in chips, €4.50 bounty)
Seat 6: savin.hsp (8319 in chips, €4.50 bounty)
Seat 7: RafaPradoQJ (8773 in chips, €4.50 bounty)
Seat 8: jeje_sat (9955 in chips, €4.50 bounty)
Seat 9: CHIPSCRAZYYY (9955 in chips, €4.50 bounty)
rogernu7: posts the ante 25
Aymeric 6186: posts the ante 25
Troll-In1990: posts the ante 25
saperevedere: posts the ante 25
mateuss771: posts the ante 25
savin.hsp: posts the ante 25
RafaPradoQJ: posts the ante 25
jeje_sat: posts the ante 25
CHIPSCRAZYYY: posts the ante 25
saperevedere: posts small blind 100
mateuss771: posts big blind 200
*** HOLE CARDS ***
Dealt to jeje_sat [Jc 9d]
savin.hsp: folds
RafaPradoQJ: folds
jeje_sat: folds
CHIPSCRAZYYY: raises 200 to 400
rogernu7: folds
Aymeric 6186: folds
Troll-In1990: folds
saperevedere: folds
mateuss771: folds
Uncalled bet (200) returned to CHIPSCRAZYYY
CHIPSCRAZYYY collected 725 from pot
CHIPSCRAZYYY: doesn't show hand
*** SUMMARY ***
Total pot 725 | Rake 0
Seat 1: rogernu7 folded before Flop (didn't bet)
Seat 2: Aymeric 6186 folded before Flop (didn't bet)
Seat 3: Troll-In1990 (button) folded before Flop (didn't bet)
Seat 4: saperevedere (small blind) folded before Flop
Seat 5: mateuss771 (big blind) folded before Flop
Seat 6: savin.hsp folded before Flop (didn't bet)
Seat 7: RafaPradoQJ folded before Flop (didn't bet)
Seat 8: jeje_sat folded before Flop (didn't bet)
Seat 9: CHIPSCRAZYYY collected (725)


PokerStars Hand #229694210546: Tournament #3253260637, €4.50+€4.50+€1.00 EUR Hold'em No Limit - Level IV (100/200) - 2021/09/08 21:06:25 CET [2021/09/08 15:06:25 ET]
Table '3253260637 211' 9-max Seat #4 is the button
Seat 1: rogernu7 (20872 in chips, €6.75 bounty)
Seat 2: Aymeric 6186 (20474 in chips, €6.75 bounty)
Seat 3: Troll-In1990 (11102 in chips, €4.50 bounty)
Seat 4: saperevedere (17370 in chips, €4.50 bounty)
Seat 5: mateuss771 (9730 in chips, €4.50 bounty)
Seat 6: savin.hsp (8294 in chips, €4.50 bounty)
Seat 7: RafaPradoQJ (8748 in chips, €4.50 bounty)
Seat 8: jeje_sat (9930 in chips, €4.50 bounty)
Seat 9: CHIPSCRAZYYY (10455 in chips, €4.50 bounty)
rogernu7: posts the ante 25
Aymeric 6186: posts the ante 25
Troll-In1990: posts the ante 25
saperevedere: posts the ante 25
mateuss771: posts the ante 25
savin.hsp: posts the ante 25
RafaPradoQJ: posts the ante 25
jeje_sat: posts the ante 25
CHIPSCRAZYYY: posts the ante 25
mateuss771: posts small blind 100
savin.hsp: posts big blind 200
*** HOLE CARDS ***
Dealt to jeje_sat [8s 2s]
RafaPradoQJ: raises 200 to 400
jeje_sat: folds
CHIPSCRAZYYY: folds
rogernu7: folds
Aymeric 6186: folds
Troll-In1990: raises 200 to 600
saperevedere: folds
mateuss771: folds
savin.hsp: folds
RafaPradoQJ: calls 200
*** FLOP *** [6c Kh 6s]
RafaPradoQJ: checks
Troll-In1990: bets 762
RafaPradoQJ: folds
Uncalled bet (762) returned to Troll-In1990
Troll-In1990 collected 1725 from pot
Troll-In1990: doesn't show hand
*** SUMMARY ***
Total pot 1725 | Rake 0
Board [6c Kh 6s]
Seat 1: rogernu7 folded before Flop (didn't bet)
Seat 2: Aymeric 6186 folded before Flop (didn't bet)
Seat 3: Troll-In1990 collected (1725)
Seat 4: saperevedere (button) folded before Flop (didn't bet)
Seat 5: mateuss771 (small blind) folded before Flop
Seat 6: savin.hsp (big blind) folded before Flop
Seat 7: RafaPradoQJ folded on the Flop
Seat 8: jeje_sat folded before Flop (didn't bet)
Seat 9: CHIPSCRAZYYY folded before Flop (didn't bet)


PokerStars Hand #229694249299: Tournament #3253260637, €4.50+€4.50+€1.00 EUR Hold'em No Limit - Level IV (100/200) - 2021/09/08 21:07:43 CET [2021/09/08 15:07:43 ET]
Table '3253260637 211' 9-max Seat #5 is the button
Seat 1: rogernu7 (20847 in chips, €6.75 bounty)
Seat 2: Aymeric 6186 (20449 in chips, €6.75 bounty)
Seat 3: Troll-In1990 (12202 in chips, €4.50 bounty)
Seat 4: saperevedere (17345 in chips, €4.50 bounty)
Seat 5: mateuss771 (9605 in chips, €4.50 bounty)
Seat 6: savin.hsp (8069 in chips, €4.50 bounty)
Seat 7: RafaPradoQJ (8123 in chips, €4.50 bounty)
Seat 8: jeje_sat (9905 in chips, €4.50 bounty)
Seat 9: CHIPSCRAZYYY (10430 in chips, €4.50 bounty)
rogernu7: posts the ante 25
Aymeric 6186: posts the ante 25
Troll-In1990: posts the ante 25
saperevedere: posts the ante 25
mateuss771: posts the ante 25
savin.hsp: posts the ante 25
RafaPradoQJ: posts the ante 25
jeje_sat: posts the ante 25
CHIPSCRAZYYY: posts the ante 25
savin.hsp: posts small blind 100
RafaPradoQJ: posts big blind 200
*** HOLE CARDS ***
Dealt to jeje_sat [9h 7s]
jeje_sat: folds
CHIPSCRAZYYY: folds
rogernu7: folds
Aymeric 6186: folds
Troll-In1990: calls 200
saperevedere: folds
mateuss771: raises 800 to 1000
savin.hsp: folds
RafaPradoQJ: calls 800
Troll-In1990: folds
*** FLOP *** [7h Ah Ks]
RafaPradoQJ: checks
mateuss771: bets 631
RafaPradoQJ: calls 631
*** TURN *** [7h Ah Ks] [7d]
RafaPradoQJ: checks
mateuss771: checks
*** RIVER *** [7h Ah Ks 7d] [Js]
RafaPradoQJ: checks
mateuss771: checks
*** SHOW DOWN ***
RafaPradoQJ: shows [Jc Ac] (two pair, Aces and Jacks)
mateuss771: mucks hand
RafaPradoQJ collected 3787 from pot
*** SUMMARY ***
Total pot 3787 | Rake 0
Board [7h Ah Ks 7d Js]
Seat 1: rogernu7 folded before Flop (didn't bet)
Seat 2: Aymeric 6186 folded before Flop (didn't bet)
Seat 3: Troll-In1990 folded before Flop
Seat 4: saperevedere folded before Flop (didn't bet)
Seat 5: mateuss771 (button) mucked [Th Tc]
Seat 6: savin.hsp (small blind) folded before Flop
Seat 7: RafaPradoQJ (big blind) showed [Jc Ac] and won (3787) with two pair, Aces and Jacks
Seat 8: jeje_sat folded before Flop (didn't bet)
Seat 9: CHIPSCRAZYYY folded before Flop (didn't bet)


PokerStars Hand #229694292097: Tournament #3253260637, €4.50+€4.50+€1.00 EUR Hold'em No Limit - Level IV (100/200) - 2021/09/08 21:09:11 CET [2021/09/08 15:09:11 ET]
Table '3253260637 211' 9-max Seat #6 is the button
Seat 1: rogernu7 (20822 in chips, €6.75 bounty)
Seat 2: Aymeric 6186 (20424 in chips, €6.75 bounty)
Seat 3: Troll-In1990 (11977 in chips, €4.50 bounty)
Seat 4: saperevedere (17320 in chips, €4.50 bounty)
Seat 5: mateuss771 (7949 in chips, €4.50 bounty)
Seat 6: savin.hsp (7944 in chips, €4.50 bounty)
Seat 7: RafaPradoQJ (10254 in chips, €4.50 bounty)
Seat 8: jeje_sat (9880 in chips, €4.50 bounty)
Seat 9: CHIPSCRAZYYY (10405 in chips, €4.50 bounty)
rogernu7: posts the ante 25
Aymeric 6186: posts the ante 25
Troll-In1990: posts the ante 25
saperevedere: posts the ante 25
mateuss771: posts the ante 25
savin.hsp: posts the ante 25
RafaPradoQJ: posts the ante 25
jeje_sat: posts the ante 25
CHIPSCRAZYYY: posts the ante 25
RafaPradoQJ: posts small blind 100
jeje_sat: posts big blind 200
*** HOLE CARDS ***
Dealt to jeje_sat [5c 4d]
CHIPSCRAZYYY: folds
rogernu7: raises 200 to 400
Aymeric 6186: folds
Troll-In1990: calls 400
saperevedere: folds
mateuss771: folds
savin.hsp: folds
RafaPradoQJ: folds
jeje_sat: folds
*** FLOP *** [Ks 6c Jh]
rogernu7: checks
Troll-In1990: bets 635
rogernu7: folds
Uncalled bet (635) returned to Troll-In1990
Troll-In1990 collected 1325 from pot
Troll-In1990: doesn't show hand
*** SUMMARY ***
Total pot 1325 | Rake 0
Board [Ks 6c Jh]
Seat 1: rogernu7 folded on the Flop
Seat 2: Aymeric 6186 folded before Flop (didn't bet)
Seat 3: Troll-In1990 collected (1325)
Seat 4: saperevedere folded before Flop (didn't bet)
Seat 5: mateuss771 folded before Flop (didn't bet)
Seat 6: savin.hsp (button) folded before Flop (didn't bet)
Seat 7: RafaPradoQJ (small blind) folded before Flop
Seat 8: jeje_sat (big blind) folded before Flop
Seat 9: CHIPSCRAZYYY folded before Flop (didn't bet)


PokerStars Hand #229694332157: Tournament #3253260637, €4.50+€4.50+€1.00 EUR Hold'em No Limit - Level IV (100/200) - 2021/09/08 21:10:32 CET [2021/09/08 15:10:32 ET]
Table '3253260637 211' 9-max Seat #7 is the button
Seat 1: rogernu7 (20397 in chips, €6.75 bounty)
Seat 2: Aymeric 6186 (20399 in chips, €6.75 bounty)
Seat 3: Troll-In1990 (12877 in chips, €4.50 bounty)
Seat 4: saperevedere (17295 in chips, €4.50 bounty)
Seat 5: mateuss771 (7924 in chips, €4.50 bounty)
Seat 6: savin.hsp (7919 in chips, €4.50 bounty)
Seat 7: RafaPradoQJ (10129 in chips, €4.50 bounty)
Seat 8: jeje_sat (9655 in chips, €4.50 bounty)
Seat 9: CHIPSCRAZYYY (10380 in chips, €4.50 bounty)
rogernu7: posts the ante 25
Aymeric 6186: posts the ante 25
Troll-In1990: posts the ante 25
saperevedere: posts the ante 25
mateuss771: posts the ante 25
savin.hsp: posts the ante 25
RafaPradoQJ: posts the ante 25
jeje_sat: posts the ante 25
CHIPSCRAZYYY: posts the ante 25
jeje_sat: posts small blind 100
CHIPSCRAZYYY: posts big blind 200
*** HOLE CARDS ***
Dealt to jeje_sat [Kh Tc]
rogernu7: raises 300 to 500
Aymeric 6186: folds
Troll-In1990: folds
saperevedere: folds
mateuss771: folds
savin.hsp: folds
RafaPradoQJ: folds
jeje_sat: calls 400
CHIPSCRAZYYY: folds
*** FLOP *** [8d 8s Js]
jeje_sat: checks
rogernu7: bets 428
jeje_sat: folds
Uncalled bet (428) returned to rogernu7
rogernu7 collected 1425 from pot
*** SUMMARY ***
Total pot 1425 | Rake 0
Board [8d 8s Js]
Seat 1: rogernu7 collected (1425)
Seat 2: Aymeric 6186 folded before Flop (didn't bet)
Seat 3: Troll-In1990 folded before Flop (didn't bet)
Seat 4: saperevedere folded before Flop (didn't bet)
Seat 5: mateuss771 folded before Flop (didn't bet)
Seat 6: savin.hsp folded before Flop (didn't bet)
Seat 7: RafaPradoQJ (button) folded before Flop (didn't bet)
Seat 8: jeje_sat (small blind) folded on the Flop
Seat 9: CHIPSCRAZYYY (big blind) folded before Flop


PokerStars Hand #229694370777: Tournament #3253260637, €4.50+€4.50+€1.00 EUR Hold'em No Limit - Level IV (100/200) - 2021/09/08 21:11:42 CET [2021/09/08 15:11:42 ET]
Table '3253260637 211' 9-max Seat #8 is the button
Seat 1: rogernu7 (21297 in chips, €6.75 bounty)
Seat 2: Aymeric 6186 (20374 in chips, €6.75 bounty)
Seat 3: Troll-In1990 (12852 in chips, €4.50 bounty)
Seat 4: saperevedere (17270 in chips, €4.50 bounty)
Seat 5: mateuss771 (7899 in chips, €4.50 bounty)
Seat 6: savin.hsp (7894 in chips, €4.50 bounty)
Seat 7: RafaPradoQJ (10104 in chips, €4.50 bounty)
Seat 8: jeje_sat (9130 in chips, €4.50 bounty)
Seat 9: CHIPSCRAZYYY (10155 in chips, €4.50 bounty)
rogernu7: posts the ante 25
Aymeric 6186: posts the ante 25
Troll-In1990: posts the ante 25
saperevedere: posts the ante 25
mateuss771: posts the ante 25
savin.hsp: posts the ante 25
RafaPradoQJ: posts the ante 25
jeje_sat: posts the ante 25
CHIPSCRAZYYY: posts the ante 25
CHIPSCRAZYYY: posts small blind 100
rogernu7: posts big blind 200
*** HOLE CARDS ***
Dealt to jeje_sat [3d 2d]
Aymeric 6186: folds
Troll-In1990: folds
saperevedere: folds
mateuss771: folds
savin.hsp: folds
RafaPradoQJ: folds
jeje_sat: calls 200
CHIPSCRAZYYY: raises 500 to 700
rogernu7: folds
jeje_sat: folds
Uncalled bet (500) returned to CHIPSCRAZYYY
CHIPSCRAZYYY collected 825 from pot
CHIPSCRAZYYY: doesn't show hand
*** SUMMARY ***
Total pot 825 | Rake 0
Seat 1: rogernu7 (big blind) folded before Flop
Seat 2: Aymeric 6186 folded before Flop (didn't bet)
Seat 3: Troll-In1990 folded before Flop (didn't bet)
Seat 4: saperevedere folded before Flop (didn't bet)
Seat 5: mateuss771 folded before Flop (didn't bet)
Seat 6: savin.hsp folded before Flop (didn't bet)
Seat 7: RafaPradoQJ folded before Flop (didn't bet)
Seat 8: jeje_sat (button) folded before Flop
Seat 9: CHIPSCRAZYYY (small blind) collected (825)


PokerStars Hand #229694387973: Tournament #3253260637, €4.50+€4.50+€1.00 EUR Hold'em No Limit - Level IV (100/200) - 2021/09/08 21:12:17 CET [2021/09/08 15:12:17 ET]
Table '3253260637 211' 9-max Seat #9 is the button
Seat 1: rogernu7 (21072 in chips, €6.75 bounty)
Seat 2: Aymeric 6186 (20349 in chips, €6.75 bounty)
Seat 3: Troll-In1990 (12827 in chips, €4.50 bounty)
Seat 4: saperevedere (17245 in chips, €4.50 bounty)
Seat 5: mateuss771 (7874 in chips, €4.50 bounty)
Seat 6: savin.hsp (7869 in chips, €4.50 bounty)
Seat 7: RafaPradoQJ (10079 in chips, €4.50 bounty)
Seat 8: jeje_sat (8905 in chips, €4.50 bounty)
Seat 9: CHIPSCRAZYYY (10755 in chips, €4.50 bounty)
rogernu7: posts the ante 25
Aymeric 6186: posts the ante 25
Troll-In1990: posts the ante 25
saperevedere: posts the ante 25
mateuss771: posts the ante 25
savin.hsp: posts the ante 25
RafaPradoQJ: posts the ante 25
jeje_sat: posts the ante 25
CHIPSCRAZYYY: posts the ante 25
rogernu7: posts small blind 100
Aymeric 6186: posts big blind 200
*** HOLE CARDS ***
Dealt to jeje_sat [4s 3c]
Troll-In1990: calls 200
saperevedere: folds
mateuss771: folds
savin.hsp: folds
RafaPradoQJ: folds
jeje_sat: folds
CHIPSCRAZYYY: folds
rogernu7: folds
Aymeric 6186: checks
*** FLOP *** [Qd 5c 8c]
Aymeric 6186: checks
Troll-In1990: bets 325
Aymeric 6186: folds
Uncalled bet (325) returned to Troll-In1990
Troll-In1990 collected 725 from pot
Troll-In1990: doesn't show hand
*** SUMMARY ***
Total pot 725 | Rake 0
Board [Qd 5c 8c]
Seat 1: rogernu7 (small blind) folded before Flop
Seat 2: Aymeric 6186 (big blind) folded on the Flop
Seat 3: Troll-In1990 collected (725)
Seat 4: saperevedere folded before Flop (didn't bet)
Seat 5: mateuss771 folded before Flop (didn't bet)
Seat 6: savin.hsp folded before Flop (didn't bet)
Seat 7: RafaPradoQJ folded before Flop (didn't bet)
Seat 8: jeje_sat folded before Flop (didn't bet)
Seat 9: CHIPSCRAZYYY (button) folded before Flop (didn't bet)


PokerStars Hand #229694409868: Tournament #3253260637, €4.50+€4.50+€1.00 EUR Hold'em No Limit - Level V (125/250) - 2021/09/08 21:13:01 CET [2021/09/08 15:13:01 ET]
Table '3253260637 211' 9-max Seat #1 is the button
Seat 1: rogernu7 (20947 in chips, €6.75 bounty)
Seat 2: Aymeric 6186 (20124 in chips, €6.75 bounty)
Seat 3: Troll-In1990 (13327 in chips, €4.50 bounty)
Seat 4: saperevedere (17220 in chips, €4.50 bounty)
Seat 5: mateuss771 (7849 in chips, €4.50 bounty)
Seat 6: savin.hsp (7844 in chips, €4.50 bounty)
Seat 7: RafaPradoQJ (10054 in chips, €4.50 bounty)
Seat 8: jeje_sat (8880 in chips, €4.50 bounty)
Seat 9: CHIPSCRAZYYY (10730 in chips, €4.50 bounty)
rogernu7: posts the ante 30
Aymeric 6186: posts the ante 30
Troll-In1990: posts the ante 30
saperevedere: posts the ante 30
mateuss771: posts the ante 30
savin.hsp: posts the ante 30
RafaPradoQJ: posts the ante 30
jeje_sat: posts the ante 30
CHIPSCRAZYYY: posts the ante 30
Aymeric 6186: posts small blind 125
Troll-In1990: posts big blind 250
*** HOLE CARDS ***
Dealt to jeje_sat [5d Td]
saperevedere: folds
mateuss771: folds
savin.hsp: folds
RafaPradoQJ: folds
jeje_sat: folds
CHIPSCRAZYYY: folds
rogernu7: folds
Aymeric 6186: calls 125
Troll-In1990: raises 670 to 920
Aymeric 6186: calls 670
*** FLOP *** [Tc 2d 3s]
Aymeric 6186: bets 250
Troll-In1990: calls 250
*** TURN *** [Tc 2d 3s] [4h]
Aymeric 6186: checks
Troll-In1990: bets 1250
Aymeric 6186: calls 1250
*** RIVER *** [Tc 2d 3s 4h] [7h]
Aymeric 6186: checks
Troll-In1990: checks
*** SHOW DOWN ***
Aymeric 6186: shows [Ts Jd] (a pair of Tens)
Troll-In1990: mucks hand
Aymeric 6186 collected 5110 from pot
*** SUMMARY ***
Total pot 5110 | Rake 0
Board [Tc 2d 3s 4h 7h]
Seat 1: rogernu7 (button) folded before Flop (didn't bet)
Seat 2: Aymeric 6186 (small blind) showed [Ts Jd] and won (5110) with a pair of Tens
Seat 3: Troll-In1990 (big blind) mucked [2h As]
Seat 4: saperevedere folded before Flop (didn't bet)
Seat 5: mateuss771 folded before Flop (didn't bet)
Seat 6: savin.hsp folded before Flop (didn't bet)
Seat 7: RafaPradoQJ folded before Flop (didn't bet)
Seat 8: jeje_sat folded before Flop (didn't bet)
Seat 9: CHIPSCRAZYYY folded before Flop (didn't bet)


PokerStars Hand #229694447769: Tournament #3253260637, €4.50+€4.50+€1.00 EUR Hold'em No Limit - Level V (125/250) - 2021/09/08 21:14:17 CET [2021/09/08 15:14:17 ET]
Table '3253260637 211' 9-max Seat #2 is the button
Seat 1: rogernu7 (20917 in chips, €6.75 bounty)
Seat 2: Aymeric 6186 (22784 in chips, €6.75 bounty)
Seat 3: Troll-In1990 (10877 in chips, €4.50 bounty)
Seat 4: saperevedere (17190 in chips, €4.50 bounty)
Seat 5: mateuss771 (7819 in chips, €4.50 bounty)
Seat 6: savin.hsp (7814 in chips, €4.50 bounty)
Seat 7: RafaPradoQJ (10024 in chips, €4.50 bounty)
Seat 8: jeje_sat (8850 in chips, €4.50 bounty)
Seat 9: CHIPSCRAZYYY (10700 in chips, €4.50 bounty)
rogernu7: posts the ante 30
Aymeric 6186: posts the ante 30
Troll-In1990: posts the ante 30
saperevedere: posts the ante 30
mateuss771: posts the ante 30
savin.hsp: posts the ante 30
RafaPradoQJ: posts the ante 30
jeje_sat: posts the ante 30
CHIPSCRAZYYY: posts the ante 30
Troll-In1990: posts small blind 125
saperevedere: posts big blind 250
*** HOLE CARDS ***
Dealt to jeje_sat [Tc Kh]
mateuss771: folds
savin.hsp: folds
RafaPradoQJ: folds
jeje_sat: raises 500 to 750
CHIPSCRAZYYY: folds
rogernu7: calls 750
Aymeric 6186: folds
Troll-In1990: folds
saperevedere: calls 500
*** FLOP *** [8h 2c 3c]
saperevedere: checks
jeje_sat: checks
rogernu7: bets 794
saperevedere: folds
jeje_sat: folds
Uncalled bet (794) returned to rogernu7
rogernu7 collected 2645 from pot
*** SUMMARY ***
Total pot 2645 | Rake 0
Board [8h 2c 3c]
Seat 1: rogernu7 collected (2645)
Seat 2: Aymeric 6186 (button) folded before Flop (didn't bet)
Seat 3: Troll-In1990 (small blind) folded before Flop
Seat 4: saperevedere (big blind) folded on the Flop
Seat 5: mateuss771 folded before Flop (didn't bet)
Seat 6: savin.hsp folded before Flop (didn't bet)
Seat 7: RafaPradoQJ folded before Flop (didn't bet)
Seat 8: jeje_sat folded on the Flop
Seat 9: CHIPSCRAZYYY folded before Flop (didn't bet)


PokerStars Hand #229694489635: Tournament #3253260637, €4.50+€4.50+€1.00 EUR Hold'em No Limit - Level V (125/250) - 2021/09/08 21:15:41 CET [2021/09/08 15:15:41 ET]
Table '3253260637 211' 9-max Seat #3 is the button
Seat 1: rogernu7 (22782 in chips, €6.75 bounty)
Seat 2: Aymeric 6186 (22754 in chips, €6.75 bounty)
Seat 3: Troll-In1990 (10722 in chips, €4.50 bounty)
Seat 4: saperevedere (16410 in chips, €4.50 bounty)
Seat 5: mateuss771 (7789 in chips, €4.50 bounty)
Seat 6: savin.hsp (7784 in chips, €4.50 bounty)
Seat 7: RafaPradoQJ (9994 in chips, €4.50 bounty)
Seat 8: jeje_sat (8070 in chips, €4.50 bounty)
Seat 9: CHIPSCRAZYYY (10670 in chips, €4.50 bounty)
rogernu7: posts the ante 30
Aymeric 6186: posts the ante 30
Troll-In1990: posts the ante 30
saperevedere: posts the ante 30
mateuss771: posts the ante 30
savin.hsp: posts the ante 30
RafaPradoQJ: posts the ante 30
jeje_sat: posts the ante 30
CHIPSCRAZYYY: posts the ante 30
saperevedere: posts small blind 125
mateuss771: posts big blind 250
*** HOLE CARDS ***
Dealt to jeje_sat [8s Qs]
savin.hsp: raises 275 to 525
RafaPradoQJ: folds
jeje_sat: folds
CHIPSCRAZYYY: folds
rogernu7: folds
Aymeric 6186: folds
Troll-In1990: calls 525
saperevedere: folds
mateuss771: calls 275
*** FLOP *** [2s Jh 7s]
mateuss771: checks
savin.hsp: checks
Troll-In1990: bets 660
mateuss771: folds
savin.hsp: calls 660
*** TURN *** [2s Jh 7s] [Jc]
savin.hsp: checks
Troll-In1990: bets 1405
savin.hsp: calls 1405
*** RIVER *** [2s Jh 7s Jc] [Kd]
savin.hsp: checks
Troll-In1990: bets 8102 and is all-in
savin.hsp: folds
Uncalled bet (8102) returned to Troll-In1990
Troll-In1990 collected 6100 from pot
Troll-In1990: doesn't show hand
*** SUMMARY ***
Total pot 6100 | Rake 0
Board [2s Jh 7s Jc Kd]
Seat 1: rogernu7 folded before Flop (didn't bet)
Seat 2: Aymeric 6186 folded before Flop (didn't bet)
Seat 3: Troll-In1990 (button) collected (6100)
Seat 4: saperevedere (small blind) folded before Flop
Seat 5: mateuss771 (big blind) folded on the Flop
Seat 6: savin.hsp folded on the River
Seat 7: RafaPradoQJ folded before Flop (didn't bet)
Seat 8: jeje_sat folded before Flop (didn't bet)
Seat 9: CHIPSCRAZYYY folded before Flop (didn't bet)


PokerStars Hand #229694542069: Tournament #3253260637, €4.50+€4.50+€1.00 EUR Hold'em No Limit - Level V (125/250) - 2021/09/08 21:17:26 CET [2021/09/08 15:17:26 ET]
Table '3253260637 211' 9-max Seat #4 is the button
Seat 1: rogernu7 (22752 in chips, €6.75 bounty)
Seat 2: Aymeric 6186 (22724 in chips, €6.75 bounty)
Seat 3: Troll-In1990 (14202 in chips, €4.50 bounty)
Seat 4: saperevedere (16255 in chips, €4.50 bounty)
Seat 5: mateuss771 (7234 in chips, €4.50 bounty)
Seat 6: savin.hsp (5164 in chips, €4.50 bounty)
Seat 7: RafaPradoQJ (9964 in chips, €4.50 bounty)
Seat 8: jeje_sat (8040 in chips, €4.50 bounty)
Seat 9: CHIPSCRAZYYY (10640 in chips, €4.50 bounty)
rogernu7: posts the ante 30
Aymeric 6186: posts the ante 30
Troll-In1990: posts the ante 30
saperevedere: posts the ante 30
mateuss771: posts the ante 30
savin.hsp: posts the ante 30
RafaPradoQJ: posts the ante 30
jeje_sat: posts the ante 30
CHIPSCRAZYYY: posts the ante 30
mateuss771: posts small blind 125
savin.hsp: posts big blind 250
*** HOLE CARDS ***
Dealt to jeje_sat [Kd Td]
RafaPradoQJ: folds
jeje_sat: raises 500 to 750
CHIPSCRAZYYY: folds
rogernu7: folds
Aymeric 6186: folds
Troll-In1990: folds
saperevedere: folds
mateuss771: folds
savin.hsp: folds
Uncalled bet (500) returned to jeje_sat
jeje_sat collected 895 from pot
jeje_sat: doesn't show hand
*** SUMMARY ***
Total pot 895 | Rake 0
Seat 1: rogernu7 folded before Flop (didn't bet)
Seat 2: Aymeric 6186 folded before Flop (didn't bet)
Seat 3: Troll-In1990 folded before Flop (didn't bet)
Seat 4: saperevedere (button) folded before Flop (didn't bet)
Seat 5: mateuss771 (small blind) folded before Flop
Seat 6: savin.hsp (big blind) folded before Flop
Seat 7: RafaPradoQJ folded before Flop (didn't bet)
Seat 8: jeje_sat collected (895)
Seat 9: CHIPSCRAZYYY folded before Flop (didn't bet)


PokerStars Hand #229694558731: Tournament #3253260637, €4.50+€4.50+€1.00 EUR Hold'em No Limit - Level V (125/250) - 2021/09/08 21:17:59 CET [2021/09/08 15:17:59 ET]
Table '3253260637 211' 9-max Seat #5 is the button
Seat 1: rogernu7 (22722 in chips, €6.75 bounty)
Seat 2: Aymeric 6186 (22694 in chips, €6.75 bounty)
Seat 3: Troll-In1990 (14172 in chips, €4.50 bounty)
Seat 4: saperevedere (16225 in chips, €4.50 bounty)
Seat 5: mateuss771 (7079 in chips, €4.50 bounty)
Seat 6: savin.hsp (4884 in chips, €4.50 bounty)
Seat 7: RafaPradoQJ (9934 in chips, €4.50 bounty)
Seat 8: jeje_sat (8655 in chips, €4.50 bounty)
Seat 9: CHIPSCRAZYYY (10610 in chips, €4.50 bounty)
rogernu7: posts the ante 30
Aymeric 6186: posts the ante 30
Troll-In1990: posts the ante 30
saperevedere: posts the ante 30
mateuss771: posts the ante 30
savin.hsp: posts the ante 30
RafaPradoQJ: posts the ante 30
jeje_sat: posts the ante 30
CHIPSCRAZYYY: posts the ante 30
savin.hsp: posts small blind 125
RafaPradoQJ: posts big blind 250
*** HOLE CARDS ***
Dealt to jeje_sat [Ks 5c]
jeje_sat: folds
CHIPSCRAZYYY: folds
rogernu7: folds
Aymeric 6186: folds
Troll-In1990: raises 465 to 715
saperevedere: folds
mateuss771: folds
savin.hsp: folds
RafaPradoQJ: calls 465
*** FLOP *** [9s 5h 3c]
RafaPradoQJ: checks
Troll-In1990: bets 1135
RafaPradoQJ: folds
Uncalled bet (1135) returned to Troll-In1990
Troll-In1990 collected 1825 from pot
Troll-In1990: doesn't show hand
*** SUMMARY ***
Total pot 1825 | Rake 0
Board [9s 5h 3c]
Seat 1: rogernu7 folded before Flop (didn't bet)
Seat 2: Aymeric 6186 folded before Flop (didn't bet)
Seat 3: Troll-In1990 collected (1825)
Seat 4: saperevedere folded before Flop (didn't bet)
Seat 5: mateuss771 (button) folded before Flop (didn't bet)
Seat 6: savin.hsp (small blind) folded before Flop
Seat 7: RafaPradoQJ (big blind) folded on the Flop
Seat 8: jeje_sat folded before Flop (didn't bet)
Seat 9: CHIPSCRAZYYY folded before Flop (didn't bet)


PokerStars Hand #229694598360: Tournament #3253260637, €4.50+€4.50+€1.00 EUR Hold'em No Limit - Level V (125/250) - 2021/09/08 21:19:19 CET [2021/09/08 15:19:19 ET]
Table '3253260637 211' 9-max Seat #6 is the button
Seat 1: rogernu7 (22692 in chips, €6.75 bounty)
Seat 2: Aymeric 6186 (22664 in chips, €6.75 bounty)
Seat 3: Troll-In1990 (15252 in chips, €4.50 bounty)
Seat 4: saperevedere (16195 in chips, €4.50 bounty)
Seat 5: mateuss771 (7049 in chips, €4.50 bounty)
Seat 6: savin.hsp (4729 in chips, €4.50 bounty)
Seat 7: RafaPradoQJ (9189 in chips, €4.50 bounty)
Seat 8: jeje_sat (8625 in chips, €4.50 bounty)
Seat 9: CHIPSCRAZYYY (10580 in chips, €4.50 bounty)
rogernu7: posts the ante 30
Aymeric 6186: posts the ante 30
Troll-In1990: posts the ante 30
saperevedere: posts the ante 30
mateuss771: posts the ante 30
savin.hsp: posts the ante 30
RafaPradoQJ: posts the ante 30
jeje_sat: posts the ante 30
CHIPSCRAZYYY: posts the ante 30
RafaPradoQJ: posts small blind 125
jeje_sat: posts big blind 250
*** HOLE CARDS ***
Dealt to jeje_sat [Jd 6d]
CHIPSCRAZYYY: folds
rogernu7: folds
Aymeric 6186: folds
Troll-In1990: folds
saperevedere: folds
mateuss771: folds
savin.hsp: folds
RafaPradoQJ: raises 250 to 500
jeje_sat: calls 250
*** FLOP *** [5c Tc 5s]
RafaPradoQJ: bets 419
jeje_sat: folds
Uncalled bet (419) returned to RafaPradoQJ
RafaPradoQJ collected 1270 from pot
RafaPradoQJ: doesn't show hand
*** SUMMARY ***
Total pot 1270 | Rake 0
Board [5c Tc 5s]
Seat 1: rogernu7 folded before Flop (didn't bet)
Seat 2: Aymeric 6186 folded before Flop (didn't bet)
Seat 3: Troll-In1990 folded before Flop (didn't bet)
Seat 4: saperevedere folded before Flop (didn't bet)
Seat 5: mateuss771 folded before Flop (didn't bet)
Seat 6: savin.hsp (button) folded before Flop (didn't bet)
Seat 7: RafaPradoQJ (small blind) collected (1270)
Seat 8: jeje_sat (big blind) folded on the Flop
Seat 9: CHIPSCRAZYYY folded before Flop (didn't bet)


PokerStars Hand #229694631481: Tournament #3253260637, €4.50+€4.50+€1.00 EUR Hold'em No Limit - Level V (125/250) - 2021/09/08 21:20:24 CET [2021/09/08 15:20:24 ET]
Table '3253260637 211' 9-max Seat #7 is the button
Seat 1: rogernu7 (22662 in chips, €6.75 bounty)
Seat 2: Aymeric 6186 (22634 in chips, €6.75 bounty)
Seat 3: Troll-In1990 (15222 in chips, €4.50 bounty)
Seat 4: saperevedere (16165 in chips, €4.50 bounty)
Seat 5: mateuss771 (7019 in chips, €4.50 bounty)
Seat 6: savin.hsp (4699 in chips, €4.50 bounty)
Seat 7: RafaPradoQJ (9929 in chips, €4.50 bounty)
Seat 8: jeje_sat (8095 in chips, €4.50 bounty)
Seat 9: CHIPSCRAZYYY (10550 in chips, €4.50 bounty)
rogernu7: posts the ante 30
Aymeric 6186: posts the ante 30
Troll-In1990: posts the ante 30
saperevedere: posts the ante 30
mateuss771: posts the ante 30
savin.hsp: posts the ante 30
RafaPradoQJ: posts the ante 30
jeje_sat: posts the ante 30
CHIPSCRAZYYY: posts the ante 30
jeje_sat: posts small blind 125
CHIPSCRAZYYY: posts big blind 250
*** HOLE CARDS ***
Dealt to jeje_sat [6d Kd]
rogernu7: folds
Aymeric 6186: folds
Troll-In1990: folds
saperevedere: folds
mateuss771: folds
savin.hsp: raises 275 to 525
RafaPradoQJ: raises 9374 to 9899 and is all-in
jeje_sat: folds
CHIPSCRAZYYY: folds
savin.hsp: folds
Uncalled bet (9374) returned to RafaPradoQJ
RafaPradoQJ collected 1695 from pot
RafaPradoQJ: doesn't show hand
*** SUMMARY ***
Total pot 1695 | Rake 0
Seat 1: rogernu7 folded before Flop (didn't bet)
Seat 2: Aymeric 6186 folded before Flop (didn't bet)
Seat 3: Troll-In1990 folded before Flop (didn't bet)
Seat 4: saperevedere folded before Flop (didn't bet)
Seat 5: mateuss771 folded before Flop (didn't bet)
Seat 6: savin.hsp folded before Flop
Seat 7: RafaPradoQJ (button) collected (1695)
Seat 8: jeje_sat (small blind) folded before Flop
Seat 9: CHIPSCRAZYYY (big blind) folded before Flop


PokerStars Hand #229694666045: Tournament #3253260637, €4.50+€4.50+€1.00 EUR Hold'em No Limit - Level VI (150/300) - 2021/09/08 21:21:33 CET [2021/09/08 15:21:33 ET]
Table '3253260637 211' 9-max Seat #8 is the button
Seat 1: rogernu7 (22632 in chips, €6.75 bounty)
Seat 2: Aymeric 6186 (22604 in chips, €6.75 bounty)
Seat 3: Troll-In1990 (15192 in chips, €4.50 bounty)
Seat 4: saperevedere (16135 in chips, €4.50 bounty)
Seat 5: mateuss771 (6989 in chips, €4.50 bounty)
Seat 6: savin.hsp (4144 in chips, €4.50 bounty)
Seat 7: RafaPradoQJ (11069 in chips, €4.50 bounty)
Seat 8: jeje_sat (7940 in chips, €4.50 bounty)
Seat 9: CHIPSCRAZYYY (10270 in chips, €4.50 bounty)
rogernu7: posts the ante 40
Aymeric 6186: posts the ante 40
Troll-In1990: posts the ante 40
saperevedere: posts the ante 40
mateuss771: posts the ante 40
savin.hsp: posts the ante 40
RafaPradoQJ: posts the ante 40
jeje_sat: posts the ante 40
CHIPSCRAZYYY: posts the ante 40
CHIPSCRAZYYY: posts small blind 150
rogernu7: posts big blind 300
*** HOLE CARDS ***
Dealt to jeje_sat [Jc 8d]
Aymeric 6186: calls 300
Troll-In1990: folds
saperevedere: folds
mateuss771: folds
savin.hsp: folds
RafaPradoQJ: folds
jeje_sat: raises 600 to 900
CHIPSCRAZYYY: folds
rogernu7: folds
Aymeric 6186: calls 600
*** FLOP *** [4h As 5c]
Aymeric 6186: checks
jeje_sat: bets 1305
Aymeric 6186: folds
Uncalled bet (1305) returned to jeje_sat
jeje_sat collected 2610 from pot
jeje_sat: doesn't show hand
*** SUMMARY ***
Total pot 2610 | Rake 0
Board [4h As 5c]
Seat 1: rogernu7 (big blind) folded before Flop
Seat 2: Aymeric 6186 folded on the Flop
Seat 3: Troll-In1990 folded before Flop (didn't bet)
Seat 4: saperevedere folded before Flop (didn't bet)
Seat 5: mateuss771 folded before Flop (didn't bet)
Seat 6: savin.hsp folded before Flop (didn't bet)
Seat 7: RafaPradoQJ folded before Flop (didn't bet)
Seat 8: jeje_sat (button) collected (2610)
Seat 9: CHIPSCRAZYYY (small blind) folded before Flop


PokerStars Hand #229694703449: Tournament #3253260637, €4.50+€4.50+€1.00 EUR Hold'em No Limit - Level VI (150/300) - 2021/09/08 21:22:48 CET [2021/09/08 15:22:48 ET]
Table '3253260637 211' 9-max Seat #9 is the button
Seat 1: rogernu7 (22292 in chips, €6.75 bounty)
Seat 2: Aymeric 6186 (21664 in chips, €6.75 bounty)
Seat 3: Troll-In1990 (15152 in chips, €4.50 bounty)
Seat 4: saperevedere (16095 in chips, €4.50 bounty)
Seat 5: mateuss771 (6949 in chips, €4.50 bounty)
Seat 6: savin.hsp (4104 in chips, €4.50 bounty)
Seat 7: RafaPradoQJ (11029 in chips, €4.50 bounty)
Seat 8: jeje_sat (9610 in chips, €4.50 bounty)
Seat 9: CHIPSCRAZYYY (10080 in chips, €4.50 bounty)
rogernu7: posts the ante 40
Aymeric 6186: posts the ante 40
Troll-In1990: posts the ante 40
saperevedere: posts the ante 40
mateuss771: posts the ante 40
savin.hsp: posts the ante 40
RafaPradoQJ: posts the ante 40
jeje_sat: posts the ante 40
CHIPSCRAZYYY: posts the ante 40
rogernu7: posts small blind 150
Aymeric 6186: posts big blind 300
*** HOLE CARDS ***
Dealt to jeje_sat [Qh Kc]
Troll-In1990: folds
saperevedere: folds
mateuss771: folds
savin.hsp: raises 3764 to 4064 and is all-in
RafaPradoQJ: folds
jeje_sat: folds
CHIPSCRAZYYY: raises 5976 to 10040 and is all-in
rogernu7: folds
Aymeric 6186: folds
Uncalled bet (5976) returned to CHIPSCRAZYYY
*** FLOP *** [Ah 3h Js]
*** TURN *** [Ah 3h Js] [Qd]
*** RIVER *** [Ah 3h Js Qd] [Kh]
*** SHOW DOWN ***
savin.hsp: shows [Td Kd] (a straight, Ten to Ace)
CHIPSCRAZYYY: shows [Ac 7c] (a pair of Aces)
savin.hsp collected 8938 from pot
*** SUMMARY ***
Total pot 8938 | Rake 0
Board [Ah 3h Js Qd Kh]
Seat 1: rogernu7 (small blind) folded before Flop
Seat 2: Aymeric 6186 (big blind) folded before Flop
Seat 3: Troll-In1990 folded before Flop (didn't bet)
Seat 4: saperevedere folded before Flop (didn't bet)
Seat 5: mateuss771 folded before Flop (didn't bet)
Seat 6: savin.hsp showed [Td Kd] and won (8938) with a straight, Ten to Ace
Seat 7: RafaPradoQJ folded before Flop (didn't bet)
Seat 8: jeje_sat folded before Flop (didn't bet)
Seat 9: CHIPSCRAZYYY (button) showed [Ac 7c] and lost with a pair of Aces


PokerStars Hand #229694752039: Tournament #3253260637, €4.50+€4.50+€1.00 EUR Hold'em No Limit - Level VI (150/300) - 2021/09/08 21:24:10 CET [2021/09/08 15:24:10 ET]
Table '3253260637 211' 9-max Seat #1 is the button
Seat 1: rogernu7 (22102 in chips, €6.75 bounty)
Seat 2: Aymeric 6186 (21324 in chips, €6.75 bounty)
Seat 3: Troll-In1990 (15112 in chips, €4.50 bounty)
Seat 4: saperevedere (16055 in chips, €4.50 bounty)
Seat 5: mateuss771 (6909 in chips, €4.50 bounty)
Seat 6: savin.hsp (8938 in chips, €4.50 bounty)
Seat 7: RafaPradoQJ (10989 in chips, €4.50 bounty)
Seat 8: jeje_sat (9570 in chips, €4.50 bounty)
Seat 9: CHIPSCRAZYYY (5976 in chips, €4.50 bounty)
rogernu7: posts the ante 40
Aymeric 6186: posts the ante 40
Troll-In1990: posts the ante 40
saperevedere: posts the ante 40
mateuss771: posts the ante 40
savin.hsp: posts the ante 40
RafaPradoQJ: posts the ante 40
jeje_sat: posts the ante 40
CHIPSCRAZYYY: posts the ante 40
Aymeric 6186: posts small blind 150
Troll-In1990: posts big blind 300
*** HOLE CARDS ***
Dealt to jeje_sat [9h 2h]
saperevedere: raises 390 to 690
mateuss771: folds
savin.hsp: folds
RafaPradoQJ: folds
jeje_sat: folds
CHIPSCRAZYYY: folds
rogernu7: folds
Aymeric 6186: folds
Troll-In1990: folds
Uncalled bet (390) returned to saperevedere
saperevedere collected 1110 from pot
*** SUMMARY ***
Total pot 1110 | Rake 0
Seat 1: rogernu7 (button) folded before Flop (didn't bet)
Seat 2: Aymeric 6186 (small blind) folded before Flop
Seat 3: Troll-In1990 (big blind) folded before Flop
Seat 4: saperevedere collected (1110)
Seat 5: mateuss771 folded before Flop (didn't bet)
Seat 6: savin.hsp folded before Flop (didn't bet)
Seat 7: RafaPradoQJ folded before Flop (didn't bet)
Seat 8: jeje_sat folded before Flop (didn't bet)
Seat 9: CHIPSCRAZYYY folded before Flop (didn't bet)


PokerStars Hand #229694763123: Tournament #3253260637, €4.50+€4.50+€1.00 EUR Hold'em No Limit - Level VI (150/300) - 2021/09/08 21:24:32 CET [2021/09/08 15:24:32 ET]
Table '3253260637 211' 9-max Seat #2 is the button
Seat 1: rogernu7 (22062 in chips, €6.75 bounty)
Seat 2: Aymeric 6186 (21134 in chips, €6.75 bounty)
Seat 3: Troll-In1990 (14772 in chips, €4.50 bounty)
Seat 4: saperevedere (16825 in chips, €4.50 bounty)
Seat 5: mateuss771 (6869 in chips, €4.50 bounty)
Seat 6: savin.hsp (8898 in chips, €4.50 bounty)
Seat 7: RafaPradoQJ (10949 in chips, €4.50 bounty)
Seat 8: jeje_sat (9530 in chips, €4.50 bounty)
Seat 9: CHIPSCRAZYYY (5936 in chips, €4.50 bounty)
rogernu7: posts the ante 40
Aymeric 6186: posts the ante 40
Troll-In1990: posts the ante 40
saperevedere: posts the ante 40
mateuss771: posts the ante 40
savin.hsp: posts the ante 40
RafaPradoQJ: posts the ante 40
jeje_sat: posts the ante 40
CHIPSCRAZYYY: posts the ante 40
Troll-In1990: posts small blind 150
saperevedere: posts big blind 300
*** HOLE CARDS ***
Dealt to jeje_sat [5s 2d]
mateuss771: folds
savin.hsp: folds
RafaPradoQJ: raises 300 to 600
jeje_sat: folds
CHIPSCRAZYYY: folds
rogernu7: folds
Aymeric 6186: folds
Troll-In1990: calls 450
saperevedere: folds
*** FLOP *** [4d 2s 2c]
Troll-In1990: checks
RafaPradoQJ: bets 744
Troll-In1990: calls 744
*** TURN *** [4d 2s 2c] [9s]
Troll-In1990: checks
RafaPradoQJ: bets 2232
Troll-In1990: folds
Uncalled bet (2232) returned to RafaPradoQJ
RafaPradoQJ collected 3348 from pot
RafaPradoQJ: doesn't show hand
*** SUMMARY ***
Total pot 3348 | Rake 0
Board [4d 2s 2c 9s]
Seat 1: rogernu7 folded before Flop (didn't bet)
Seat 2: Aymeric 6186 (button) folded before Flop (didn't bet)
Seat 3: Troll-In1990 (small blind) folded on the Turn
Seat 4: saperevedere (big blind) folded before Flop
Seat 5: mateuss771 folded before Flop (didn't bet)
Seat 6: savin.hsp folded before Flop (didn't bet)
Seat 7: RafaPradoQJ collected (3348)
Seat 8: jeje_sat folded before Flop (didn't bet)
Seat 9: CHIPSCRAZYYY folded before Flop (didn't bet)


PokerStars Hand #229694804193: Tournament #3253260637, €4.50+€4.50+€1.00 EUR Hold'em No Limit - Level VI (150/300) - 2021/09/08 21:25:55 CET [2021/09/08 15:25:55 ET]
Table '3253260637 211' 9-max Seat #3 is the button
Seat 1: rogernu7 (22022 in chips, €6.75 bounty)
Seat 2: Aymeric 6186 (21094 in chips, €6.75 bounty)
Seat 3: Troll-In1990 (13388 in chips, €4.50 bounty)
Seat 4: saperevedere (16485 in chips, €4.50 bounty)
Seat 5: mateuss771 (6829 in chips, €4.50 bounty)
Seat 6: savin.hsp (8858 in chips, €4.50 bounty)
Seat 7: RafaPradoQJ (12913 in chips, €4.50 bounty)
Seat 8: jeje_sat (9490 in chips, €4.50 bounty)
Seat 9: CHIPSCRAZYYY (5896 in chips, €4.50 bounty)
rogernu7: posts the ante 40
Aymeric 6186: posts the ante 40
Troll-In1990: posts the ante 40
saperevedere: posts the ante 40
mateuss771: posts the ante 40
savin.hsp: posts the ante 40
RafaPradoQJ: posts the ante 40
jeje_sat: posts the ante 40
CHIPSCRAZYYY: posts the ante 40
saperevedere: posts small blind 150
mateuss771: posts big blind 300
*** HOLE CARDS ***
Dealt to jeje_sat [Ts 5h]
savin.hsp: folds
RafaPradoQJ: folds
jeje_sat: folds
CHIPSCRAZYYY: folds
rogernu7: raises 300 to 600
Aymeric 6186: folds
Troll-In1990: calls 600
saperevedere: folds
mateuss771: folds
*** FLOP *** [2h 3h Kh]
rogernu7: checks
Troll-In1990: bets 775
rogernu7: folds
Uncalled bet (775) returned to Troll-In1990
Troll-In1990 collected 2010 from pot
Troll-In1990: doesn't show hand
*** SUMMARY ***
Total pot 2010 | Rake 0
Board [2h 3h Kh]
Seat 1: rogernu7 folded on the Flop
Seat 2: Aymeric 6186 folded before Flop (didn't bet)
Seat 3: Troll-In1990 (button) collected (2010)
Seat 4: saperevedere (small blind) folded before Flop
Seat 5: mateuss771 (big blind) folded before Flop
Seat 6: savin.hsp folded before Flop (didn't bet)
Seat 7: RafaPradoQJ folded before Flop (didn't bet)
Seat 8: jeje_sat folded before Flop (didn't bet)
Seat 9: CHIPSCRAZYYY folded before Flop (didn't bet)


PokerStars Hand #229694838407: Tournament #3253260637, €4.50+€4.50+€1.00 EUR Hold'em No Limit - Level VI (150/300) - 2021/09/08 21:27:03 CET [2021/09/08 15:27:03 ET]
Table '3253260637 211' 9-max Seat #4 is the button
Seat 1: rogernu7 (21382 in chips, €6.75 bounty)
Seat 2: Aymeric 6186 (21054 in chips, €6.75 bounty)
Seat 3: Troll-In1990 (14758 in chips, €4.50 bounty)
Seat 4: saperevedere (16295 in chips, €4.50 bounty)
Seat 5: mateuss771 (6489 in chips, €4.50 bounty)
Seat 6: savin.hsp (8818 in chips, €4.50 bounty)
Seat 7: RafaPradoQJ (12873 in chips, €4.50 bounty)
Seat 8: jeje_sat (9450 in chips, €4.50 bounty)
Seat 9: CHIPSCRAZYYY (5856 in chips, €4.50 bounty)
rogernu7: posts the ante 40
Aymeric 6186: posts the ante 40
Troll-In1990: posts the ante 40
saperevedere: posts the ante 40
mateuss771: posts the ante 40
savin.hsp: posts the ante 40
RafaPradoQJ: posts the ante 40
jeje_sat: posts the ante 40
CHIPSCRAZYYY: posts the ante 40
mateuss771: posts small blind 150
savin.hsp: posts big blind 300
*** HOLE CARDS ***
Dealt to jeje_sat [4d 7d]
RafaPradoQJ: folds
jeje_sat: folds
CHIPSCRAZYYY: folds
rogernu7: folds
Aymeric 6186: folds
Troll-In1990: folds
saperevedere: raises 390 to 690
mateuss771: folds
savin.hsp: calls 390
*** FLOP *** [Ks 3d 4h]
savin.hsp: checks
saperevedere: bets 624
savin.hsp: folds
Uncalled bet (624) returned to saperevedere
saperevedere collected 1890 from pot
*** SUMMARY ***
Total pot 1890 | Rake 0
Board [Ks 3d 4h]
Seat 1: rogernu7 folded before Flop (didn't bet)
Seat 2: Aymeric 6186 folded before Flop (didn't bet)
Seat 3: Troll-In1990 folded before Flop (didn't bet)
Seat 4: saperevedere (button) collected (1890)
Seat 5: mateuss771 (small blind) folded before Flop
Seat 6: savin.hsp (big blind) folded on the Flop
Seat 7: RafaPradoQJ folded before Flop (didn't bet)
Seat 8: jeje_sat folded before Flop (didn't bet)
Seat 9: CHIPSCRAZYYY folded before Flop (didn't bet)


PokerStars Hand #229694863848: Tournament #3253260637, €4.50+€4.50+€1.00 EUR Hold'em No Limit - Level VI (150/300) - 2021/09/08 21:27:54 CET [2021/09/08 15:27:54 ET]
Table '3253260637 211' 9-max Seat #5 is the button
Seat 1: rogernu7 (21342 in chips, €6.75 bounty)
Seat 2: Aymeric 6186 (21014 in chips, €6.75 bounty)
Seat 3: Troll-In1990 (14718 in chips, €4.50 bounty)
Seat 4: saperevedere (17455 in chips, €4.50 bounty)
Seat 5: mateuss771 (6299 in chips, €4.50 bounty)
Seat 6: savin.hsp (8088 in chips, €4.50 bounty)
Seat 7: RafaPradoQJ (12833 in chips, €4.50 bounty)
Seat 8: jeje_sat (9410 in chips, €4.50 bounty)
Seat 9: CHIPSCRAZYYY (5816 in chips, €4.50 bounty)
rogernu7: posts the ante 40
Aymeric 6186: posts the ante 40
Troll-In1990: posts the ante 40
saperevedere: posts the ante 40
mateuss771: posts the ante 40
savin.hsp: posts the ante 40
RafaPradoQJ: posts the ante 40
jeje_sat: posts the ante 40
CHIPSCRAZYYY: posts the ante 40
savin.hsp: posts small blind 150
RafaPradoQJ: posts big blind 300
*** HOLE CARDS ***
Dealt to jeje_sat [5h Th]
jeje_sat: folds
CHIPSCRAZYYY: folds
rogernu7: folds
Aymeric 6186: calls 300
Troll-In1990: folds
saperevedere: folds
mateuss771: calls 300
savin.hsp: calls 150
RafaPradoQJ: checks
*** FLOP *** [Kh 8h 6c]
savin.hsp: checks
RafaPradoQJ: checks
Aymeric 6186: checks
mateuss771: bets 515
savin.hsp: calls 515
RafaPradoQJ: calls 515
Aymeric 6186: folds
*** TURN *** [Kh 8h 6c] [6s]
savin.hsp: checks
RafaPradoQJ: bets 1025
mateuss771: calls 1025
savin.hsp: folds
*** RIVER *** [Kh 8h 6c 6s] [8d]
RafaPradoQJ: checks
mateuss771: checks
*** SHOW DOWN ***
RafaPradoQJ: shows [Kd 7d] (two pair, Kings and Eights)
mateuss771: shows [Ts Kc] (two pair, Kings and Eights - Ten kicker)
mateuss771 collected 5155 from pot
*** SUMMARY ***
Total pot 5155 | Rake 0
Board [Kh 8h 6c 6s 8d]
Seat 1: rogernu7 folded before Flop (didn't bet)
Seat 2: Aymeric 6186 folded on the Flop
Seat 3: Troll-In1990 folded before Flop (didn't bet)
Seat 4: saperevedere folded before Flop (didn't bet)
Seat 5: mateuss771 (button) showed [Ts Kc] and won (5155) with two pair, Kings and Eights
Seat 6: savin.hsp (small blind) folded on the Turn
Seat 7: RafaPradoQJ (big blind) showed [Kd 7d] and lost with two pair, Kings and Eights
Seat 8: jeje_sat folded before Flop (didn't bet)
Seat 9: CHIPSCRAZYYY folded before Flop (didn't bet)


PokerStars Hand #229694925609: Tournament #3253260637, €4.50+€4.50+€1.00 EUR Hold'em No Limit - Level VII (200/400) - 2021/09/08 21:29:53 CET [2021/09/08 15:29:53 ET]
Table '3253260637 211' 9-max Seat #6 is the button
Seat 1: rogernu7 (21302 in chips, €6.75 bounty)
Seat 2: Aymeric 6186 (20674 in chips, €6.75 bounty)
Seat 3: Troll-In1990 (14678 in chips, €4.50 bounty)
Seat 4: saperevedere (17415 in chips, €4.50 bounty)
Seat 5: mateuss771 (9574 in chips, €4.50 bounty)
Seat 6: savin.hsp (7233 in chips, €4.50 bounty)
Seat 7: RafaPradoQJ (10953 in chips, €4.50 bounty)
Seat 8: jeje_sat (9370 in chips, €4.50 bounty)
Seat 9: CHIPSCRAZYYY (5776 in chips, €4.50 bounty)
rogernu7: posts the ante 50
Aymeric 6186: posts the ante 50
Troll-In1990: posts the ante 50
saperevedere: posts the ante 50
mateuss771: posts the ante 50
savin.hsp: posts the ante 50
RafaPradoQJ: posts the ante 50
jeje_sat: posts the ante 50
CHIPSCRAZYYY: posts the ante 50
RafaPradoQJ: posts small blind 200
jeje_sat: posts big blind 400
*** HOLE CARDS ***
Dealt to jeje_sat [Ks 2s]
CHIPSCRAZYYY: raises 5326 to 5726 and is all-in
rogernu7: folds
Aymeric 6186: folds
Troll-In1990: folds
saperevedere: folds
mateuss771: folds
savin.hsp: folds
RafaPradoQJ: folds
jeje_sat: folds
Uncalled bet (5326) returned to CHIPSCRAZYYY
CHIPSCRAZYYY collected 1450 from pot
CHIPSCRAZYYY: doesn't show hand
*** SUMMARY ***
Total pot 1450 | Rake 0
Seat 1: rogernu7 folded before Flop (didn't bet)
Seat 2: Aymeric 6186 folded before Flop (didn't bet)
Seat 3: Troll-In1990 folded before Flop (didn't bet)
Seat 4: saperevedere folded before Flop (didn't bet)
Seat 5: mateuss771 folded before Flop (didn't bet)
Seat 6: savin.hsp (button) folded before Flop (didn't bet)
Seat 7: RafaPradoQJ (small blind) folded before Flop
Seat 8: jeje_sat (big blind) folded before Flop
Seat 9: CHIPSCRAZYYY collected (1450)


PokerStars Hand #229694950498: Tournament #3253260637, €4.50+€4.50+€1.00 EUR Hold'em No Limit - Level VII (200/400) - 2021/09/08 21:30:23 CET [2021/09/08 15:30:23 ET]
Table '3253260637 211' 9-max Seat #7 is the button
Seat 1: rogernu7 (21252 in chips, €6.75 bounty)
Seat 2: Aymeric 6186 (20624 in chips, €6.75 bounty)
Seat 3: Troll-In1990 (14628 in chips, €4.50 bounty)
Seat 4: saperevedere (17365 in chips, €4.50 bounty)
Seat 5: mateuss771 (9524 in chips, €4.50 bounty)
Seat 6: savin.hsp (7183 in chips, €4.50 bounty)
Seat 7: RafaPradoQJ (10703 in chips, €4.50 bounty)
Seat 8: jeje_sat (8920 in chips, €4.50 bounty)
Seat 9: CHIPSCRAZYYY (6776 in chips, €4.50 bounty)
rogernu7: posts the ante 50
Aymeric 6186: posts the ante 50
Troll-In1990: posts the ante 50
saperevedere: posts the ante 50
mateuss771: posts the ante 50
savin.hsp: posts the ante 50
RafaPradoQJ: posts the ante 50
jeje_sat: posts the ante 50
CHIPSCRAZYYY: posts the ante 50
jeje_sat: posts small blind 200
CHIPSCRAZYYY: posts big blind 400
*** HOLE CARDS ***
Dealt to jeje_sat [Jh 2s]
rogernu7: folds
Aymeric 6186: folds
Troll-In1990: folds
saperevedere: folds
mateuss771: folds
savin.hsp: folds
RafaPradoQJ: raises 10253 to 10653 and is all-in
jeje_sat: folds
CHIPSCRAZYYY: folds
Uncalled bet (10253) returned to RafaPradoQJ
RafaPradoQJ collected 1450 from pot
RafaPradoQJ: doesn't show hand
*** SUMMARY ***
Total pot 1450 | Rake 0
Seat 1: rogernu7 folded before Flop (didn't bet)
Seat 2: Aymeric 6186 folded before Flop (didn't bet)
Seat 3: Troll-In1990 folded before Flop (didn't bet)
Seat 4: saperevedere folded before Flop (didn't bet)
Seat 5: mateuss771 folded before Flop (didn't bet)
Seat 6: savin.hsp folded before Flop (didn't bet)
Seat 7: RafaPradoQJ (button) collected (1450)
Seat 8: jeje_sat (small blind) folded before Flop
Seat 9: CHIPSCRAZYYY (big blind) folded before Flop


PokerStars Hand #229694972479: Tournament #3253260637, €4.50+€4.50+€1.00 EUR Hold'em No Limit - Level VII (200/400) - 2021/09/08 21:31:05 CET [2021/09/08 15:31:05 ET]
Table '3253260637 211' 9-max Seat #8 is the button
Seat 1: rogernu7 (21202 in chips, €6.75 bounty)
Seat 2: Aymeric 6186 (20574 in chips, €6.75 bounty)
Seat 3: Troll-In1990 (14578 in chips, €4.50 bounty)
Seat 4: saperevedere (17315 in chips, €4.50 bounty)
Seat 5: mateuss771 (9474 in chips, €4.50 bounty)
Seat 6: savin.hsp (7133 in chips, €4.50 bounty)
Seat 7: RafaPradoQJ (11703 in chips, €4.50 bounty)
Seat 8: jeje_sat (8670 in chips, €4.50 bounty)
Seat 9: CHIPSCRAZYYY (6326 in chips, €4.50 bounty)
rogernu7: posts the ante 50
Aymeric 6186: posts the ante 50
Troll-In1990: posts the ante 50
saperevedere: posts the ante 50
mateuss771: posts the ante 50
savin.hsp: posts the ante 50
RafaPradoQJ: posts the ante 50
jeje_sat: posts the ante 50
CHIPSCRAZYYY: posts the ante 50
CHIPSCRAZYYY: posts small blind 200
rogernu7: posts big blind 400
*** HOLE CARDS ***
Dealt to jeje_sat [9h Ac]
Aymeric 6186: folds
Troll-In1990: folds
saperevedere: folds
mateuss771: folds
savin.hsp: folds
RafaPradoQJ: raises 400 to 800
jeje_sat: calls 800
CHIPSCRAZYYY: folds
rogernu7: calls 400
*** FLOP *** [7d Tc 7h]
rogernu7: checks
RafaPradoQJ: checks
jeje_sat: bets 1525
rogernu7: raises 18827 to 20352 and is all-in
RafaPradoQJ: calls 10853 and is all-in
jeje_sat: folds
Uncalled bet (9499) returned to rogernu7
*** TURN *** [7d Tc 7h] [8s]
*** RIVER *** [7d Tc 7h 8s] [Ad]
*** SHOW DOWN ***
rogernu7: shows [5d Th] (two pair, Tens and Sevens)
RafaPradoQJ: shows [9d 8d] (two pair, Eights and Sevens)
rogernu7 collected 26281 from pot
rogernu7 wins €2.25 for eliminating RafaPradoQJ and their own bounty increases by €2.25 to €9
RafaPradoQJ finished the tournament
*** SUMMARY ***
Total pot 26281 | Rake 0
Board [7d Tc 7h 8s Ad]
Seat 1: rogernu7 (big blind) showed [5d Th] and won (26281) with two pair, Tens and Sevens
Seat 2: Aymeric 6186 folded before Flop (didn't bet)
Seat 3: Troll-In1990 folded before Flop (didn't bet)
Seat 4: saperevedere folded before Flop (didn't bet)
Seat 5: mateuss771 folded before Flop (didn't bet)
Seat 6: savin.hsp folded before Flop (didn't bet)
Seat 7: RafaPradoQJ showed [9d 8d] and lost with two pair, Eights and Sevens
Seat 8: jeje_sat (button) folded on the Flop
Seat 9: CHIPSCRAZYYY (small blind) folded before Flop


PokerStars Hand #229695009628: Tournament #3253260637, €4.50+€4.50+€1.00 EUR Hold'em No Limit - Level VII (200/400) - 2021/09/08 21:32:17 CET [2021/09/08 15:32:17 ET]
Table '3253260637 211' 9-max Seat #9 is the button
Seat 1: rogernu7 (35780 in chips, €9 bounty)
Seat 2: Aymeric 6186 (20524 in chips, €6.75 bounty)
Seat 3: Troll-In1990 (14528 in chips, €4.50 bounty)
Seat 4: saperevedere (17265 in chips, €4.50 bounty)
Seat 5: mateuss771 (9424 in chips, €4.50 bounty)
Seat 6: savin.hsp (7083 in chips, €4.50 bounty)
Seat 8: jeje_sat (6295 in chips, €4.50 bounty)
Seat 9: CHIPSCRAZYYY (6076 in chips, €4.50 bounty)
rogernu7: posts the ante 50
Aymeric 6186: posts the ante 50
Troll-In1990: posts the ante 50
saperevedere: posts the ante 50
mateuss771: posts the ante 50
savin.hsp: posts the ante 50
jeje_sat: posts the ante 50
CHIPSCRAZYYY: posts the ante 50
rogernu7: posts small blind 200
Aymeric 6186: posts big blind 400
*** HOLE CARDS ***
Dealt to jeje_sat [3c 7s]
Troll-In1990: folds
saperevedere: folds
mateuss771: folds
savin.hsp: folds
jeje_sat: folds
CHIPSCRAZYYY: raises 400 to 800
rogernu7: calls 600
Aymeric 6186: folds
*** FLOP *** [Tc 4h 7h]
rogernu7: checks
CHIPSCRAZYYY: bets 792
rogernu7: calls 792
*** TURN *** [Tc 4h 7h] [7c]
rogernu7: checks
CHIPSCRAZYYY: bets 4434 and is all-in
rogernu7: folds
Uncalled bet (4434) returned to CHIPSCRAZYYY
CHIPSCRAZYYY collected 3984 from pot
CHIPSCRAZYYY: doesn't show hand
*** SUMMARY ***
Total pot 3984 | Rake 0
Board [Tc 4h 7h 7c]
Seat 1: rogernu7 (small blind) folded on the Turn
Seat 2: Aymeric 6186 (big blind) folded before Flop
Seat 3: Troll-In1990 folded before Flop (didn't bet)
Seat 4: saperevedere folded before Flop (didn't bet)
Seat 5: mateuss771 folded before Flop (didn't bet)
Seat 6: savin.hsp folded before Flop (didn't bet)
Seat 8: jeje_sat folded before Flop (didn't bet)
Seat 9: CHIPSCRAZYYY (button) collected (3984)


PokerStars Hand #229695050385: Tournament #3253260637, €4.50+€4.50+€1.00 EUR Hold'em No Limit - Level VII (200/400) - 2021/09/08 21:33:35 CET [2021/09/08 15:33:35 ET]
Table '3253260637 211' 9-max Seat #1 is the button
Seat 1: rogernu7 (34138 in chips, €9 bounty)
Seat 2: Aymeric 6186 (20074 in chips, €6.75 bounty)
Seat 3: Troll-In1990 (14478 in chips, €4.50 bounty)
Seat 4: saperevedere (17215 in chips, €4.50 bounty)
Seat 5: mateuss771 (9374 in chips, €4.50 bounty)
Seat 6: savin.hsp (7033 in chips, €4.50 bounty)
Seat 7: roby664 (10000 in chips, €4.50 bounty)
Seat 8: jeje_sat (6245 in chips, €4.50 bounty)
Seat 9: CHIPSCRAZYYY (8418 in chips, €4.50 bounty)
rogernu7: posts the ante 50
Aymeric 6186: posts the ante 50
Troll-In1990: posts the ante 50
saperevedere: posts the ante 50
mateuss771: posts the ante 50
savin.hsp: posts the ante 50
roby664: posts the ante 50
jeje_sat: posts the ante 50
CHIPSCRAZYYY: posts the ante 50
Aymeric 6186: posts small blind 200
Troll-In1990: posts big blind 400
*** HOLE CARDS ***
Dealt to jeje_sat [Jh 6c]
saperevedere: folds
mateuss771: folds
savin.hsp: raises 6583 to 6983 and is all-in
roby664: folds
jeje_sat: folds
CHIPSCRAZYYY: folds
rogernu7: folds
Aymeric 6186: folds
Troll-In1990: folds
Uncalled bet (6583) returned to savin.hsp
savin.hsp collected 1450 from pot
savin.hsp: doesn't show hand
*** SUMMARY ***
Total pot 1450 | Rake 0
Seat 1: rogernu7 (button) folded before Flop (didn't bet)
Seat 2: Aymeric 6186 (small blind) folded before Flop
Seat 3: Troll-In1990 (big blind) folded before Flop
Seat 4: saperevedere folded before Flop (didn't bet)
Seat 5: mateuss771 folded before Flop (didn't bet)
Seat 6: savin.hsp collected (1450)
Seat 7: roby664 folded before Flop (didn't bet)
Seat 8: jeje_sat folded before Flop (didn't bet)
Seat 9: CHIPSCRAZYYY folded before Flop (didn't bet)


PokerStars Hand #229695071842: Tournament #3253260637, €4.50+€4.50+€1.00 EUR Hold'em No Limit - Level VII (200/400) - 2021/09/08 21:34:16 CET [2021/09/08 15:34:16 ET]
Table '3253260637 211' 9-max Seat #2 is the button
Seat 1: rogernu7 (34088 in chips, €9 bounty)
Seat 2: Aymeric 6186 (19824 in chips, €6.75 bounty)
Seat 3: Troll-In1990 (14028 in chips, €4.50 bounty)
Seat 4: saperevedere (17165 in chips, €4.50 bounty)
Seat 5: mateuss771 (9324 in chips, €4.50 bounty)
Seat 6: savin.hsp (8033 in chips, €4.50 bounty)
Seat 7: roby664 (9950 in chips, €4.50 bounty)
Seat 8: jeje_sat (6195 in chips, €4.50 bounty)
Seat 9: CHIPSCRAZYYY (8368 in chips, €4.50 bounty)
rogernu7: posts the ante 50
Aymeric 6186: posts the ante 50
Troll-In1990: posts the ante 50
saperevedere: posts the ante 50
mateuss771: posts the ante 50
savin.hsp: posts the ante 50
roby664: posts the ante 50
jeje_sat: posts the ante 50
CHIPSCRAZYYY: posts the ante 50
Troll-In1990: posts small blind 200
saperevedere: posts big blind 400
*** HOLE CARDS ***
Dealt to jeje_sat [Td Ac]
mateuss771: folds
savin.hsp: raises 440 to 840
roby664: folds
jeje_sat: calls 840
CHIPSCRAZYYY: folds
rogernu7: folds
Aymeric 6186: folds
Troll-In1990: folds
saperevedere: calls 440
*** FLOP *** [Ts As Js]
saperevedere: checks
savin.hsp: checks
jeje_sat: bets 1585
saperevedere: folds
savin.hsp: folds
Uncalled bet (1585) returned to jeje_sat
jeje_sat collected 3170 from pot
jeje_sat: doesn't show hand
*** SUMMARY ***
Total pot 3170 | Rake 0
Board [Ts As Js]
Seat 1: rogernu7 folded before Flop (didn't bet)
Seat 2: Aymeric 6186 (button) folded before Flop (didn't bet)
Seat 3: Troll-In1990 (small blind) folded before Flop
Seat 4: saperevedere (big blind) folded on the Flop
Seat 5: mateuss771 folded before Flop (didn't bet)
Seat 6: savin.hsp folded on the Flop
Seat 7: roby664 folded before Flop (didn't bet)
Seat 8: jeje_sat collected (3170)
Seat 9: CHIPSCRAZYYY folded before Flop (didn't bet)


PokerStars Hand #229695109999: Tournament #3253260637, €4.50+€4.50+€1.00 EUR Hold'em No Limit - Level VII (200/400) - 2021/09/08 21:35:30 CET [2021/09/08 15:35:30 ET]
Table '3253260637 211' 9-max Seat #3 is the button
Seat 1: rogernu7 (34038 in chips, €9 bounty)
Seat 2: Aymeric 6186 (19774 in chips, €6.75 bounty)
Seat 3: Troll-In1990 (13778 in chips, €4.50 bounty)
Seat 4: saperevedere (16275 in chips, €4.50 bounty)
Seat 5: mateuss771 (9274 in chips, €4.50 bounty)
Seat 6: savin.hsp (7143 in chips, €4.50 bounty)
Seat 7: roby664 (9900 in chips, €4.50 bounty)
Seat 8: jeje_sat (8475 in chips, €4.50 bounty)
Seat 9: CHIPSCRAZYYY (8318 in chips, €4.50 bounty)
rogernu7: posts the ante 50
Aymeric 6186: posts the ante 50
Troll-In1990: posts the ante 50
saperevedere: posts the ante 50
mateuss771: posts the ante 50
savin.hsp: posts the ante 50
roby664: posts the ante 50
jeje_sat: posts the ante 50
CHIPSCRAZYYY: posts the ante 50
saperevedere: posts small blind 200
mateuss771: posts big blind 400
*** HOLE CARDS ***
Dealt to jeje_sat [6d Jd]
savin.hsp: folds
roby664: folds
jeje_sat: folds
CHIPSCRAZYYY: folds
rogernu7: raises 600 to 1000
Aymeric 6186: folds
Troll-In1990: folds
saperevedere: folds
mateuss771: folds
Uncalled bet (600) returned to rogernu7
rogernu7 collected 1450 from pot
rogernu7: doesn't show hand
*** SUMMARY ***
Total pot 1450 | Rake 0
Seat 1: rogernu7 collected (1450)
Seat 2: Aymeric 6186 folded before Flop (didn't bet)
Seat 3: Troll-In1990 (button) folded before Flop (didn't bet)
Seat 4: saperevedere (small blind) folded before Flop
Seat 5: mateuss771 (big blind) folded before Flop
Seat 6: savin.hsp folded before Flop (didn't bet)
Seat 7: roby664 folded before Flop (didn't bet)
Seat 8: jeje_sat folded before Flop (didn't bet)
Seat 9: CHIPSCRAZYYY folded before Flop (didn't bet)


PokerStars Hand #229695133209: Tournament #3253260637, €4.50+€4.50+€1.00 EUR Hold'em No Limit - Level VII (200/400) - 2021/09/08 21:36:15 CET [2021/09/08 15:36:15 ET]
Table '3253260637 211' 9-max Seat #4 is the button
Seat 1: rogernu7 (35038 in chips, €9 bounty)
Seat 2: Aymeric 6186 (19724 in chips, €6.75 bounty)
Seat 3: Troll-In1990 (13728 in chips, €4.50 bounty)
Seat 4: saperevedere (16025 in chips, €4.50 bounty)
Seat 5: mateuss771 (8824 in chips, €4.50 bounty)
Seat 6: savin.hsp (7093 in chips, €4.50 bounty)
Seat 7: roby664 (9850 in chips, €4.50 bounty)
Seat 8: jeje_sat (8425 in chips, €4.50 bounty)
Seat 9: CHIPSCRAZYYY (8268 in chips, €4.50 bounty)
rogernu7: posts the ante 50
Aymeric 6186: posts the ante 50
Troll-In1990: posts the ante 50
saperevedere: posts the ante 50
mateuss771: posts the ante 50
savin.hsp: posts the ante 50
roby664: posts the ante 50
jeje_sat: posts the ante 50
CHIPSCRAZYYY: posts the ante 50
mateuss771: posts small blind 200
savin.hsp: posts big blind 400
*** HOLE CARDS ***
Dealt to jeje_sat [7s Ts]
roby664: folds
jeje_sat: folds
CHIPSCRAZYYY: folds
rogernu7: folds
Aymeric 6186: folds
Troll-In1990: folds
saperevedere: raises 520 to 920
mateuss771: folds
savin.hsp: calls 520
*** FLOP *** [6s 2c 7c]
savin.hsp: checks
saperevedere: bets 1200
savin.hsp: raises 4923 to 6123 and is all-in
saperevedere: calls 4923
*** TURN *** [6s 2c 7c] [Qh]
*** RIVER *** [6s 2c 7c Qh] [5d]
*** SHOW DOWN ***
savin.hsp: shows [8s 9h] (a straight, Five to Nine)
saperevedere: shows [Tc Td] (a pair of Tens)
savin.hsp collected 14736 from pot
*** SUMMARY ***
Total pot 14736 | Rake 0
Board [6s 2c 7c Qh 5d]
Seat 1: rogernu7 folded before Flop (didn't bet)
Seat 2: Aymeric 6186 folded before Flop (didn't bet)
Seat 3: Troll-In1990 folded before Flop (didn't bet)
Seat 4: saperevedere (button) showed [Tc Td] and lost with a pair of Tens
Seat 5: mateuss771 (small blind) folded before Flop
Seat 6: savin.hsp (big blind) showed [8s 9h] and won (14736) with a straight, Five to Nine
Seat 7: roby664 folded before Flop (didn't bet)
Seat 8: jeje_sat folded before Flop (didn't bet)
Seat 9: CHIPSCRAZYYY folded before Flop (didn't bet)


PokerStars Hand #229695167089: Tournament #3253260637, €4.50+€4.50+€1.00 EUR Hold'em No Limit - Level VIII (250/500) - 2021/09/08 21:37:16 CET [2021/09/08 15:37:16 ET]
Table '3253260637 211' 9-max Seat #5 is the button
Seat 1: rogernu7 (34988 in chips, €9 bounty)
Seat 2: Aymeric 6186 (19674 in chips, €6.75 bounty)
Seat 3: Troll-In1990 (13678 in chips, €4.50 bounty)
Seat 4: saperevedere (8932 in chips, €4.50 bounty)
Seat 5: mateuss771 (8574 in chips, €4.50 bounty)
Seat 6: savin.hsp (14736 in chips, €4.50 bounty)
Seat 7: roby664 (9800 in chips, €4.50 bounty)
Seat 8: jeje_sat (8375 in chips, €4.50 bounty)
Seat 9: CHIPSCRAZYYY (8218 in chips, €4.50 bounty)
rogernu7: posts the ante 60
Aymeric 6186: posts the ante 60
Troll-In1990: posts the ante 60
saperevedere: posts the ante 60
mateuss771: posts the ante 60
savin.hsp: posts the ante 60
roby664: posts the ante 60
jeje_sat: posts the ante 60
CHIPSCRAZYYY: posts the ante 60
savin.hsp: posts small blind 250
roby664: posts big blind 500
*** HOLE CARDS ***
Dealt to jeje_sat [As 9d]
jeje_sat: folds
CHIPSCRAZYYY: folds
rogernu7: folds
Aymeric 6186: folds
Troll-In1990: folds
saperevedere: raises 650 to 1150
mateuss771: folds
savin.hsp: raises 13526 to 14676 and is all-in
roby664: folds
saperevedere: calls 7722 and is all-in
Uncalled bet (5804) returned to savin.hsp
*** FLOP *** [5s Kd 3s]
*** TURN *** [5s Kd 3s] [Ks]
*** RIVER *** [5s Kd 3s Ks] [4h]
*** SHOW DOWN ***
savin.hsp: shows [Ac Tc] (a pair of Kings)
saperevedere: shows [9s Js] (a flush, King high)
saperevedere collected 18784 from pot
*** SUMMARY ***
Total pot 18784 | Rake 0
Board [5s Kd 3s Ks 4h]
Seat 1: rogernu7 folded before Flop (didn't bet)
Seat 2: Aymeric 6186 folded before Flop (didn't bet)
Seat 3: Troll-In1990 folded before Flop (didn't bet)
Seat 4: saperevedere showed [9s Js] and won (18784) with a flush, King high
Seat 5: mateuss771 (button) folded before Flop (didn't bet)
Seat 6: savin.hsp (small blind) showed [Ac Tc] and lost with a pair of Kings
Seat 7: roby664 (big blind) folded before Flop
Seat 8: jeje_sat folded before Flop (didn't bet)
Seat 9: CHIPSCRAZYYY folded before Flop (didn't bet)


PokerStars Hand #229695196316: Tournament #3253260637, €4.50+€4.50+€1.00 EUR Hold'em No Limit - Level VIII (250/500) - 2021/09/08 21:38:13 CET [2021/09/08 15:38:13 ET]
Table '3253260637 211' 9-max Seat #6 is the button
Seat 1: rogernu7 (34928 in chips, €9 bounty)
Seat 2: Aymeric 6186 (19614 in chips, €6.75 bounty)
Seat 3: Troll-In1990 (13618 in chips, €4.50 bounty)
Seat 4: saperevedere (18784 in chips, €4.50 bounty)
Seat 5: mateuss771 (8514 in chips, €4.50 bounty)
Seat 6: savin.hsp (5804 in chips, €4.50 bounty)
Seat 7: roby664 (9240 in chips, €4.50 bounty)
Seat 8: jeje_sat (8315 in chips, €4.50 bounty)
Seat 9: CHIPSCRAZYYY (8158 in chips, €4.50 bounty)
rogernu7: posts the ante 60
Aymeric 6186: posts the ante 60
Troll-In1990: posts the ante 60
saperevedere: posts the ante 60
mateuss771: posts the ante 60
savin.hsp: posts the ante 60
roby664: posts the ante 60
jeje_sat: posts the ante 60
CHIPSCRAZYYY: posts the ante 60
roby664: posts small blind 250
jeje_sat: posts big blind 500
*** HOLE CARDS ***
Dealt to jeje_sat [Ts Td]
CHIPSCRAZYYY: folds
saperevedere said, ":*"
rogernu7: folds
Aymeric 6186: calls 500
Troll-In1990: folds
saperevedere: folds
mateuss771: folds
savin.hsp: folds
roby664: raises 8680 to 9180 and is all-in
jeje_sat: calls 7755 and is all-in
Aymeric 6186: calls 8680
*** FLOP *** [5d Ac 5h]
*** TURN *** [5d Ac 5h] [Kc]
*** RIVER *** [5d Ac 5h Kc] [2d]
*** SHOW DOWN ***
roby664: shows [8h 8s] (two pair, Eights and Fives)
Aymeric 6186: shows [6s 6c] (two pair, Sixes and Fives)
roby664 collected 1850 from side pot
jeje_sat: shows [Ts Td] (two pair, Tens and Fives)
jeje_sat collected 25305 from main pot
*** SUMMARY ***
Total pot 27155 Main pot 25305. Side pot 1850. | Rake 0
Board [5d Ac 5h Kc 2d]
Seat 1: rogernu7 folded before Flop (didn't bet)
Seat 2: Aymeric 6186 showed [6s 6c] and lost with two pair, Sixes and Fives
Seat 3: Troll-In1990 folded before Flop (didn't bet)
Seat 4: saperevedere folded before Flop (didn't bet)
Seat 5: mateuss771 folded before Flop (didn't bet)
Seat 6: savin.hsp (button) folded before Flop (didn't bet)
Seat 7: roby664 (small blind) showed [8h 8s] and won (1850) with two pair, Eights and Fives
Seat 8: jeje_sat (big blind) showed [Ts Td] and won (25305) with two pair, Tens and Fives
Seat 9: CHIPSCRAZYYY folded before Flop (didn't bet)


PokerStars Hand #229695218237: Tournament #3253260637, €4.50+€4.50+€1.00 EUR Hold'em No Limit - Level VIII (250/500) - 2021/09/08 21:38:54 CET [2021/09/08 15:38:54 ET]
Table '3253260637 211' 9-max Seat #7 is the button
Seat 1: rogernu7 (34868 in chips, €9 bounty)
Seat 2: Aymeric 6186 (10374 in chips, €6.75 bounty)
Seat 3: Troll-In1990 (13558 in chips, €4.50 bounty)
Seat 4: saperevedere (18724 in chips, €4.50 bounty)
Seat 5: mateuss771 (8454 in chips, €4.50 bounty)
Seat 6: savin.hsp (5744 in chips, €4.50 bounty)
Seat 7: roby664 (1850 in chips, €4.50 bounty)
Seat 8: jeje_sat (25305 in chips, €4.50 bounty)
Seat 9: CHIPSCRAZYYY (8098 in chips, €4.50 bounty)
rogernu7: posts the ante 60
Aymeric 6186: posts the ante 60
Troll-In1990: posts the ante 60
saperevedere: posts the ante 60
mateuss771: posts the ante 60
savin.hsp: posts the ante 60
roby664: posts the ante 60
jeje_sat: posts the ante 60
CHIPSCRAZYYY: posts the ante 60
jeje_sat: posts small blind 250
CHIPSCRAZYYY: posts big blind 500
*** HOLE CARDS ***
Dealt to jeje_sat [Ks As]
rogernu7: folds
Aymeric 6186: calls 500
Troll-In1990: folds
saperevedere: folds
mateuss771: folds
savin.hsp: folds
roby664: raises 1290 to 1790 and is all-in
jeje_sat: raises 23455 to 25245 and is all-in
CHIPSCRAZYYY: folds
Aymeric 6186: folds
Uncalled bet (23455) returned to jeje_sat
*** FLOP *** [8c 9d 3d]
*** TURN *** [8c 9d 3d] [Ac]
*** RIVER *** [8c 9d 3d Ac] [Qd]
*** SHOW DOWN ***
jeje_sat: shows [Ks As] (a pair of Aces)
roby664: shows [Kh 9h] (a pair of Nines)
jeje_sat collected 5120 from pot
jeje_sat wins €2.25 for eliminating roby664 and their own bounty increases by €2.25 to €6.75
roby664 finished the tournament
*** SUMMARY ***
Total pot 5120 | Rake 0
Board [8c 9d 3d Ac Qd]
Seat 1: rogernu7 folded before Flop (didn't bet)
Seat 2: Aymeric 6186 folded before Flop
Seat 3: Troll-In1990 folded before Flop (didn't bet)
Seat 4: saperevedere folded before Flop (didn't bet)
Seat 5: mateuss771 folded before Flop (didn't bet)
Seat 6: savin.hsp folded before Flop (didn't bet)
Seat 7: roby664 (button) showed [Kh 9h] and lost with a pair of Nines
Seat 8: jeje_sat (small blind) showed [Ks As] and won (5120) with a pair of Aces
Seat 9: CHIPSCRAZYYY (big blind) folded before Flop


PokerStars Hand #229695255118: Tournament #3253260637, €4.50+€4.50+€1.00 EUR Hold'em No Limit - Level VIII (250/500) - 2021/09/08 21:40:05 CET [2021/09/08 15:40:05 ET]
Table '3253260637 211' 9-max Seat #8 is the button
Seat 1: rogernu7 (34808 in chips, €9 bounty)
Seat 2: Aymeric 6186 (9814 in chips, €6.75 bounty)
Seat 3: Troll-In1990 (13498 in chips, €4.50 bounty)
Seat 4: saperevedere (18664 in chips, €4.50 bounty)
Seat 5: mateuss771 (8394 in chips, €4.50 bounty)
Seat 6: savin.hsp (5684 in chips, €4.50 bounty)
Seat 8: jeje_sat (28575 in chips, €6.75 bounty)
Seat 9: CHIPSCRAZYYY (7538 in chips, €4.50 bounty)
rogernu7: posts the ante 60
Aymeric 6186: posts the ante 60
Troll-In1990: posts the ante 60
saperevedere: posts the ante 60
mateuss771: posts the ante 60
savin.hsp: posts the ante 60
jeje_sat: posts the ante 60
CHIPSCRAZYYY: posts the ante 60
CHIPSCRAZYYY: posts small blind 250
rogernu7: posts big blind 500
*** HOLE CARDS ***
Dealt to jeje_sat [6d 2s]
Aymeric 6186: raises 9254 to 9754 and is all-in
Troll-In1990: folds
saperevedere: folds
mateuss771: folds
savin.hsp: folds
jeje_sat: folds
CHIPSCRAZYYY: folds
rogernu7: folds
Uncalled bet (9254) returned to Aymeric 6186
Aymeric 6186 collected 1730 from pot
*** SUMMARY ***
Total pot 1730 | Rake 0
Seat 1: rogernu7 (big blind) folded before Flop
Seat 2: Aymeric 6186 collected (1730)
Seat 3: Troll-In1990 folded before Flop (didn't bet)
Seat 4: saperevedere folded before Flop (didn't bet)
Seat 5: mateuss771 folded before Flop (didn't bet)
Seat 6: savin.hsp folded before Flop (didn't bet)
Seat 8: jeje_sat (button) folded before Flop (didn't bet)
Seat 9: CHIPSCRAZYYY (small blind) folded before Flop


PokerStars Hand #229695272363: Tournament #3253260637, €4.50+€4.50+€1.00 EUR Hold'em No Limit - Level VIII (250/500) - 2021/09/08 21:40:37 CET [2021/09/08 15:40:37 ET]
Table '3253260637 211' 9-max Seat #9 is the button
Seat 1: rogernu7 (34248 in chips, €9 bounty)
Seat 2: Aymeric 6186 (10984 in chips, €6.75 bounty)
Seat 3: Troll-In1990 (13438 in chips, €4.50 bounty)
Seat 4: saperevedere (18604 in chips, €4.50 bounty)
Seat 5: mateuss771 (8334 in chips, €4.50 bounty)
Seat 6: savin.hsp (5624 in chips, €4.50 bounty)
Seat 7: kerrlos (17897 in chips, €4.50 bounty)
Seat 8: jeje_sat (28515 in chips, €6.75 bounty)
Seat 9: CHIPSCRAZYYY (7228 in chips, €4.50 bounty)
rogernu7: posts the ante 60
Aymeric 6186: posts the ante 60
Troll-In1990: posts the ante 60
saperevedere: posts the ante 60
mateuss771: posts the ante 60
savin.hsp: posts the ante 60
kerrlos: posts the ante 60
jeje_sat: posts the ante 60
CHIPSCRAZYYY: posts the ante 60
rogernu7: posts small blind 250
Aymeric 6186: posts big blind 500
*** HOLE CARDS ***
Dealt to jeje_sat [Qd 5h]
Troll-In1990: folds
saperevedere: folds
mateuss771: raises 550 to 1050
savin.hsp: folds
kerrlos: folds
jeje_sat: folds
CHIPSCRAZYYY: folds
rogernu7: raises 7838 to 8888
Aymeric 6186: folds
mateuss771: folds
Uncalled bet (7838) returned to rogernu7
rogernu7 collected 3140 from pot
*** SUMMARY ***
Total pot 3140 | Rake 0
Seat 1: rogernu7 (small blind) collected (3140)
Seat 2: Aymeric 6186 (big blind) folded before Flop
Seat 3: Troll-In1990 folded before Flop (didn't bet)
Seat 4: saperevedere folded before Flop (didn't bet)
Seat 5: mateuss771 folded before Flop
Seat 6: savin.hsp folded before Flop (didn't bet)
Seat 7: kerrlos folded before Flop (didn't bet)
Seat 8: jeje_sat folded before Flop (didn't bet)
Seat 9: CHIPSCRAZYYY (button) folded before Flop (didn't bet)


PokerStars Hand #229695291735: Tournament #3253260637, €4.50+€4.50+€1.00 EUR Hold'em No Limit - Level VIII (250/500) - 2021/09/08 21:41:14 CET [2021/09/08 15:41:14 ET]
Table '3253260637 211' 9-max Seat #1 is the button
Seat 1: rogernu7 (36278 in chips, €9 bounty)
Seat 2: Aymeric 6186 (10424 in chips, €6.75 bounty)
Seat 3: Troll-In1990 (13378 in chips, €4.50 bounty)
Seat 4: saperevedere (18544 in chips, €4.50 bounty)
Seat 5: mateuss771 (7224 in chips, €4.50 bounty)
Seat 6: savin.hsp (5564 in chips, €4.50 bounty)
Seat 7: kerrlos (17837 in chips, €4.50 bounty)
Seat 8: jeje_sat (28455 in chips, €6.75 bounty)
Seat 9: CHIPSCRAZYYY (7168 in chips, €4.50 bounty)
rogernu7: posts the ante 60
Aymeric 6186: posts the ante 60
Troll-In1990: posts the ante 60
saperevedere: posts the ante 60
mateuss771: posts the ante 60
savin.hsp: posts the ante 60
kerrlos: posts the ante 60
jeje_sat: posts the ante 60
CHIPSCRAZYYY: posts the ante 60
Aymeric 6186: posts small blind 250
Troll-In1990: posts big blind 500
*** HOLE CARDS ***
Dealt to jeje_sat [6c 6h]
saperevedere: folds
mateuss771: folds
savin.hsp: folds
kerrlos: folds
jeje_sat: raises 1000 to 1500
CHIPSCRAZYYY: folds
rogernu7: folds
Aymeric 6186: folds
Troll-In1990: calls 1000
*** FLOP *** [5h 9s Qc]
Troll-In1990: checks
jeje_sat: bets 1895
Troll-In1990: calls 1895
*** TURN *** [5h 9s Qc] [5c]
Troll-In1990: checks
jeje_sat: checks
*** RIVER *** [5h 9s Qc 5c] [2c]
Troll-In1990: bets 2170
jeje_sat: calls 2170
*** SHOW DOWN ***
Troll-In1990: shows [Ac Js] (a pair of Fives)
jeje_sat: shows [6c 6h] (two pair, Sixes and Fives)
jeje_sat collected 11920 from pot
*** SUMMARY ***
Total pot 11920 | Rake 0
Board [5h 9s Qc 5c 2c]
Seat 1: rogernu7 (button) folded before Flop (didn't bet)
Seat 2: Aymeric 6186 (small blind) folded before Flop
Seat 3: Troll-In1990 (big blind) showed [Ac Js] and lost with a pair of Fives
Seat 4: saperevedere folded before Flop (didn't bet)
Seat 5: mateuss771 folded before Flop (didn't bet)
Seat 6: savin.hsp folded before Flop (didn't bet)
Seat 7: kerrlos folded before Flop (didn't bet)
Seat 8: jeje_sat showed [6c 6h] and won (11920) with two pair, Sixes and Fives
Seat 9: CHIPSCRAZYYY folded before Flop (didn't bet)


PokerStars Hand #229695332339: Tournament #3253260637, €4.50+€4.50+€1.00 EUR Hold'em No Limit - Level VIII (250/500) - 2021/09/08 21:42:32 CET [2021/09/08 15:42:32 ET]
Table '3253260637 211' 9-max Seat #2 is the button
Seat 1: rogernu7 (36218 in chips, €9 bounty)
Seat 2: Aymeric 6186 (10114 in chips, €6.75 bounty)
Seat 3: Troll-In1990 (7753 in chips, €4.50 bounty)
Seat 4: saperevedere (18484 in chips, €4.50 bounty)
Seat 5: mateuss771 (7164 in chips, €4.50 bounty)
Seat 6: savin.hsp (5504 in chips, €4.50 bounty)
Seat 7: kerrlos (17777 in chips, €4.50 bounty)
Seat 8: jeje_sat (34750 in chips, €6.75 bounty)
Seat 9: CHIPSCRAZYYY (7108 in chips, €4.50 bounty)
rogernu7: posts the ante 60
Aymeric 6186: posts the ante 60
Troll-In1990: posts the ante 60
saperevedere: posts the ante 60
mateuss771: posts the ante 60
savin.hsp: posts the ante 60
kerrlos: posts the ante 60
jeje_sat: posts the ante 60
CHIPSCRAZYYY: posts the ante 60
Troll-In1990: posts small blind 250
saperevedere: posts big blind 500
*** HOLE CARDS ***
Dealt to jeje_sat [3d 6d]
mateuss771: folds
savin.hsp: folds
kerrlos: folds
jeje_sat: folds
CHIPSCRAZYYY: folds
rogernu7: folds
Aymeric 6186: folds
Troll-In1990: calls 250
saperevedere: checks
*** FLOP *** [Kc Jh Tc]
Troll-In1990: checks
saperevedere: bets 770
Troll-In1990: calls 770
*** TURN *** [Kc Jh Tc] [4h]
Troll-In1990: checks
saperevedere: checks
*** RIVER *** [Kc Jh Tc 4h] [Ah]
Troll-In1990: checks
saperevedere: checks
*** SHOW DOWN ***
Troll-In1990: shows [6c Jd] (a pair of Jacks)
saperevedere: mucks hand
Troll-In1990 collected 3080 from pot
*** SUMMARY ***
Total pot 3080 | Rake 0
Board [Kc Jh Tc 4h Ah]
Seat 1: rogernu7 folded before Flop (didn't bet)
Seat 2: Aymeric 6186 (button) folded before Flop (didn't bet)
Seat 3: Troll-In1990 (small blind) showed [6c Jd] and won (3080) with a pair of Jacks
Seat 4: saperevedere (big blind) mucked [7c 4d]
Seat 5: mateuss771 folded before Flop (didn't bet)
Seat 6: savin.hsp folded before Flop (didn't bet)
Seat 7: kerrlos folded before Flop (didn't bet)
Seat 8: jeje_sat folded before Flop (didn't bet)
Seat 9: CHIPSCRAZYYY folded before Flop (didn't bet)


PokerStars Hand #229695368248: Tournament #3253260637, €4.50+€4.50+€1.00 EUR Hold'em No Limit - Level VIII (250/500) - 2021/09/08 21:43:40 CET [2021/09/08 15:43:40 ET]
Table '3253260637 211' 9-max Seat #3 is the button
Seat 1: rogernu7 (36158 in chips, €9 bounty)
Seat 2: Aymeric 6186 (10054 in chips, €6.75 bounty)
Seat 3: Troll-In1990 (9503 in chips, €4.50 bounty)
Seat 4: saperevedere (17154 in chips, €4.50 bounty)
Seat 5: mateuss771 (7104 in chips, €4.50 bounty)
Seat 6: savin.hsp (5444 in chips, €4.50 bounty)
Seat 7: kerrlos (17717 in chips, €4.50 bounty)
Seat 8: jeje_sat (34690 in chips, €6.75 bounty)
Seat 9: CHIPSCRAZYYY (7048 in chips, €4.50 bounty)
rogernu7: posts the ante 60
Aymeric 6186: posts the ante 60
Troll-In1990: posts the ante 60
saperevedere: posts the ante 60
mateuss771: posts the ante 60
savin.hsp: posts the ante 60
kerrlos: posts the ante 60
jeje_sat: posts the ante 60
CHIPSCRAZYYY: posts the ante 60
saperevedere: posts small blind 250
mateuss771: posts big blind 500
*** HOLE CARDS ***
Dealt to jeje_sat [3d Ad]
savin.hsp: folds
kerrlos: folds
jeje_sat: raises 1000 to 1500
CHIPSCRAZYYY: folds
rogernu7: folds
Aymeric 6186: calls 1500
Troll-In1990: calls 1500
saperevedere: folds
mateuss771: calls 1000
*** FLOP *** [Ah 8h 2d]
mateuss771: checks
jeje_sat: bets 3395
Aymeric 6186: raises 5099 to 8494 and is all-in
Troll-In1990: folds
mateuss771: folds
jeje_sat: calls 5099
*** TURN *** [Ah 8h 2d] [6d]
*** RIVER *** [Ah 8h 2d 6d] [Qs]
*** SHOW DOWN ***
jeje_sat: shows [3d Ad] (a pair of Aces)
Aymeric 6186: shows [Ac Kh] (a pair of Aces - King kicker)
Aymeric 6186 collected 23778 from pot
*** SUMMARY ***
Total pot 23778 | Rake 0
Board [Ah 8h 2d 6d Qs]
Seat 1: rogernu7 folded before Flop (didn't bet)
Seat 2: Aymeric 6186 showed [Ac Kh] and won (23778) with a pair of Aces
Seat 3: Troll-In1990 (button) folded on the Flop
Seat 4: saperevedere (small blind) folded before Flop
Seat 5: mateuss771 (big blind) folded on the Flop
Seat 6: savin.hsp folded before Flop (didn't bet)
Seat 7: kerrlos folded before Flop (didn't bet)
Seat 8: jeje_sat showed [3d Ad] and lost with a pair of Aces
Seat 9: CHIPSCRAZYYY folded before Flop (didn't bet)


PokerStars Hand #229695400770: Tournament #3253260637, €4.50+€4.50+€1.00 EUR Hold'em No Limit - Level IX (300/600) - 2021/09/08 21:44:42 CET [2021/09/08 15:44:42 ET]
Table '3253260637 211' 9-max Seat #4 is the button
Seat 1: rogernu7 (36098 in chips, €9 bounty)
Seat 2: Aymeric 6186 (23778 in chips, €6.75 bounty)
Seat 3: Troll-In1990 (7943 in chips, €4.50 bounty)
Seat 4: saperevedere (16844 in chips, €4.50 bounty)
Seat 5: mateuss771 (5544 in chips, €4.50 bounty)
Seat 6: savin.hsp (5384 in chips, €4.50 bounty)
Seat 7: kerrlos (17657 in chips, €4.50 bounty)
Seat 8: jeje_sat (24636 in chips, €6.75 bounty)
Seat 9: CHIPSCRAZYYY (6988 in chips, €4.50 bounty)
rogernu7: posts the ante 70
Aymeric 6186: posts the ante 70
Troll-In1990: posts the ante 70
saperevedere: posts the ante 70
mateuss771: posts the ante 70
savin.hsp: posts the ante 70
kerrlos: posts the ante 70
jeje_sat: posts the ante 70
CHIPSCRAZYYY: posts the ante 70
mateuss771: posts small blind 300
savin.hsp: posts big blind 600
*** HOLE CARDS ***
Dealt to jeje_sat [6s 3h]
kerrlos: raises 720 to 1320
jeje_sat: folds
CHIPSCRAZYYY: folds
rogernu7: calls 1320
Aymeric 6186: folds
Troll-In1990: folds
saperevedere: folds
mateuss771: raises 4154 to 5474 and is all-in
savin.hsp: folds
kerrlos: raises 12113 to 17587 and is all-in
rogernu7: calls 16267
*** FLOP *** [9s Jc Ah]
*** TURN *** [9s Jc Ah] [5h]
*** RIVER *** [9s Jc Ah 5h] [Kc]
*** SHOW DOWN ***
kerrlos: shows [Kd Kh] (three of a kind, Kings)
rogernu7: shows [5c 5d] (three of a kind, Fives)
kerrlos collected 24226 from side pot
mateuss771: shows [Qd Qc] (a pair of Queens)
kerrlos collected 17652 from main pot
kerrlos wins €2.25 for eliminating mateuss771 and their own bounty increases by €2.25 to €6.75
mateuss771 finished the tournament
*** SUMMARY ***
Total pot 41878 Main pot 17652. Side pot 24226. | Rake 0
Board [9s Jc Ah 5h Kc]
Seat 1: rogernu7 showed [5c 5d] and lost with three of a kind, Fives
Seat 2: Aymeric 6186 folded before Flop (didn't bet)
Seat 3: Troll-In1990 folded before Flop (didn't bet)
Seat 4: saperevedere (button) folded before Flop (didn't bet)
Seat 5: mateuss771 (small blind) showed [Qd Qc] and lost with a pair of Queens
Seat 6: savin.hsp (big blind) folded before Flop
Seat 7: kerrlos showed [Kd Kh] and won (41878) with three of a kind, Kings
Seat 8: jeje_sat folded before Flop (didn't bet)
Seat 9: CHIPSCRAZYYY folded before Flop (didn't bet)


PokerStars Hand #229695430221: Tournament #3253260637, €4.50+€4.50+€1.00 EUR Hold'em No Limit - Level IX (300/600) - 2021/09/08 21:45:35 CET [2021/09/08 15:45:35 ET]
Table '3253260637 211' 9-max Seat #6 is the button
Seat 1: rogernu7 (18441 in chips, €9 bounty)
Seat 2: Aymeric 6186 (23708 in chips, €6.75 bounty)
Seat 3: Troll-In1990 (7873 in chips, €4.50 bounty)
Seat 4: saperevedere (16774 in chips, €4.50 bounty)
Seat 6: savin.hsp (4714 in chips, €4.50 bounty)
Seat 7: kerrlos (41878 in chips, €6.75 bounty)
Seat 8: jeje_sat (24566 in chips, €6.75 bounty)
Seat 9: CHIPSCRAZYYY (6918 in chips, €4.50 bounty)
rogernu7: posts the ante 70
Aymeric 6186: posts the ante 70
Troll-In1990: posts the ante 70
saperevedere: posts the ante 70
savin.hsp: posts the ante 70
kerrlos: posts the ante 70
jeje_sat: posts the ante 70
CHIPSCRAZYYY: posts the ante 70
kerrlos: posts small blind 300
jeje_sat: posts big blind 600
*** HOLE CARDS ***
Dealt to jeje_sat [3s Td]
CHIPSCRAZYYY: folds
rogernu7: folds
Aymeric 6186: folds
Troll-In1990: folds
saperevedere: folds
savin.hsp: raises 4044 to 4644 and is all-in
kerrlos: folds
jeje_sat: folds
Uncalled bet (4044) returned to savin.hsp
savin.hsp collected 2060 from pot
savin.hsp: doesn't show hand
*** SUMMARY ***
Total pot 2060 | Rake 0
Seat 1: rogernu7 folded before Flop (didn't bet)
Seat 2: Aymeric 6186 folded before Flop (didn't bet)
Seat 3: Troll-In1990 folded before Flop (didn't bet)
Seat 4: saperevedere folded before Flop (didn't bet)
Seat 6: savin.hsp (button) collected (2060)
Seat 7: kerrlos (small blind) folded before Flop
Seat 8: jeje_sat (big blind) folded before Flop
Seat 9: CHIPSCRAZYYY folded before Flop (didn't bet)


PokerStars Hand #229695452925: Tournament #3253260637, €4.50+€4.50+€1.00 EUR Hold'em No Limit - Level IX (300/600) - 2021/09/08 21:46:18 CET [2021/09/08 15:46:18 ET]
Table '3253260637 211' 9-max Seat #7 is the button
Seat 1: rogernu7 (18371 in chips, €9 bounty)
Seat 2: Aymeric 6186 (23638 in chips, €6.75 bounty)
Seat 3: Troll-In1990 (7803 in chips, €4.50 bounty)
Seat 4: saperevedere (16704 in chips, €4.50 bounty)
Seat 6: savin.hsp (6104 in chips, €4.50 bounty)
Seat 7: kerrlos (41508 in chips, €6.75 bounty)
Seat 8: jeje_sat (23896 in chips, €6.75 bounty)
Seat 9: CHIPSCRAZYYY (6848 in chips, €4.50 bounty)
rogernu7: posts the ante 70
Aymeric 6186: posts the ante 70
Troll-In1990: posts the ante 70
saperevedere: posts the ante 70
savin.hsp: posts the ante 70
kerrlos: posts the ante 70
jeje_sat: posts the ante 70
CHIPSCRAZYYY: posts the ante 70
jeje_sat: posts small blind 300
CHIPSCRAZYYY: posts big blind 600
*** HOLE CARDS ***
Dealt to jeje_sat [Js Kh]
rogernu7: folds
Aymeric 6186: folds
Troll-In1990: raises 600 to 1200
saperevedere: folds
savin.hsp: folds
kerrlos: folds
jeje_sat: calls 900
CHIPSCRAZYYY: calls 600
*** FLOP *** [3c Tc Ah]
jeje_sat: checks
CHIPSCRAZYYY: checks
Troll-In1990: bets 1800
jeje_sat: calls 1800
CHIPSCRAZYYY: raises 3778 to 5578 and is all-in
Troll-In1990: raises 955 to 6533 and is all-in
jeje_sat: calls 4733
*** TURN *** [3c Tc Ah] [5d]
*** RIVER *** [3c Tc Ah 5d] [Jc]
*** SHOW DOWN ***
jeje_sat: shows [Js Kh] (a pair of Jacks)
Troll-In1990: shows [9h Ac] (a pair of Aces)
Troll-In1990 collected 1910 from side pot
CHIPSCRAZYYY: shows [Ad 4c] (a pair of Aces - lower kicker)
Troll-In1990 collected 20894 from main pot
Troll-In1990 wins €2.25 for eliminating CHIPSCRAZYYY and their own bounty increases by €2.25 to €6.75
CHIPSCRAZYYY finished the tournament
*** SUMMARY ***
Total pot 22804 Main pot 20894. Side pot 1910. | Rake 0
Board [3c Tc Ah 5d Jc]
Seat 1: rogernu7 folded before Flop (didn't bet)
Seat 2: Aymeric 6186 folded before Flop (didn't bet)
Seat 3: Troll-In1990 showed [9h Ac] and won (22804) with a pair of Aces
Seat 4: saperevedere folded before Flop (didn't bet)
Seat 6: savin.hsp folded before Flop (didn't bet)
Seat 7: kerrlos (button) folded before Flop (didn't bet)
Seat 8: jeje_sat (small blind) showed [Js Kh] and lost with a pair of Jacks
Seat 9: CHIPSCRAZYYY (big blind) showed [Ad 4c] and lost with a pair of Aces


PokerStars Hand #229695496323: Tournament #3253260637, €4.50+€4.50+€1.00 EUR Hold'em No Limit - Level IX (300/600) - 2021/09/08 21:47:41 CET [2021/09/08 15:47:41 ET]
Table '3253260637 211' 9-max Seat #8 is the button
Seat 1: rogernu7 (18301 in chips, €9 bounty)
Seat 2: Aymeric 6186 (23568 in chips, €6.75 bounty)
Seat 3: Troll-In1990 (22804 in chips, €6.75 bounty)
Seat 4: saperevedere (16634 in chips, €4.50 bounty)
Seat 5: actezer (10000 in chips, €4.50 bounty)
Seat 6: savin.hsp (6034 in chips, €4.50 bounty)
Seat 7: kerrlos (41438 in chips, €6.75 bounty)
Seat 8: jeje_sat (16093 in chips, €6.75 bounty)
rogernu7: posts the ante 70
Aymeric 6186: posts the ante 70
Troll-In1990: posts the ante 70
saperevedere: posts the ante 70
actezer: posts the ante 70
savin.hsp: posts the ante 70
kerrlos: posts the ante 70
jeje_sat: posts the ante 70
rogernu7: posts small blind 300
Aymeric 6186: posts big blind 600
*** HOLE CARDS ***
Dealt to jeje_sat [Td 7c]
Troll-In1990: folds
saperevedere: raises 780 to 1380
actezer: calls 1380
savin.hsp: folds
kerrlos: folds
jeje_sat: folds
rogernu7: calls 1080
Aymeric 6186: folds
*** FLOP *** [5d Ac 2c]
rogernu7: checks
saperevedere: bets 1749
actezer: folds
rogernu7: folds
Uncalled bet (1749) returned to saperevedere
saperevedere collected 5300 from pot
*** SUMMARY ***
Total pot 5300 | Rake 0
Board [5d Ac 2c]
Seat 1: rogernu7 (small blind) folded on the Flop
Seat 2: Aymeric 6186 (big blind) folded before Flop
Seat 3: Troll-In1990 folded before Flop (didn't bet)
Seat 4: saperevedere collected (5300)
Seat 5: actezer folded on the Flop
Seat 6: savin.hsp folded before Flop (didn't bet)
Seat 7: kerrlos folded before Flop (didn't bet)
Seat 8: jeje_sat (button) folded before Flop (didn't bet)


PokerStars Hand #229695543613: Tournament #3253260637, €4.50+€4.50+€1.00 EUR Hold'em No Limit - Level IX (300/600) - 2021/09/08 21:49:12 CET [2021/09/08 15:49:12 ET]
Table '3253260637 211' 9-max Seat #1 is the button
Seat 1: rogernu7 (16851 in chips, €9 bounty)
Seat 2: Aymeric 6186 (22898 in chips, €6.75 bounty)
Seat 3: Troll-In1990 (22734 in chips, €6.75 bounty)
Seat 4: saperevedere (20484 in chips, €4.50 bounty)
Seat 5: actezer (8550 in chips, €4.50 bounty)
Seat 6: savin.hsp (5964 in chips, €4.50 bounty)
Seat 7: kerrlos (41368 in chips, €6.75 bounty)
Seat 8: jeje_sat (16023 in chips, €6.75 bounty)
Seat 9: lorenx666 (10000 in chips, €4.50 bounty)
rogernu7: posts the ante 70
Aymeric 6186: posts the ante 70
Troll-In1990: posts the ante 70
saperevedere: posts the ante 70
actezer: posts the ante 70
savin.hsp: posts the ante 70
kerrlos: posts the ante 70
jeje_sat: posts the ante 70
lorenx666: posts the ante 70
Aymeric 6186: posts small blind 300
Troll-In1990: posts big blind 600
*** HOLE CARDS ***
Dealt to jeje_sat [Kc 6h]
saperevedere: folds
actezer: folds
savin.hsp: folds
kerrlos: raises 720 to 1320
jeje_sat: folds
lorenx666: folds
rogernu7: folds
Aymeric 6186: folds
Troll-In1990: calls 720
*** FLOP *** [4c 5c 8d]
Troll-In1990: checks
kerrlos: checks
*** TURN *** [4c 5c 8d] [Ts]
Troll-In1990: checks
kerrlos: bets 1999
Troll-In1990: calls 1999
*** RIVER *** [4c 5c 8d Ts] [Ac]
Troll-In1990: bets 4345
kerrlos: calls 4345
*** SHOW DOWN ***
Troll-In1990: shows [4s 4h] (three of a kind, Fours)
kerrlos: mucks hand
Troll-In1990 collected 16258 from pot
*** SUMMARY ***
Total pot 16258 | Rake 0
Board [4c 5c 8d Ts Ac]
Seat 1: rogernu7 (button) folded before Flop (didn't bet)
Seat 2: Aymeric 6186 (small blind) folded before Flop
Seat 3: Troll-In1990 (big blind) showed [4s 4h] and won (16258) with three of a kind, Fours
Seat 4: saperevedere folded before Flop (didn't bet)
Seat 5: actezer folded before Flop (didn't bet)
Seat 6: savin.hsp folded before Flop (didn't bet)
Seat 7: kerrlos mucked [As 8s]
Seat 8: jeje_sat folded before Flop (didn't bet)
Seat 9: lorenx666 folded before Flop (didn't bet)


PokerStars Hand #229695618292: Tournament #3253260637, €4.50+€4.50+€1.00 EUR Hold'em No Limit - Level IX (300/600) - 2021/09/08 21:51:35 CET [2021/09/08 15:51:35 ET]
Table '3253260637 211' 9-max Seat #2 is the button
Seat 1: rogernu7 (16781 in chips, €9 bounty)
Seat 2: Aymeric 6186 (22528 in chips, €6.75 bounty)
Seat 3: Troll-In1990 (31258 in chips, €6.75 bounty)
Seat 4: saperevedere (20414 in chips, €4.50 bounty)
Seat 5: actezer (8480 in chips, €4.50 bounty)
Seat 6: savin.hsp (5894 in chips, €4.50 bounty)
Seat 7: kerrlos (33634 in chips, €6.75 bounty)
Seat 8: jeje_sat (15953 in chips, €6.75 bounty)
Seat 9: lorenx666 (9930 in chips, €4.50 bounty)
rogernu7: posts the ante 70
Aymeric 6186: posts the ante 70
Troll-In1990: posts the ante 70
saperevedere: posts the ante 70
actezer: posts the ante 70
savin.hsp: posts the ante 70
kerrlos: posts the ante 70
jeje_sat: posts the ante 70
lorenx666: posts the ante 70
Troll-In1990: posts small blind 300
saperevedere: posts big blind 600
*** HOLE CARDS ***
Dealt to jeje_sat [6d 9d]
actezer: raises 7810 to 8410 and is all-in
savin.hsp: calls 5824 and is all-in
kerrlos: folds
jeje_sat: folds
lorenx666: raises 1450 to 9860 and is all-in
rogernu7: folds
Aymeric 6186: folds
Troll-In1990: folds
saperevedere: folds
Uncalled bet (1450) returned to lorenx666
*** FLOP *** [5h 8h 7s]
*** TURN *** [5h 8h 7s] [4d]
*** RIVER *** [5h 8h 7s 4d] [4h]
*** SHOW DOWN ***
actezer: shows [Qh 3h] (a flush, Queen high)
lorenx666: shows [Qc Td] (a pair of Fours)
actezer collected 5172 from side pot
savin.hsp: shows [8c 8s] (a full house, Eights full of Fours)
savin.hsp collected 19002 from main pot
*** SUMMARY ***
Total pot 24174 Main pot 19002. Side pot 5172. | Rake 0
Board [5h 8h 7s 4d 4h]
Seat 1: rogernu7 folded before Flop (didn't bet)
Seat 2: Aymeric 6186 (button) folded before Flop (didn't bet)
Seat 3: Troll-In1990 (small blind) folded before Flop
Seat 4: saperevedere (big blind) folded before Flop
Seat 5: actezer showed [Qh 3h] and won (5172) with a flush, Queen high
Seat 6: savin.hsp showed [8c 8s] and won (19002) with a full house, Eights full of Fours
Seat 7: kerrlos folded before Flop (didn't bet)
Seat 8: jeje_sat folded before Flop (didn't bet)
Seat 9: lorenx666 showed [Qc Td] and lost with a pair of Fours


PokerStars Hand #229695651734: Tournament #3253260637, €4.50+€4.50+€1.00 EUR Hold'em No Limit - Level IX (300/600) - 2021/09/08 21:52:25 CET [2021/09/08 15:52:25 ET]
Table '3253260637 211' 9-max Seat #3 is the button
Seat 1: rogernu7 (16711 in chips, €9 bounty)
Seat 2: Aymeric 6186 (22458 in chips, €6.75 bounty)
Seat 3: Troll-In1990 (30888 in chips, €6.75 bounty)
Seat 4: saperevedere (19744 in chips, €4.50 bounty)
Seat 5: actezer (5172 in chips, €4.50 bounty)
Seat 6: savin.hsp (19002 in chips, €4.50 bounty)
Seat 7: kerrlos (33564 in chips, €6.75 bounty)
Seat 8: jeje_sat (15883 in chips, €6.75 bounty)
Seat 9: lorenx666 (1450 in chips, €4.50 bounty)
rogernu7: posts the ante 70
Aymeric 6186: posts the ante 70
Troll-In1990: posts the ante 70
saperevedere: posts the ante 70
actezer: posts the ante 70
savin.hsp: posts the ante 70
kerrlos: posts the ante 70
jeje_sat: posts the ante 70
lorenx666: posts the ante 70
saperevedere: posts small blind 300
actezer: posts big blind 600
*** HOLE CARDS ***
Dealt to jeje_sat [6s Jd]
savin.hsp: folds
kerrlos: folds
jeje_sat: folds
lorenx666: raises 780 to 1380 and is all-in
rogernu7: calls 1380
Aymeric 6186: folds
Troll-In1990: raises 29438 to 30818 and is all-in
saperevedere: folds
actezer: calls 4502 and is all-in
rogernu7: folds
Uncalled bet (25716) returned to Troll-In1990
*** FLOP *** [Ad 9h 7s]
*** TURN *** [Ad 9h 7s] [Ts]
*** RIVER *** [Ad 9h 7s Ts] [Qd]
*** SHOW DOWN ***
actezer: shows [5c Qc] (a pair of Queens)
Troll-In1990: shows [Kh Ah] (a pair of Aces)
Troll-In1990 collected 7444 from side pot
lorenx666: shows [Kd 4s] (high card Ace)
Troll-In1990 collected 6450 from main pot
Troll-In1990 wins €2.25 for eliminating actezer and their own bounty increases by €2.25 to €9
Troll-In1990 wins €2.25 for eliminating lorenx666 and their own bounty increases by €2.25 to €11.25
actezer finished the tournament
lorenx666 finished the tournament
*** SUMMARY ***
Total pot 13894 Main pot 6450. Side pot 7444. | Rake 0
Board [Ad 9h 7s Ts Qd]
Seat 1: rogernu7 folded before Flop
Seat 2: Aymeric 6186 folded before Flop (didn't bet)
Seat 3: Troll-In1990 (button) showed [Kh Ah] and won (13894) with a pair of Aces
Seat 4: saperevedere (small blind) folded before Flop
Seat 5: actezer (big blind) showed [5c Qc] and lost with a pair of Queens
Seat 6: savin.hsp folded before Flop (didn't bet)
Seat 7: kerrlos folded before Flop (didn't bet)
Seat 8: jeje_sat folded before Flop (didn't bet)
Seat 9: lorenx666 showed [Kd 4s] and lost with high card Ace


PokerStars Hand #229695689176: Tournament #3253260637, €4.50+€4.50+€1.00 EUR Hold'em No Limit - Level X (350/700) - 2021/09/08 21:53:25 CET [2021/09/08 15:53:25 ET]
Table '3253260637 211' 9-max Seat #4 is the button
Seat 1: rogernu7 (15261 in chips, €9 bounty)
Seat 2: Aymeric 6186 (22388 in chips, €6.75 bounty)
Seat 3: Troll-In1990 (39610 in chips, €11.25 bounty)
Seat 4: saperevedere (19374 in chips, €4.50 bounty)
Seat 5: Tio Dany77 (8335 in chips) out of hand (moved from another table into small blind)
Seat 6: savin.hsp (18932 in chips, €4.50 bounty)
Seat 7: kerrlos (33494 in chips, €6.75 bounty)
Seat 8: jeje_sat (15813 in chips, €6.75 bounty)
Tio Dany77 will be allowed to play after the button
rogernu7: posts the ante 85
Aymeric 6186: posts the ante 85
Troll-In1990: posts the ante 85
saperevedere: posts the ante 85
savin.hsp: posts the ante 85
kerrlos: posts the ante 85
jeje_sat: posts the ante 85
savin.hsp: posts small blind 350
kerrlos: posts big blind 700
*** HOLE CARDS ***
Dealt to jeje_sat [4c Qd]
jeje_sat: folds
rogernu7: folds
Aymeric 6186: folds
Troll-In1990: calls 700
saperevedere: folds
savin.hsp: folds
kerrlos: checks
*** FLOP *** [7c 6s 3s]
kerrlos: checks
Troll-In1990: bets 1204
kerrlos: folds
Uncalled bet (1204) returned to Troll-In1990
Troll-In1990 collected 2345 from pot
Troll-In1990: doesn't show hand
*** SUMMARY ***
Total pot 2345 | Rake 0
Board [7c 6s 3s]
Seat 1: rogernu7 folded before Flop (didn't bet)
Seat 2: Aymeric 6186 folded before Flop (didn't bet)
Seat 3: Troll-In1990 collected (2345)
Seat 4: saperevedere (button) folded before Flop (didn't bet)
Seat 6: savin.hsp (small blind) folded before Flop
Seat 7: kerrlos (big blind) folded on the Flop
Seat 8: jeje_sat folded before Flop (didn't bet)


PokerStars Hand #229695718970: Tournament #3253260637, €4.50+€4.50+€1.00 EUR Hold'em No Limit - Level X (350/700) - 2021/09/08 21:54:23 CET [2021/09/08 15:54:23 ET]
Table '3253260637 211' 9-max Seat #6 is the button
Seat 1: rogernu7 (15176 in chips, €9 bounty)
Seat 2: Aymeric 6186 (22303 in chips, €6.75 bounty)
Seat 3: Troll-In1990 (41170 in chips, €11.25 bounty)
Seat 4: saperevedere (19289 in chips, €4.50 bounty)
Seat 5: Tio Dany77 (8335 in chips, €4.50 bounty)
Seat 6: savin.hsp (18497 in chips, €4.50 bounty)
Seat 7: kerrlos (32709 in chips, €6.75 bounty)
Seat 8: jeje_sat (15728 in chips, €6.75 bounty)
Seat 9: Brainkiiller (24751 in chips, €9 bounty)
rogernu7: posts the ante 85
Aymeric 6186: posts the ante 85
Troll-In1990: posts the ante 85
saperevedere: posts the ante 85
Tio Dany77: posts the ante 85
savin.hsp: posts the ante 85
kerrlos: posts the ante 85
jeje_sat: posts the ante 85
Brainkiiller: posts the ante 85
kerrlos: posts small blind 350
jeje_sat: posts big blind 700
*** HOLE CARDS ***
Dealt to jeje_sat [3c Jc]
Brainkiiller: folds
rogernu7: folds
Aymeric 6186: folds
Troll-In1990: folds
saperevedere: folds
Tio Dany77: calls 700
savin.hsp: folds
kerrlos: folds
jeje_sat: checks
*** FLOP *** [Qd 2h Js]
jeje_sat: bets 1258
Tio Dany77: calls 1258
*** TURN *** [Qd 2h Js] [Ks]
jeje_sat: checks
Tio Dany77: checks
*** RIVER *** [Qd 2h Js Ks] [6h]
jeje_sat: checks
Tio Dany77: checks
*** SHOW DOWN ***
jeje_sat: shows [3c Jc] (a pair of Jacks)
Tio Dany77: mucks hand
jeje_sat collected 5031 from pot
*** SUMMARY ***
Total pot 5031 | Rake 0
Board [Qd 2h Js Ks 6h]
Seat 1: rogernu7 folded before Flop (didn't bet)
Seat 2: Aymeric 6186 folded before Flop (didn't bet)
Seat 3: Troll-In1990 folded before Flop (didn't bet)
Seat 4: saperevedere folded before Flop (didn't bet)
Seat 5: Tio Dany77 mucked [Tc 8d]
Seat 6: savin.hsp (button) folded before Flop (didn't bet)
Seat 7: kerrlos (small blind) folded before Flop
Seat 8: jeje_sat (big blind) showed [3c Jc] and won (5031) with a pair of Jacks
Seat 9: Brainkiiller folded before Flop (didn't bet)


PokerStars Hand #229696046204: Tournament #3253260637, €4.50+€4.50+€1.00 EUR Hold'em No Limit - Level X (350/700) - 2021/09/08 22:06:45 CET [2021/09/08 16:06:45 ET]
Table '3253260637 211' 9-max Seat #9 is the button
Seat 1: rogernu7 (14221 in chips, €9 bounty)
Seat 2: Aymeric 6186 (21348 in chips, €6.75 bounty)
Seat 3: 1881285 (9830 in chips, €4.50 bounty)
Seat 4: saperevedere (22599 in chips, €4.50 bounty)
Seat 5: Tio Dany77 (7937 in chips, €4.50 bounty)
Seat 6: savin.hsp (18242 in chips, €4.50 bounty)
Seat 7: kerrlos (31404 in chips, €6.75 bounty)
Seat 8: jeje_sat (18196 in chips, €6.75 bounty) is sitting out
Seat 9: Brainkiiller (23096 in chips, €9 bounty)
rogernu7: posts the ante 85
Aymeric 6186: posts the ante 85
1881285: posts the ante 85
saperevedere: posts the ante 85
Tio Dany77: posts the ante 85
savin.hsp: posts the ante 85
kerrlos: posts the ante 85
jeje_sat: posts the ante 85
Brainkiiller: posts the ante 85
rogernu7: posts small blind 350
Aymeric 6186: posts big blind 700
*** HOLE CARDS ***
Dealt to jeje_sat [5h 4c]
1881285: folds
saperevedere: folds
Tio Dany77: calls 700
jeje_sat has returned
savin.hsp: folds
kerrlos: folds
jeje_sat: folds
Brainkiiller: raises 2800 to 3500
rogernu7: folds
Aymeric 6186: folds
Tio Dany77: calls 2800
*** FLOP *** [Ac 9h 6h]
Tio Dany77: checks
Brainkiiller: checks
*** TURN *** [Ac 9h 6h] [8s]
Tio Dany77: checks
Brainkiiller: bets 4900
Tio Dany77: folds
Uncalled bet (4900) returned to Brainkiiller
Brainkiiller collected 8815 from pot
Brainkiiller: doesn't show hand
*** SUMMARY ***
Total pot 8815 | Rake 0
Board [Ac 9h 6h 8s]
Seat 1: rogernu7 (small blind) folded before Flop
Seat 2: Aymeric 6186 (big blind) folded before Flop
Seat 3: 1881285 folded before Flop (didn't bet)
Seat 4: saperevedere folded before Flop (didn't bet)
Seat 5: Tio Dany77 folded on the Turn
Seat 6: savin.hsp folded before Flop (didn't bet)
Seat 7: kerrlos folded before Flop (didn't bet)
Seat 8: jeje_sat folded before Flop (didn't bet)
Seat 9: Brainkiiller (button) collected (8815)


PokerStars Hand #229696084302: Tournament #3253260637, €4.50+€4.50+€1.00 EUR Hold'em No Limit - Level XI (400/800) - 2021/09/08 22:07:58 CET [2021/09/08 16:07:58 ET]
Table '3253260637 211' 9-max Seat #1 is the button
Seat 1: rogernu7 (13786 in chips, €9 bounty)
Seat 2: Aymeric 6186 (20563 in chips, €6.75 bounty)
Seat 3: 1881285 (9745 in chips, €4.50 bounty)
Seat 4: saperevedere (22514 in chips, €4.50 bounty)
Seat 5: Tio Dany77 (4352 in chips, €4.50 bounty)
Seat 6: savin.hsp (18157 in chips, €4.50 bounty)
Seat 7: kerrlos (31319 in chips, €6.75 bounty)
Seat 8: jeje_sat (18111 in chips, €6.75 bounty)
Seat 9: Brainkiiller (28326 in chips, €9 bounty)
rogernu7: posts the ante 100
Aymeric 6186: posts the ante 100
1881285: posts the ante 100
saperevedere: posts the ante 100
Tio Dany77: posts the ante 100
savin.hsp: posts the ante 100
kerrlos: posts the ante 100
jeje_sat: posts the ante 100
Brainkiiller: posts the ante 100
Aymeric 6186: posts small blind 400
1881285: posts big blind 800
*** HOLE CARDS ***
Dealt to jeje_sat [Ah Jc]
saperevedere: folds
Tio Dany77: raises 3452 to 4252 and is all-in
savin.hsp: folds
kerrlos: folds
jeje_sat: raises 13759 to 18011 and is all-in
Brainkiiller: folds
rogernu7: folds
Aymeric 6186: folds
1881285: folds
Uncalled bet (13759) returned to jeje_sat
*** FLOP *** [Ts 9h Jd]
*** TURN *** [Ts 9h Jd] [9s]
*** RIVER *** [Ts 9h Jd 9s] [Ac]
*** SHOW DOWN ***
Tio Dany77: shows [8s 8d] (two pair, Nines and Eights)
jeje_sat: shows [Ah Jc] (two pair, Aces and Jacks)
jeje_sat collected 10604 from pot
jeje_sat wins €2.25 for eliminating Tio Dany77 and their own bounty increases by €2.25 to €9
Tio Dany77 finished the tournament
*** SUMMARY ***
Total pot 10604 | Rake 0
Board [Ts 9h Jd 9s Ac]
Seat 1: rogernu7 (button) folded before Flop (didn't bet)
Seat 2: Aymeric 6186 (small blind) folded before Flop
Seat 3: 1881285 (big blind) folded before Flop
Seat 4: saperevedere folded before Flop (didn't bet)
Seat 5: Tio Dany77 showed [8s 8d] and lost with two pair, Nines and Eights
Seat 6: savin.hsp folded before Flop (didn't bet)
Seat 7: kerrlos folded before Flop (didn't bet)
Seat 8: jeje_sat showed [Ah Jc] and won (10604) with two pair, Aces and Jacks
Seat 9: Brainkiiller folded before Flop (didn't bet)


PokerStars Hand #229696105191: Tournament #3253260637, €4.50+€4.50+€1.00 EUR Hold'em No Limit - Level XI (400/800) - 2021/09/08 22:08:39 CET [2021/09/08 16:08:39 ET]
Table '3253260637 211' 9-max Seat #2 is the button
Seat 1: rogernu7 (13686 in chips, €9 bounty)
Seat 2: Aymeric 6186 (20063 in chips, €6.75 bounty)
Seat 3: 1881285 (8845 in chips, €4.50 bounty)
Seat 4: saperevedere (22414 in chips, €4.50 bounty)
Seat 5: ghaspareed (11343 in chips, €4.50 bounty)
Seat 6: savin.hsp (18057 in chips, €4.50 bounty)
Seat 7: kerrlos (31219 in chips, €6.75 bounty)
Seat 8: jeje_sat (24363 in chips, €9 bounty)
Seat 9: Brainkiiller (28226 in chips, €9 bounty)
rogernu7: posts the ante 100
Aymeric 6186: posts the ante 100
1881285: posts the ante 100
saperevedere: posts the ante 100
ghaspareed: posts the ante 100
savin.hsp: posts the ante 100
kerrlos: posts the ante 100
jeje_sat: posts the ante 100
Brainkiiller: posts the ante 100
1881285: posts small blind 400
saperevedere: posts big blind 800
*** HOLE CARDS ***
Dealt to jeje_sat [3h 7d]
ghaspareed: folds
savin.hsp: folds
kerrlos: folds
jeje_sat: folds
Brainkiiller: raises 880 to 1680
rogernu7: folds
Aymeric 6186: folds
1881285: folds
saperevedere: folds
Uncalled bet (880) returned to Brainkiiller
Brainkiiller collected 2900 from pot
Brainkiiller: doesn't show hand
*** SUMMARY ***
Total pot 2900 | Rake 0
Seat 1: rogernu7 folded before Flop (didn't bet)
Seat 2: Aymeric 6186 (button) folded before Flop (didn't bet)
Seat 3: 1881285 (small blind) folded before Flop
Seat 4: saperevedere (big blind) folded before Flop
Seat 5: ghaspareed folded before Flop (didn't bet)
Seat 6: savin.hsp folded before Flop (didn't bet)
Seat 7: kerrlos folded before Flop (didn't bet)
Seat 8: jeje_sat folded before Flop (didn't bet)
Seat 9: Brainkiiller collected (2900)


PokerStars Hand #229696154797: Tournament #3253260637, €4.50+€4.50+€1.00 EUR Hold'em No Limit - Level XI (400/800) - 2021/09/08 22:10:14 CET [2021/09/08 16:10:14 ET]
Table '3253260637 211' 9-max Seat #3 is the button
Seat 1: rogernu7 (13586 in chips, €9 bounty)
Seat 2: Aymeric 6186 (19963 in chips, €6.75 bounty)
Seat 3: 1881285 (8345 in chips, €4.50 bounty)
Seat 4: saperevedere (21514 in chips, €4.50 bounty)
Seat 5: ghaspareed (11243 in chips, €4.50 bounty)
Seat 6: savin.hsp (17957 in chips, €4.50 bounty)
Seat 7: kerrlos (31119 in chips, €6.75 bounty)
Seat 8: jeje_sat (24263 in chips, €9 bounty)
Seat 9: Brainkiiller (30226 in chips, €9 bounty)
rogernu7: posts the ante 100
Aymeric 6186: posts the ante 100
1881285: posts the ante 100
saperevedere: posts the ante 100
ghaspareed: posts the ante 100
savin.hsp: posts the ante 100
kerrlos: posts the ante 100
jeje_sat: posts the ante 100
Brainkiiller: posts the ante 100
saperevedere: posts small blind 400
ghaspareed: posts big blind 800
*** HOLE CARDS ***
Dealt to jeje_sat [7d Qd]
savin.hsp: folds
kerrlos: folds
jeje_sat: folds
Brainkiiller: raises 880 to 1680
rogernu7: folds
Aymeric 6186: calls 1680
1881285: folds
saperevedere: folds
ghaspareed: calls 880
*** FLOP *** [6h 3h 4s]
ghaspareed: checks
Brainkiiller: checks
Aymeric 6186: checks
*** TURN *** [6h 3h 4s] [2s]
ghaspareed: bets 2092
Brainkiiller: folds
Aymeric 6186: raises 16091 to 18183 and is all-in
ghaspareed: folds
Uncalled bet (16091) returned to Aymeric 6186
Aymeric 6186 collected 10524 from pot
*** SUMMARY ***
Total pot 10524 | Rake 0
Board [6h 3h 4s 2s]
Seat 1: rogernu7 folded before Flop (didn't bet)
Seat 2: Aymeric 6186 collected (10524)
Seat 3: 1881285 (button) folded before Flop (didn't bet)
Seat 4: saperevedere (small blind) folded before Flop
Seat 5: ghaspareed (big blind) folded on the Turn
Seat 6: savin.hsp folded before Flop (didn't bet)
Seat 7: kerrlos folded before Flop (didn't bet)
Seat 8: jeje_sat folded before Flop (didn't bet)
Seat 9: Brainkiiller folded on the Turn


PokerStars Hand #229696196832: Tournament #3253260637, €4.50+€4.50+€1.00 EUR Hold'em No Limit - Level XI (400/800) - 2021/09/08 22:11:35 CET [2021/09/08 16:11:35 ET]
Table '3253260637 211' 9-max Seat #5 is the button
Seat 1: rogernu7 (13486 in chips, €9 bounty)
Seat 2: Aymeric 6186 (26615 in chips, €6.75 bounty)
Seat 3: 1881285 (8245 in chips, €4.50 bounty)
Seat 5: ghaspareed (7371 in chips, €4.50 bounty)
Seat 6: savin.hsp (17857 in chips, €4.50 bounty)
Seat 7: kerrlos (31019 in chips, €6.75 bounty)
Seat 8: jeje_sat (24163 in chips, €9 bounty)
Seat 9: Brainkiiller (28446 in chips, €9 bounty)
rogernu7: posts the ante 100
Aymeric 6186: posts the ante 100
1881285: posts the ante 100
ghaspareed: posts the ante 100
savin.hsp: posts the ante 100
kerrlos: posts the ante 100
jeje_sat: posts the ante 100
Brainkiiller: posts the ante 100
savin.hsp: posts small blind 400
kerrlos: posts big blind 800
*** HOLE CARDS ***
Dealt to jeje_sat [7c Js]
jeje_sat: folds
Brainkiiller: raises 880 to 1680
rogernu7: folds
Aymeric 6186: folds
1881285: folds
ghaspareed: folds
savin.hsp: folds
kerrlos: raises 29239 to 30919 and is all-in
Brainkiiller: calls 26666 and is all-in
Uncalled bet (2573) returned to kerrlos
*** FLOP *** [Kh 7s 4d]
*** TURN *** [Kh 7s 4d] [Ad]
*** RIVER *** [Kh 7s 4d Ad] [Jd]
*** SHOW DOWN ***
kerrlos: shows [9c 9h] (a pair of Nines)
Brainkiiller: shows [8d 8s] (a pair of Eights)
kerrlos collected 57892 from pot
kerrlos wins €4.50 for eliminating Brainkiiller and their own bounty increases by €4.50 to €11.25
Brainkiiller finished the tournament
*** SUMMARY ***
Total pot 57892 | Rake 0
Board [Kh 7s 4d Ad Jd]
Seat 1: rogernu7 folded before Flop (didn't bet)
Seat 2: Aymeric 6186 folded before Flop (didn't bet)
Seat 3: 1881285 folded before Flop (didn't bet)
Seat 5: ghaspareed (button) folded before Flop (didn't bet)
Seat 6: savin.hsp (small blind) folded before Flop
Seat 7: kerrlos (big blind) showed [9c 9h] and won (57892) with a pair of Nines
Seat 8: jeje_sat folded before Flop (didn't bet)
Seat 9: Brainkiiller showed [8d 8s] and lost with a pair of Eights


PokerStars Hand #229696228390: Tournament #3253260637, €4.50+€4.50+€1.00 EUR Hold'em No Limit - Level XI (400/800) - 2021/09/08 22:12:37 CET [2021/09/08 16:12:37 ET]
Table '3253260637 211' 9-max Seat #6 is the button
Seat 1: rogernu7 (13386 in chips, €9 bounty)
Seat 2: Aymeric 6186 (26515 in chips, €6.75 bounty)
Seat 3: 1881285 (8145 in chips, €4.50 bounty)
Seat 4: ilyleya (10000 in chips, €4.50 bounty)
Seat 5: ghaspareed (7271 in chips, €4.50 bounty)
Seat 6: savin.hsp (17357 in chips, €4.50 bounty)
Seat 7: kerrlos (60465 in chips, €11.25 bounty)
Seat 8: jeje_sat (24063 in chips, €9 bounty)
rogernu7: posts the ante 100
Aymeric 6186: posts the ante 100
1881285: posts the ante 100
ilyleya: posts the ante 100
ghaspareed: posts the ante 100
savin.hsp: posts the ante 100
kerrlos: posts the ante 100
jeje_sat: posts the ante 100
kerrlos: posts small blind 400
jeje_sat: posts big blind 800
*** HOLE CARDS ***
Dealt to jeje_sat [Qh Th]
rogernu7: raises 12486 to 13286 and is all-in
Aymeric 6186: folds
1881285: folds
ilyleya: folds
ghaspareed: folds
savin.hsp: folds
kerrlos: folds
jeje_sat: folds
Uncalled bet (12486) returned to rogernu7
rogernu7 collected 2800 from pot
*** SUMMARY ***
Total pot 2800 | Rake 0
Seat 1: rogernu7 collected (2800)
Seat 2: Aymeric 6186 folded before Flop (didn't bet)
Seat 3: 1881285 folded before Flop (didn't bet)
Seat 4: ilyleya folded before Flop (didn't bet)
Seat 5: ghaspareed folded before Flop (didn't bet)
Seat 6: savin.hsp (button) folded before Flop (didn't bet)
Seat 7: kerrlos (small blind) folded before Flop
Seat 8: jeje_sat (big blind) folded before Flop


PokerStars Hand #229696250309: Tournament #3253260637, €4.50+€4.50+€1.00 EUR Hold'em No Limit - Level XI (400/800) - 2021/09/08 22:13:19 CET [2021/09/08 16:13:19 ET]
Table '3253260637 211' 9-max Seat #7 is the button
Seat 1: rogernu7 (15286 in chips, €9 bounty)
Seat 2: Aymeric 6186 (26415 in chips, €6.75 bounty)
Seat 3: 1881285 (8045 in chips, €4.50 bounty)
Seat 4: ilyleya (9900 in chips, €4.50 bounty)
Seat 5: ghaspareed (7171 in chips, €4.50 bounty)
Seat 6: savin.hsp (17257 in chips, €4.50 bounty)
Seat 7: kerrlos (59965 in chips, €11.25 bounty)
Seat 8: jeje_sat (23163 in chips, €9 bounty)
rogernu7: posts the ante 100
Aymeric 6186: posts the ante 100
1881285: posts the ante 100
ilyleya: posts the ante 100
ghaspareed: posts the ante 100
savin.hsp: posts the ante 100
kerrlos: posts the ante 100
jeje_sat: posts the ante 100
jeje_sat: posts small blind 400
rogernu7: posts big blind 800
*** HOLE CARDS ***
Dealt to jeje_sat [7d Qc]
Aymeric 6186: folds
1881285: raises 800 to 1600
ilyleya: raises 8200 to 9800 and is all-in
ghaspareed: folds
savin.hsp: folds
kerrlos: folds
jeje_sat: folds
rogernu7: folds
1881285: calls 6345 and is all-in
Uncalled bet (1855) returned to ilyleya
*** FLOP *** [4c 3d Th]
*** TURN *** [4c 3d Th] [2c]
*** RIVER *** [4c 3d Th 2c] [Ac]
*** SHOW DOWN ***
1881285: shows [Kh As] (a pair of Aces)
ilyleya: shows [7h 7c] (a pair of Sevens)
1881285 collected 17890 from pot
*** SUMMARY ***
Total pot 17890 | Rake 0
Board [4c 3d Th 2c Ac]
Seat 1: rogernu7 (big blind) folded before Flop
Seat 2: Aymeric 6186 folded before Flop (didn't bet)
Seat 3: 1881285 showed [Kh As] and won (17890) with a pair of Aces
Seat 4: ilyleya showed [7h 7c] and lost with a pair of Sevens
Seat 5: ghaspareed folded before Flop (didn't bet)
Seat 6: savin.hsp folded before Flop (didn't bet)
Seat 7: kerrlos (button) folded before Flop (didn't bet)
Seat 8: jeje_sat (small blind) folded before Flop


PokerStars Hand #229696271912: Tournament #3253260637, €4.50+€4.50+€1.00 EUR Hold'em No Limit - Level XI (400/800) - 2021/09/08 22:14:01 CET [2021/09/08 16:14:01 ET]
Table '3253260637 211' 9-max Seat #8 is the button
Seat 1: rogernu7 (14386 in chips, €9 bounty)
Seat 2: Aymeric 6186 (26315 in chips, €6.75 bounty)
Seat 3: 1881285 (17890 in chips, €4.50 bounty)
Seat 4: ilyleya (1855 in chips, €4.50 bounty)
Seat 5: ghaspareed (7071 in chips, €4.50 bounty)
Seat 6: savin.hsp (17157 in chips, €4.50 bounty)
Seat 7: kerrlos (59865 in chips, €11.25 bounty)
Seat 8: jeje_sat (22663 in chips, €9 bounty)
rogernu7: posts the ante 100
Aymeric 6186: posts the ante 100
1881285: posts the ante 100
ilyleya: posts the ante 100
ghaspareed: posts the ante 100
savin.hsp: posts the ante 100
kerrlos: posts the ante 100
jeje_sat: posts the ante 100
rogernu7: posts small blind 400
Aymeric 6186: posts big blind 800
*** HOLE CARDS ***
Dealt to jeje_sat [Kc 4h]
1881285: raises 1600 to 2400
ilyleya: calls 1755 and is all-in
ghaspareed: folds
savin.hsp: folds
kerrlos: folds
jeje_sat: folds
rogernu7: folds
Aymeric 6186: folds
Uncalled bet (645) returned to 1881285
*** FLOP *** [2h 5d 5c]
*** TURN *** [2h 5d 5c] [8h]
*** RIVER *** [2h 5d 5c 8h] [9h]
*** SHOW DOWN ***
1881285: shows [Ah Ks] (a pair of Fives)
ilyleya: shows [3s Js] (a pair of Fives - lower kicker)
1881285 collected 5510 from pot
1881285 wins €2.25 for eliminating ilyleya and their own bounty increases by €2.25 to €6.75
ilyleya finished the tournament
*** SUMMARY ***
Total pot 5510 | Rake 0
Board [2h 5d 5c 8h 9h]
Seat 1: rogernu7 (small blind) folded before Flop
Seat 2: Aymeric 6186 (big blind) folded before Flop
Seat 3: 1881285 showed [Ah Ks] and won (5510) with a pair of Fives
Seat 4: ilyleya showed [3s Js] and lost with a pair of Fives
Seat 5: ghaspareed folded before Flop (didn't bet)
Seat 6: savin.hsp folded before Flop (didn't bet)
Seat 7: kerrlos folded before Flop (didn't bet)
Seat 8: jeje_sat (button) folded before Flop (didn't bet)


PokerStars Hand #229696292304: Tournament #3253260637, €4.50+€4.50+€1.00 EUR Hold'em No Limit - Level XI (400/800) - 2021/09/08 22:14:41 CET [2021/09/08 16:14:41 ET]
Table '3253260637 211' 9-max Seat #1 is the button
Seat 1: rogernu7 (13886 in chips, €9 bounty)
Seat 2: Aymeric 6186 (25415 in chips, €6.75 bounty)
Seat 3: 1881285 (21545 in chips, €6.75 bounty)
Seat 5: ghaspareed (6971 in chips, €4.50 bounty)
Seat 6: savin.hsp (17057 in chips, €4.50 bounty)
Seat 7: kerrlos (59765 in chips, €11.25 bounty)
Seat 8: jeje_sat (22563 in chips, €9 bounty)
Seat 9: cara do bem (46475 in chips, €9 bounty)
rogernu7: posts the ante 100
Aymeric 6186: posts the ante 100
1881285: posts the ante 100
ghaspareed: posts the ante 100
savin.hsp: posts the ante 100
kerrlos: posts the ante 100
jeje_sat: posts the ante 100
cara do bem: posts the ante 100
Aymeric 6186: posts small blind 400
1881285: posts big blind 800
*** HOLE CARDS ***
Dealt to jeje_sat [2s 3s]
ghaspareed: folds
savin.hsp: folds
kerrlos: folds
jeje_sat: folds
cara do bem: raises 960 to 1760
rogernu7: raises 12026 to 13786 and is all-in
Aymeric 6186: folds
1881285: folds
cara do bem: folds
Uncalled bet (12026) returned to rogernu7
rogernu7 collected 5520 from pot
rogernu7: doesn't show hand
*** SUMMARY ***
Total pot 5520 | Rake 0
Seat 1: rogernu7 (button) collected (5520)
Seat 2: Aymeric 6186 (small blind) folded before Flop
Seat 3: 1881285 (big blind) folded before Flop
Seat 5: ghaspareed folded before Flop (didn't bet)
Seat 6: savin.hsp folded before Flop (didn't bet)
Seat 7: kerrlos folded before Flop (didn't bet)
Seat 8: jeje_sat folded before Flop (didn't bet)
Seat 9: cara do bem folded before Flop


PokerStars Hand #229696316039: Tournament #3253260637, €4.50+€4.50+€1.00 EUR Hold'em No Limit - Level XI (400/800) - 2021/09/08 22:15:26 CET [2021/09/08 16:15:26 ET]
Table '3253260637 211' 9-max Seat #2 is the button
Seat 1: rogernu7 (17546 in chips, €9 bounty)
Seat 2: Aymeric 6186 (24915 in chips, €6.75 bounty)
Seat 3: 1881285 (20645 in chips, €6.75 bounty)
Seat 4: cokinhagelada (28580 in chips, €9 bounty)
Seat 5: ghaspareed (6871 in chips, €4.50 bounty)
Seat 6: savin.hsp (16957 in chips, €4.50 bounty)
Seat 7: kerrlos (59665 in chips, €11.25 bounty)
Seat 8: jeje_sat (22463 in chips, €9 bounty)
Seat 9: cara do bem (44615 in chips, €9 bounty)
rogernu7: posts the ante 100
Aymeric 6186: posts the ante 100
1881285: posts the ante 100
cokinhagelada: posts the ante 100
ghaspareed: posts the ante 100
savin.hsp: posts the ante 100
kerrlos: posts the ante 100
jeje_sat: posts the ante 100
cara do bem: posts the ante 100
1881285: posts small blind 400
cokinhagelada: posts big blind 800
*** HOLE CARDS ***
Dealt to jeje_sat [Js Ts]
ghaspareed: folds
savin.hsp: folds
kerrlos: folds
jeje_sat: raises 1600 to 2400
cara do bem: calls 2400
rogernu7: folds
Aymeric 6186: folds
1881285: folds
cokinhagelada: folds
*** FLOP *** [6c Qs 4c]
jeje_sat: bets 3450
cara do bem: calls 3450
*** TURN *** [6c Qs 4c] [4d]
jeje_sat: bets 6900
cara do bem: calls 6900
*** RIVER *** [6c Qs 4c 4d] [Qc]
jeje_sat: bets 9613 and is all-in
cara do bem: calls 9613
*** SHOW DOWN ***
jeje_sat: shows [Js Ts] (two pair, Queens and Fours)
cara do bem: shows [Qd Kd] (a full house, Queens full of Fours)
cara do bem collected 46826 from pot
*** SUMMARY ***
Total pot 46826 | Rake 0
Board [6c Qs 4c 4d Qc]
Seat 1: rogernu7 folded before Flop (didn't bet)
Seat 2: Aymeric 6186 (button) folded before Flop (didn't bet)
Seat 3: 1881285 (small blind) folded before Flop
Seat 4: cokinhagelada (big blind) folded before Flop
Seat 5: ghaspareed folded before Flop (didn't bet)
Seat 6: savin.hsp folded before Flop (didn't bet)
Seat 7: kerrlos folded before Flop (didn't bet)
Seat 8: jeje_sat showed [Js Ts] and lost with two pair, Queens and Fours
Seat 9: cara do bem showed [Qd Kd] and won (46826) with a full house, Queens full of Fours


