PokerStars Hand #230135715074: Tournament #3272321157, €0.23+€0.02 EUR Omaha Pot Limit - Level I (10/20) - 2021/09/26 1:32:10 CET [2021/09/25 19:32:10 ET]
Table '3272321157 1' 3-max Seat #1 is the button
Seat 1: camaleon60 (500 in chips)
Seat 2: carto2a (500 in chips)
Seat 3: jeje_sat (500 in chips)
carto2a: posts small blind 10
jeje_sat: posts big blind 20
*** HOLE CARDS ***
Dealt to jeje_sat [5h 3d 5d 7d]
camaleon60: calls 20
carto2a: calls 10
jeje_sat: checks
*** FLOP *** [Qd Qs 3s]
carto2a: checks
jeje_sat: checks
camaleon60: checks
*** TURN *** [Qd Qs 3s] [Ks]
carto2a: checks
jeje_sat: checks
camaleon60: checks
*** RIVER *** [Qd Qs 3s Ks] [Jd]
carto2a: checks
jeje_sat: checks
camaleon60: checks
*** SHOW DOWN ***
carto2a: shows [2h Th 8d Ah] (a straight, Ten to Ace)
jeje_sat: mucks hand
camaleon60: mucks hand
carto2a collected 60 from pot
*** SUMMARY ***
Total pot 60 | Rake 0
Board [Qd Qs 3s Ks Jd]
Seat 1: camaleon60 (button) mucked [Kh 2d 7s 3c]
Seat 2: carto2a (small blind) showed [2h Th 8d Ah] and won (60) with a straight, Ten to Ace
Seat 3: jeje_sat (big blind) mucked [5h 3d 5d 7d]


PokerStars Hand #230135727358: Tournament #3272321157, €0.23+€0.02 EUR Omaha Pot Limit - Level I (10/20) - 2021/09/26 1:32:46 CET [2021/09/25 19:32:46 ET]
Table '3272321157 1' 3-max Seat #2 is the button
Seat 1: camaleon60 (480 in chips)
Seat 2: carto2a (540 in chips)
Seat 3: jeje_sat (480 in chips)
jeje_sat: posts small blind 10
camaleon60: posts big blind 20
*** HOLE CARDS ***
Dealt to jeje_sat [3d Td 9s Qd]
carto2a: calls 20
jeje_sat: calls 10
camaleon60: checks
*** FLOP *** [Tc 4h 2h]
jeje_sat: checks
camaleon60: checks
carto2a: checks
*** TURN *** [Tc 4h 2h] [5h]
jeje_sat: checks
camaleon60: checks
carto2a: checks
*** RIVER *** [Tc 4h 2h 5h] [Ts]
jeje_sat: bets 60
camaleon60: raises 60 to 120
carto2a: folds
jeje_sat: calls 60
*** SHOW DOWN ***
camaleon60: shows [3s 2c Ah Qh] (a flush, Ace high)
jeje_sat: mucks hand
camaleon60 collected 300 from pot
*** SUMMARY ***
Total pot 300 | Rake 0
Board [Tc 4h 2h 5h Ts]
Seat 1: camaleon60 (big blind) showed [3s 2c Ah Qh] and won (300) with a flush, Ace high
Seat 2: carto2a (button) folded on the River
Seat 3: jeje_sat (small blind) mucked [3d Td 9s Qd]


PokerStars Hand #230135737514: Tournament #3272321157, €0.23+€0.02 EUR Omaha Pot Limit - Level I (10/20) - 2021/09/26 1:33:18 CET [2021/09/25 19:33:18 ET]
Table '3272321157 1' 3-max Seat #3 is the button
Seat 1: camaleon60 (640 in chips)
Seat 2: carto2a (520 in chips)
Seat 3: jeje_sat (340 in chips)
camaleon60: posts small blind 10
carto2a: posts big blind 20
*** HOLE CARDS ***
Dealt to jeje_sat [8c 4h Ac Th]
jeje_sat: raises 50 to 70
camaleon60: folds
carto2a: folds
Uncalled bet (50) returned to jeje_sat
jeje_sat collected 50 from pot
jeje_sat: doesn't show hand
*** SUMMARY ***
Total pot 50 | Rake 0
Seat 1: camaleon60 (small blind) folded before Flop
Seat 2: carto2a (big blind) folded before Flop
Seat 3: jeje_sat (button) collected (50)


PokerStars Hand #230135740704: Tournament #3272321157, €0.23+€0.02 EUR Omaha Pot Limit - Level I (10/20) - 2021/09/26 1:33:29 CET [2021/09/25 19:33:29 ET]
Table '3272321157 1' 3-max Seat #1 is the button
Seat 1: camaleon60 (630 in chips)
Seat 2: carto2a (500 in chips)
Seat 3: jeje_sat (370 in chips)
carto2a: posts small blind 10
jeje_sat: posts big blind 20
*** HOLE CARDS ***
Dealt to jeje_sat [Kh 8s Td 3h]
camaleon60: folds
carto2a: calls 10
jeje_sat: checks
*** FLOP *** [5d Js 2s]
carto2a: checks
jeje_sat: checks
*** TURN *** [5d Js 2s] [Jh]
carto2a: checks
jeje_sat: checks
*** RIVER *** [5d Js 2s Jh] [Ac]
carto2a: checks
jeje_sat: checks
*** SHOW DOWN ***
carto2a: shows [Tc 4d 8h Ks] (a pair of Jacks)
jeje_sat: shows [Kh 8s Td 3h] (a pair of Jacks)
carto2a collected 20 from pot
jeje_sat collected 20 from pot
*** SUMMARY ***
Total pot 40 | Rake 0
Board [5d Js 2s Jh Ac]
Seat 1: camaleon60 (button) folded before Flop (didn't bet)
Seat 2: carto2a (small blind) showed [Tc 4d 8h Ks] and won (20) with a pair of Jacks
Seat 3: jeje_sat (big blind) showed [Kh 8s Td 3h] and won (20) with a pair of Jacks


PokerStars Hand #230135746382: Tournament #3272321157, €0.23+€0.02 EUR Omaha Pot Limit - Level I (10/20) - 2021/09/26 1:33:47 CET [2021/09/25 19:33:47 ET]
Table '3272321157 1' 3-max Seat #2 is the button
Seat 1: camaleon60 (630 in chips)
Seat 2: carto2a (500 in chips)
Seat 3: jeje_sat (370 in chips)
jeje_sat: posts small blind 10
camaleon60: posts big blind 20
*** HOLE CARDS ***
Dealt to jeje_sat [9s 3d 6c Ad]
carto2a: calls 20
jeje_sat: raises 60 to 80
camaleon60: folds
carto2a: calls 60
*** FLOP *** [5d 8s 7d]
jeje_sat: bets 180
carto2a: calls 180
*** TURN *** [5d 8s 7d] [5c]
jeje_sat: bets 110 and is all-in
carto2a: calls 110
*** RIVER *** [5d 8s 7d 5c] [Kd]
*** SHOW DOWN ***
jeje_sat: shows [9s 3d 6c Ad] (a flush, Ace high)
carto2a: shows [Qd Ac 8c Tc] (two pair, Eights and Fives)
jeje_sat collected 760 from pot
*** SUMMARY ***
Total pot 760 | Rake 0
Board [5d 8s 7d 5c Kd]
Seat 1: camaleon60 (big blind) folded before Flop
Seat 2: carto2a (button) showed [Qd Ac 8c Tc] and lost with two pair, Eights and Fives
Seat 3: jeje_sat (small blind) showed [9s 3d 6c Ad] and won (760) with a flush, Ace high


PokerStars Hand #230135754051: Tournament #3272321157, €0.23+€0.02 EUR Omaha Pot Limit - Level I (10/20) - 2021/09/26 1:34:12 CET [2021/09/25 19:34:12 ET]
Table '3272321157 1' 3-max Seat #3 is the button
Seat 1: camaleon60 (610 in chips)
Seat 2: carto2a (130 in chips)
Seat 3: jeje_sat (760 in chips)
camaleon60: posts small blind 10
carto2a: posts big blind 20
*** HOLE CARDS ***
Dealt to jeje_sat [3c 2h 4h Jh]
jeje_sat: folds
camaleon60: calls 10
carto2a: raises 40 to 60
camaleon60: calls 40
*** FLOP *** [6d 8h 3h]
camaleon60: checks
carto2a: bets 70 and is all-in
camaleon60: calls 70
*** TURN *** [6d 8h 3h] [Td]
*** RIVER *** [6d 8h 3h Td] [Kh]
*** SHOW DOWN ***
camaleon60: shows [9s Ac 4d Th] (a pair of Tens)
carto2a: shows [Jd 5c Js 6c] (a pair of Jacks)
carto2a collected 260 from pot
*** SUMMARY ***
Total pot 260 | Rake 0
Board [6d 8h 3h Td Kh]
Seat 1: camaleon60 (small blind) showed [9s Ac 4d Th] and lost with a pair of Tens
Seat 2: carto2a (big blind) showed [Jd 5c Js 6c] and won (260) with a pair of Jacks
Seat 3: jeje_sat (button) folded before Flop (didn't bet)


PokerStars Hand #230135761854: Tournament #3272321157, €0.23+€0.02 EUR Omaha Pot Limit - Level I (10/20) - 2021/09/26 1:34:37 CET [2021/09/25 19:34:37 ET]
Table '3272321157 1' 3-max Seat #1 is the button
Seat 1: camaleon60 (480 in chips)
Seat 2: carto2a (260 in chips)
Seat 3: jeje_sat (760 in chips)
carto2a: posts small blind 10
jeje_sat: posts big blind 20
*** HOLE CARDS ***
Dealt to jeje_sat [Ks 9c 4c 7h]
camaleon60: calls 20
carto2a: calls 10
jeje_sat: checks
*** FLOP *** [5d 5s Td]
carto2a: checks
jeje_sat: checks
camaleon60: checks
*** TURN *** [5d 5s Td] [8d]
carto2a: checks
jeje_sat: checks
camaleon60: checks
*** RIVER *** [5d 5s Td 8d] [3c]
carto2a: bets 60
jeje_sat: folds
camaleon60: folds
Uncalled bet (60) returned to carto2a
carto2a collected 60 from pot
carto2a: doesn't show hand
*** SUMMARY ***
Total pot 60 | Rake 0
Board [5d 5s Td 8d 3c]
Seat 1: camaleon60 (button) folded on the River
Seat 2: carto2a (small blind) collected (60)
Seat 3: jeje_sat (big blind) folded on the River


PokerStars Hand #230135775735: Tournament #3272321157, €0.23+€0.02 EUR Omaha Pot Limit - Level I (10/20) - 2021/09/26 1:35:10 CET [2021/09/25 19:35:10 ET]
Table '3272321157 1' 3-max Seat #2 is the button
Seat 1: camaleon60 (460 in chips)
Seat 2: carto2a (300 in chips)
Seat 3: jeje_sat (740 in chips)
jeje_sat: posts small blind 10
camaleon60: posts big blind 20
*** HOLE CARDS ***
Dealt to jeje_sat [6d Kc Qs Ks]
carto2a: calls 20
jeje_sat: raises 60 to 80
camaleon60: folds
carto2a: calls 60
*** FLOP *** [8d 5s Tc]
jeje_sat: bets 180
carto2a: raises 40 to 220 and is all-in
jeje_sat: calls 40
*** TURN *** [8d 5s Tc] [Kd]
*** RIVER *** [8d 5s Tc Kd] [Kh]
*** SHOW DOWN ***
jeje_sat: shows [6d Kc Qs Ks] (four of a kind, Kings)
carto2a: shows [2c As 5h Th] (two pair, Kings and Tens)
jeje_sat collected 620 from pot
carto2a finished the tournament in 3rd place
*** SUMMARY ***
Total pot 620 | Rake 0
Board [8d 5s Tc Kd Kh]
Seat 1: camaleon60 (big blind) folded before Flop
Seat 2: carto2a (button) showed [2c As 5h Th] and lost with two pair, Kings and Tens
Seat 3: jeje_sat (small blind) showed [6d Kc Qs Ks] and won (620) with four of a kind, Kings


PokerStars Hand #230135784414: Tournament #3272321157, €0.23+€0.02 EUR Omaha Pot Limit - Level II (15/30) - 2021/09/26 1:35:38 CET [2021/09/25 19:35:38 ET]
Table '3272321157 1' 3-max Seat #1 is the button
Seat 1: camaleon60 (440 in chips)
Seat 3: jeje_sat (1060 in chips)
camaleon60: posts small blind 15
jeje_sat: posts big blind 30
*** HOLE CARDS ***
Dealt to jeje_sat [5c Ts Ks 5d]
camaleon60: calls 15
jeje_sat: checks
*** FLOP *** [6d 7d 8c]
jeje_sat: checks
camaleon60: checks
*** TURN *** [6d 7d 8c] [Kd]
jeje_sat: bets 60
camaleon60: folds
Uncalled bet (60) returned to jeje_sat
jeje_sat collected 60 from pot
jeje_sat: doesn't show hand
*** SUMMARY ***
Total pot 60 | Rake 0
Board [6d 7d 8c Kd]
Seat 1: camaleon60 (button) (small blind) folded on the Turn
Seat 3: jeje_sat (big blind) collected (60)


PokerStars Hand #230135791897: Tournament #3272321157, €0.23+€0.02 EUR Omaha Pot Limit - Level II (15/30) - 2021/09/26 1:36:03 CET [2021/09/25 19:36:03 ET]
Table '3272321157 1' 3-max Seat #3 is the button
Seat 1: camaleon60 (410 in chips)
Seat 3: jeje_sat (1090 in chips)
jeje_sat: posts small blind 15
camaleon60: posts big blind 30
*** HOLE CARDS ***
Dealt to jeje_sat [2d Qh 6d Ts]
jeje_sat: calls 15
camaleon60: checks
*** FLOP *** [Qs 5d 4h]
camaleon60: checks
jeje_sat: bets 30
camaleon60: calls 30
*** TURN *** [Qs 5d 4h] [7h]
camaleon60: checks
jeje_sat: checks
*** RIVER *** [Qs 5d 4h 7h] [8h]
camaleon60: checks
jeje_sat: checks
*** SHOW DOWN ***
camaleon60: shows [8d Kd 3d Tc] (a pair of Eights)
jeje_sat: shows [2d Qh 6d Ts] (a pair of Queens)
jeje_sat collected 120 from pot
*** SUMMARY ***
Total pot 120 | Rake 0
Board [Qs 5d 4h 7h 8h]
Seat 1: camaleon60 (big blind) showed [8d Kd 3d Tc] and lost with a pair of Eights
Seat 3: jeje_sat (button) (small blind) showed [2d Qh 6d Ts] and won (120) with a pair of Queens


PokerStars Hand #230135798540: Tournament #3272321157, €0.23+€0.02 EUR Omaha Pot Limit - Level II (15/30) - 2021/09/26 1:36:25 CET [2021/09/25 19:36:25 ET]
Table '3272321157 1' 3-max Seat #1 is the button
Seat 1: camaleon60 (350 in chips)
Seat 3: jeje_sat (1150 in chips)
camaleon60: posts small blind 15
jeje_sat: posts big blind 30
*** HOLE CARDS ***
Dealt to jeje_sat [8h 2d 8d 9c]
camaleon60: calls 15
jeje_sat: checks
*** FLOP *** [9s Qs 6h]
jeje_sat: bets 30
camaleon60: calls 30
*** TURN *** [9s Qs 6h] [3s]
jeje_sat: checks
camaleon60: bets 30
jeje_sat: folds
Uncalled bet (30) returned to camaleon60
camaleon60 collected 120 from pot
camaleon60: doesn't show hand
*** SUMMARY ***
Total pot 120 | Rake 0
Board [9s Qs 6h 3s]
Seat 1: camaleon60 (button) (small blind) collected (120)
Seat 3: jeje_sat (big blind) folded on the Turn


PokerStars Hand #230135805058: Tournament #3272321157, €0.23+€0.02 EUR Omaha Pot Limit - Level II (15/30) - 2021/09/26 1:36:46 CET [2021/09/25 19:36:46 ET]
Table '3272321157 1' 3-max Seat #3 is the button
Seat 1: camaleon60 (410 in chips)
Seat 3: jeje_sat (1090 in chips)
jeje_sat: posts small blind 15
camaleon60: posts big blind 30
*** HOLE CARDS ***
Dealt to jeje_sat [Jd 3h Jh Ts]
jeje_sat: raises 60 to 90
camaleon60: calls 60
*** FLOP *** [Ah 8s 6d]
camaleon60: checks
jeje_sat: bets 180
camaleon60: folds
Uncalled bet (180) returned to jeje_sat
jeje_sat collected 180 from pot
jeje_sat: doesn't show hand
*** SUMMARY ***
Total pot 180 | Rake 0
Board [Ah 8s 6d]
Seat 1: camaleon60 (big blind) folded on the Flop
Seat 3: jeje_sat (button) (small blind) collected (180)


PokerStars Hand #230135811569: Tournament #3272321157, €0.23+€0.02 EUR Omaha Pot Limit - Level II (15/30) - 2021/09/26 1:37:08 CET [2021/09/25 19:37:08 ET]
Table '3272321157 1' 3-max Seat #1 is the button
Seat 1: camaleon60 (320 in chips)
Seat 3: jeje_sat (1180 in chips)
camaleon60: posts small blind 15
jeje_sat: posts big blind 30
*** HOLE CARDS ***
Dealt to jeje_sat [Qc Kd Ad Td]
camaleon60: calls 15
jeje_sat: raises 60 to 90
camaleon60: calls 60
*** FLOP *** [8d Tc Jd]
jeje_sat: bets 180
camaleon60: calls 180
*** TURN *** [8d Tc Jd] [Ah]
jeje_sat: bets 540
camaleon60: calls 50 and is all-in
Uncalled bet (490) returned to jeje_sat
*** RIVER *** [8d Tc Jd Ah] [9d]
*** SHOW DOWN ***
jeje_sat: shows [Qc Kd Ad Td] (a flush, Ace high)
camaleon60: shows [4h 8c 5d As] (two pair, Aces and Eights)
jeje_sat collected 640 from pot
*** SUMMARY ***
Total pot 640 | Rake 0
Board [8d Tc Jd Ah 9d]
Seat 1: camaleon60 (button) (small blind) showed [4h 8c 5d As] and lost with two pair, Aces and Eights
Seat 3: jeje_sat (big blind) showed [Qc Kd Ad Td] and won (640) with a flush, Ace high


